Date,HW,Home,Home_Diff,Home_Pts,Start_Time,Visitor,Visitor_Pts
Tue Oct 25 2016,1,Cleveland Cavaliers,29,117,7:30 pm,New York Knicks,88
Tue Oct 25 2016,0,Golden State Warriors,-29,100,10:30 pm,San Antonio Spurs,129
Tue Oct 25 2016,1,Portland Trail Blazers,9,113,10:00 pm,Utah Jazz,104
Wed Oct 26 2016,1,Boston Celtics,5,122,7:30 pm,Brooklyn Nets,117
Wed Oct 26 2016,1,Indiana Pacers,9,130,7:00 pm,Dallas Mavericks,121
Wed Oct 26 2016,1,Los Angeles Lakers,6,120,10:30 pm,Houston Rockets,114
Wed Oct 26 2016,1,Memphis Grizzlies,4,102,8:00 pm,Minnesota Timberwolves,98
Wed Oct 26 2016,0,Milwaukee Bucks,-11,96,8:00 pm,Charlotte Hornets,107
Wed Oct 26 2016,0,New Orleans Pelicans,-5,102,8:00 pm,Denver Nuggets,107
Wed Oct 26 2016,0,Orlando Magic,-12,96,7:00 pm,Miami Heat,108
Wed Oct 26 2016,0,Philadelphia 76ers,-6,97,8:00 pm,Oklahoma City Thunder,103
Wed Oct 26 2016,0,Phoenix Suns,-19,94,10:00 pm,Sacramento Kings,113
Wed Oct 26 2016,1,Toronto Raptors,18,109,7:30 pm,Detroit Pistons,91
Thu Oct 27 2016,1,Atlanta Hawks,15,114,7:30 pm,Washington Wizards,99
Thu Oct 27 2016,1,Chicago Bulls,6,105,8:00 pm,Boston Celtics,99
Thu Oct 27 2016,0,Portland Trail Blazers,-8,106,10:30 pm,Los Angeles Clippers,114
Thu Oct 27 2016,0,Sacramento Kings,-8,94,10:30 pm,San Antonio Spurs,102
Fri Oct 28 2016,1,Brooklyn Nets,9,103,7:30 pm,Indiana Pacers,94
Fri Oct 28 2016,0,Dallas Mavericks,-8,98,8:30 pm,Houston Rockets,106
Fri Oct 28 2016,1,Detroit Pistons,26,108,7:30 pm,Orlando Magic,82
Fri Oct 28 2016,0,Miami Heat,-6,91,8:00 pm,Charlotte Hornets,97
Fri Oct 28 2016,0,New Orleans Pelicans,-8,114,9:30 pm,Golden State Warriors,122
Fri Oct 28 2016,1,Oklahoma City Thunder,3,113,8:00 pm,Phoenix Suns,110
Fri Oct 28 2016,0,Toronto Raptors,-3,91,7:00 pm,Cleveland Cavaliers,94
Fri Oct 28 2016,1,Utah Jazz,7,96,9:00 pm,Los Angeles Lakers,89
Sat Oct 29 2016,1,Chicago Bulls,17,118,8:00 pm,Indiana Pacers,101
Sat Oct 29 2016,0,Charlotte Hornets,-6,98,7:00 pm,Boston Celtics,104
Sat Oct 29 2016,1,Cleveland Cavaliers,6,105,7:30 pm,Orlando Magic,99
Sat Oct 29 2016,0,Denver Nuggets,-2,113,9:00 pm,Portland Trail Blazers,115
Sat Oct 29 2016,1,Milwaukee Bucks,2,110,8:00 pm,Brooklyn Nets,108
Sat Oct 29 2016,1,New York Knicks,7,111,7:30 pm,Memphis Grizzlies,104
Sat Oct 29 2016,0,Philadelphia 76ers,-32,72,12:30 pm,Atlanta Hawks,104
Sat Oct 29 2016,1,Sacramento Kings,3,106,10:30 pm,Minnesota Timberwolves,103
Sat Oct 29 2016,1,San Antonio Spurs,19,98,8:00 pm,New Orleans Pelicans,79
Sun Oct 30 2016,1,Detroit Pistons,15,98,6:00 pm,Milwaukee Bucks,83
Sun Oct 30 2016,1,Houston Rockets,1,93,8:00 pm,Dallas Mavericks,92
Sun Oct 30 2016,1,Los Angeles Clippers,13,88,4:30 pm,Utah Jazz,75
Sun Oct 30 2016,1,Memphis Grizzlies,9,112,8:00 pm,Washington Wizards,103
Sun Oct 30 2016,0,Miami Heat,-7,99,6:00 pm,San Antonio Spurs,106
Sun Oct 30 2016,1,Oklahoma City Thunder,17,113,7:00 pm,Los Angeles Lakers,96
Sun Oct 30 2016,0,Phoenix Suns,-6,100,6:00 pm,Golden State Warriors,106
Mon Oct 31 2016,1,Atlanta Hawks,11,106,7:30 pm,Sacramento Kings,95
Mon Oct 31 2016,0,Brooklyn Nets,-30,88,7:30 pm,Chicago Bulls,118
Mon Oct 31 2016,1,Los Angeles Clippers,18,116,10:30 pm,Phoenix Suns,98
Mon Oct 31 2016,1,Toronto Raptors,3,105,7:30 pm,Denver Nuggets,102
Tue Nov 1 2016,1,Cleveland Cavaliers,8,128,6:00 pm,Houston Rockets,120
Tue Nov 1 2016,1,Detroit Pistons,13,102,7:30 pm,New York Knicks,89
Tue Nov 1 2016,1,Indiana Pacers,7,115,7:00 pm,Los Angeles Lakers,108
Tue Nov 1 2016,1,Miami Heat,12,108,7:30 pm,Sacramento Kings,96
Tue Nov 1 2016,1,Minnesota Timberwolves,36,116,8:00 pm,Memphis Grizzlies,80
Tue Nov 1 2016,0,New Orleans Pelicans,-4,113,8:00 pm,Milwaukee Bucks,117
Tue Nov 1 2016,0,Philadelphia 76ers,-2,101,7:00 pm,Orlando Magic,103
Tue Nov 1 2016,0,Portland Trail Blazers,-23,104,10:00 pm,Golden State Warriors,127
Tue Nov 1 2016,0,San Antonio Spurs,-15,91,8:30 pm,Utah Jazz,106
Wed Nov 2 2016,0,Atlanta Hawks,-7,116,7:30 pm,Los Angeles Lakers,123
Wed Nov 2 2016,1,Boston Celtics,7,107,8:00 pm,Chicago Bulls,100
Wed Nov 2 2016,1,Brooklyn Nets,8,109,7:30 pm,Detroit Pistons,101
Wed Nov 2 2016,1,Charlotte Hornets,16,109,7:00 pm,Philadelphia 76ers,93
Wed Nov 2 2016,0,Los Angeles Clippers,-2,83,10:30 pm,Oklahoma City Thunder,85
Wed Nov 2 2016,1,Memphis Grizzlies,6,89,8:00 pm,New Orleans Pelicans,83
Wed Nov 2 2016,0,New York Knicks,-19,99,7:30 pm,Houston Rockets,118
Wed Nov 2 2016,1,Phoenix Suns,3,118,10:00 pm,Portland Trail Blazers,115
Wed Nov 2 2016,1,Utah Jazz,16,97,9:00 pm,Dallas Mavericks,81
Wed Nov 2 2016,0,Washington Wizards,-10,103,7:00 pm,Toronto Raptors,113
Thu Nov 3 2016,1,Cleveland Cavaliers,6,128,8:00 pm,Boston Celtics,122
Thu Nov 3 2016,1,Golden State Warriors,26,122,10:30 pm,Oklahoma City Thunder,96
Thu Nov 3 2016,1,Milwaukee Bucks,18,125,8:00 pm,Indiana Pacers,107
Thu Nov 3 2016,0,Minnesota Timberwolves,-3,99,8:00 pm,Denver Nuggets,102
Thu Nov 3 2016,1,Orlando Magic,8,102,7:00 pm,Sacramento Kings,94
Fri Nov 4 2016,0,Brooklyn Nets,-4,95,7:30 pm,Charlotte Hornets,99
Fri Nov 4 2016,0,Chicago Bulls,-13,104,8:00 pm,New York Knicks,117
Fri Nov 4 2016,0,Dallas Mavericks,-10,95,8:30 pm,Portland Trail Blazers,105
Fri Nov 4 2016,1,Los Angeles Lakers,20,117,10:30 pm,Golden State Warriors,97
Fri Nov 4 2016,0,Memphis Grizzlies,-11,88,8:00 pm,Los Angeles Clippers,99
Fri Nov 4 2016,0,New Orleans Pelicans,-1,111,8:00 pm,Phoenix Suns,112
Fri Nov 4 2016,1,Toronto Raptors,9,96,7:30 pm,Miami Heat,87
Fri Nov 4 2016,0,Utah Jazz,-14,86,9:00 pm,San Antonio Spurs,100
Fri Nov 4 2016,1,Washington Wizards,3,95,7:00 pm,Atlanta Hawks,92
Sat Nov 5 2016,1,Atlanta Hawks,15,112,7:30 pm,Houston Rockets,97
Sat Nov 5 2016,1,Detroit Pistons,17,103,7:00 pm,Denver Nuggets,86
Sat Nov 5 2016,1,Indiana Pacers,17,111,7:00 pm,Chicago Bulls,94
Sat Nov 5 2016,1,Milwaukee Bucks,26,117,8:00 pm,Sacramento Kings,91
Sat Nov 5 2016,1,Oklahoma City Thunder,20,112,6:00 pm,Minnesota Timberwolves,92
Sat Nov 5 2016,1,Orlando Magic,2,88,7:00 pm,Washington Wizards,86
Sat Nov 5 2016,0,Philadelphia 76ers,-1,101,7:00 pm,Cleveland Cavaliers,102
Sat Nov 5 2016,0,San Antonio Spurs,-24,92,8:30 pm,Los Angeles Clippers,116
Sun Nov 6 2016,0,Boston Celtics,-16,107,7:30 pm,Denver Nuggets,123
Sun Nov 6 2016,1,Dallas Mavericks,11,86,7:00 pm,Milwaukee Bucks,75
Sun Nov 6 2016,1,Los Angeles Lakers,11,119,9:30 pm,Phoenix Suns,108
Sun Nov 6 2016,0,Memphis Grizzlies,-6,94,3:30 pm,Portland Trail Blazers,100
Sun Nov 6 2016,0,New York Knicks,-5,109,12:00 pm,Utah Jazz,114
Sun Nov 6 2016,0,Toronto Raptors,-5,91,6:00 pm,Sacramento Kings,96
Mon Nov 7 2016,1,Chicago Bulls,32,112,8:00 pm,Orlando Magic,80
Mon Nov 7 2016,1,Charlotte Hornets,22,122,7:00 pm,Indiana Pacers,100
Mon Nov 7 2016,1,Golden State Warriors,10,116,10:30 pm,New Orleans Pelicans,106
Mon Nov 7 2016,1,Los Angeles Clippers,32,114,10:30 pm,Detroit Pistons,82
Mon Nov 7 2016,1,Oklahoma City Thunder,12,97,8:00 pm,Miami Heat,85
Mon Nov 7 2016,0,Philadelphia 76ers,-25,84,7:00 pm,Utah Jazz,109
Mon Nov 7 2016,0,Washington Wizards,-8,106,7:00 pm,Houston Rockets,114
Tue Nov 8 2016,1,Brooklyn Nets,9,119,7:30 pm,Minnesota Timberwolves,110
Tue Nov 8 2016,0,Cleveland Cavaliers,-4,106,7:00 pm,Atlanta Hawks,110
Tue Nov 8 2016,0,Los Angeles Lakers,-12,97,10:30 pm,Dallas Mavericks,109
Tue Nov 8 2016,1,Memphis Grizzlies,1,108,8:00 pm,Denver Nuggets,107
Tue Nov 8 2016,1,Portland Trail Blazers,3,124,10:00 pm,Phoenix Suns,121
Tue Nov 8 2016,1,Sacramento Kings,8,102,10:30 pm,New Orleans Pelicans,94
Wed Nov 9 2016,1,Atlanta Hawks,8,115,7:30 pm,Chicago Bulls,107
Wed Nov 9 2016,1,Charlotte Hornets,6,104,7:00 pm,Utah Jazz,98
Wed Nov 9 2016,1,Golden State Warriors,21,116,10:30 pm,Dallas Mavericks,95
Wed Nov 9 2016,1,Indiana Pacers,7,122,7:00 pm,Philadelphia 76ers,115
Wed Nov 9 2016,1,Los Angeles Clippers,31,111,10:30 pm,Portland Trail Blazers,80
Wed Nov 9 2016,1,New York Knicks,14,110,7:00 pm,Brooklyn Nets,96
Wed Nov 9 2016,0,Oklahoma City Thunder,-10,102,8:00 pm,Toronto Raptors,112
Wed Nov 9 2016,0,Orlando Magic,-16,107,7:00 pm,Minnesota Timberwolves,123
Wed Nov 9 2016,1,Phoenix Suns,7,107,9:00 pm,Detroit Pistons,100
Wed Nov 9 2016,0,San Antonio Spurs,-2,99,9:30 pm,Houston Rockets,101
Wed Nov 9 2016,1,Washington Wizards,25,118,7:00 pm,Boston Celtics,93
Thu Nov 10 2016,0,Denver Nuggets,-24,101,9:00 pm,Golden State Warriors,125
Thu Nov 10 2016,0,Miami Heat,-3,95,8:00 pm,Chicago Bulls,98
Thu Nov 10 2016,0,Milwaukee Bucks,-6,106,8:00 pm,New Orleans Pelicans,112
Thu Nov 10 2016,0,Sacramento Kings,-10,91,10:30 pm,Los Angeles Lakers,101
Fri Nov 11 2016,1,Boston Celtics,28,115,7:30 pm,New York Knicks,87
Fri Nov 11 2016,0,Charlotte Hornets,-2,111,7:00 pm,Toronto Raptors,113
Fri Nov 11 2016,0,Oklahoma City Thunder,-2,108,8:00 pm,Los Angeles Clippers,110
Fri Nov 11 2016,0,Orlando Magic,-13,74,7:00 pm,Utah Jazz,87
Fri Nov 11 2016,1,Philadelphia 76ers,4,109,7:00 pm,Indiana Pacers,105
Fri Nov 11 2016,1,Portland Trail Blazers,2,122,10:00 pm,Sacramento Kings,120
Fri Nov 11 2016,1,San Antonio Spurs,10,96,8:30 pm,Detroit Pistons,86
Fri Nov 11 2016,0,Washington Wizards,-11,94,7:00 pm,Cleveland Cavaliers,105
Sat Nov 12 2016,1,Atlanta Hawks,21,117,7:30 pm,Philadelphia 76ers,96
Sat Nov 12 2016,1,Chicago Bulls,11,106,8:00 pm,Washington Wizards,95
Sat Nov 12 2016,0,Denver Nuggets,-11,95,9:00 pm,Detroit Pistons,106
Sat Nov 12 2016,0,Houston Rockets,-6,100,8:00 pm,San Antonio Spurs,106
Sat Nov 12 2016,0,Indiana Pacers,-6,99,7:00 pm,Boston Celtics,105
Sat Nov 12 2016,0,Miami Heat,-11,91,8:00 pm,Utah Jazz,102
Sat Nov 12 2016,1,Milwaukee Bucks,10,106,8:30 pm,Memphis Grizzlies,96
Sat Nov 12 2016,0,Minnesota Timberwolves,-14,105,8:00 pm,Los Angeles Clippers,119
Sat Nov 12 2016,0,New Orleans Pelicans,-27,99,7:00 pm,Los Angeles Lakers,126
Sat Nov 12 2016,0,Phoenix Suns,-18,104,9:00 pm,Brooklyn Nets,122
Sat Nov 12 2016,1,Toronto Raptors,11,118,7:30 pm,New York Knicks,107
Sun Nov 13 2016,1,Cleveland Cavaliers,7,100,3:30 pm,Charlotte Hornets,93
Sun Nov 13 2016,1,Golden State Warriors,13,133,8:00 pm,Phoenix Suns,120
Sun Nov 13 2016,1,Minnesota Timberwolves,26,125,7:00 pm,Los Angeles Lakers,99
Sun Nov 13 2016,0,Oklahoma City Thunder,-2,117,7:00 pm,Orlando Magic,119
Sun Nov 13 2016,1,Portland Trail Blazers,7,112,9:00 pm,Denver Nuggets,105
Mon Nov 14 2016,1,Detroit Pistons,16,104,7:30 pm,Oklahoma City Thunder,88
Mon Nov 14 2016,1,Houston Rockets,27,115,8:00 pm,Philadelphia 76ers,88
Mon Nov 14 2016,1,Indiana Pacers,19,88,7:00 pm,Orlando Magic,69
Mon Nov 14 2016,1,Los Angeles Clippers,32,127,10:30 pm,Brooklyn Nets,95
Mon Nov 14 2016,1,New Orleans Pelicans,1,106,8:00 pm,Boston Celtics,105
Mon Nov 14 2016,1,New York Knicks,16,93,7:30 pm,Dallas Mavericks,77
Mon Nov 14 2016,1,San Antonio Spurs,4,94,8:30 pm,Miami Heat,90
Mon Nov 14 2016,0,Utah Jazz,-6,96,9:00 pm,Memphis Grizzlies,102
Tue Nov 15 2016,1,Cleveland Cavaliers,4,121,7:00 pm,Toronto Raptors,117
Tue Nov 15 2016,1,Los Angeles Lakers,7,125,10:30 pm,Brooklyn Nets,118
Tue Nov 15 2016,0,Miami Heat,-3,90,7:30 pm,Atlanta Hawks,93
Tue Nov 15 2016,0,Minnesota Timberwolves,-7,108,8:00 pm,Charlotte Hornets,115
Tue Nov 15 2016,0,Portland Trail Blazers,-25,88,10:00 pm,Chicago Bulls,113
Wed Nov 16 2016,1,Atlanta Hawks,7,107,7:30 pm,Milwaukee Bucks,100
Wed Nov 16 2016,1,Boston Celtics,7,90,7:30 pm,Dallas Mavericks,83
Wed Nov 16 2016,1,Denver Nuggets,16,120,9:00 pm,Phoenix Suns,104
Wed Nov 16 2016,1,Indiana Pacers,10,103,7:00 pm,Cleveland Cavaliers,93
Wed Nov 16 2016,0,Los Angeles Clippers,-4,107,10:30 pm,Memphis Grizzlies,111
Wed Nov 16 2016,1,New York Knicks,3,105,7:30 pm,Detroit Pistons,102
Wed Nov 16 2016,1,Oklahoma City Thunder,2,105,8:00 pm,Houston Rockets,103
Wed Nov 16 2016,1,Orlando Magic,7,89,7:00 pm,New Orleans Pelicans,82
Wed Nov 16 2016,1,Philadelphia 76ers,7,109,7:00 pm,Washington Wizards,102
Wed Nov 16 2016,0,Sacramento Kings,-5,105,10:30 pm,San Antonio Spurs,110
Wed Nov 16 2016,0,Toronto Raptors,-6,121,8:00 pm,Golden State Warriors,127
Thu Nov 17 2016,1,Houston Rockets,17,126,8:00 pm,Portland Trail Blazers,109
Thu Nov 17 2016,1,Miami Heat,23,96,7:30 pm,Milwaukee Bucks,73
Thu Nov 17 2016,1,Minnesota Timberwolves,24,110,8:00 pm,Philadelphia 76ers,86
Thu Nov 17 2016,0,Utah Jazz,-8,77,10:30 pm,Chicago Bulls,85
Thu Nov 17 2016,1,Washington Wizards,7,119,7:00 pm,New York Knicks,112
Fri Nov 18 2016,0,Boston Celtics,-16,88,8:00 pm,Golden State Warriors,104
Fri Nov 18 2016,1,Charlotte Hornets,4,100,7:00 pm,Atlanta Hawks,96
Fri Nov 18 2016,1,Cleveland Cavaliers,23,104,7:30 pm,Detroit Pistons,81
Fri Nov 18 2016,0,Dallas Mavericks,-16,64,8:30 pm,Memphis Grizzlies,80
Fri Nov 18 2016,0,Denver Nuggets,-2,111,9:00 pm,Toronto Raptors,113
Fri Nov 18 2016,0,Indiana Pacers,-20,96,7:00 pm,Phoenix Suns,116
Fri Nov 18 2016,0,Los Angeles Lakers,-9,107,10:30 pm,San Antonio Spurs,116
Fri Nov 18 2016,1,New Orleans Pelicans,12,113,8:00 pm,Portland Trail Blazers,101
Fri Nov 18 2016,1,Oklahoma City Thunder,19,124,8:00 pm,Brooklyn Nets,105
Fri Nov 18 2016,0,Sacramento Kings,-6,115,10:30 pm,Los Angeles Clippers,121
Sat Nov 19 2016,0,Detroit Pistons,-2,92,7:00 pm,Boston Celtics,94
Sat Nov 19 2016,1,Houston Rockets,9,111,5:00 pm,Utah Jazz,102
Sat Nov 19 2016,1,Los Angeles Clippers,7,102,10:30 pm,Chicago Bulls,95
Sat Nov 19 2016,1,Memphis Grizzlies,22,93,8:00 pm,Minnesota Timberwolves,71
Sat Nov 19 2016,0,Milwaukee Bucks,-3,121,8:30 pm,Golden State Warriors,124
Sat Nov 19 2016,1,New Orleans Pelicans,5,121,7:00 pm,Charlotte Hornets,116
Sat Nov 19 2016,1,Orlando Magic,8,95,7:00 pm,Dallas Mavericks,87
Sat Nov 19 2016,1,Philadelphia 76ers,15,120,7:30 pm,Phoenix Suns,105
Sat Nov 19 2016,0,Washington Wizards,-3,111,7:00 pm,Miami Heat,114
Sun Nov 20 2016,0,Brooklyn Nets,-20,109,3:30 pm,Portland Trail Blazers,129
Sun Nov 20 2016,1,Denver Nuggets,14,105,9:00 pm,Utah Jazz,91
Sun Nov 20 2016,0,Los Angeles Lakers,-8,110,9:30 pm,Chicago Bulls,118
Sun Nov 20 2016,1,New York Knicks,10,104,12:00 pm,Atlanta Hawks,94
Sun Nov 20 2016,0,Oklahoma City Thunder,-4,111,7:00 pm,Indiana Pacers,115
Sun Nov 20 2016,1,Sacramento Kings,3,102,9:00 pm,Toronto Raptors,99
Mon Nov 21 2016,0,Charlotte Hornets,-15,90,7:00 pm,Memphis Grizzlies,105
Mon Nov 21 2016,0,Detroit Pistons,-3,96,7:30 pm,Houston Rockets,99
Mon Nov 21 2016,0,Indiana Pacers,-37,83,7:00 pm,Golden State Warriors,120
Mon Nov 21 2016,1,Los Angeles Clippers,8,123,10:30 pm,Toronto Raptors,115
Mon Nov 21 2016,1,Milwaukee Bucks,4,93,8:00 pm,Orlando Magic,89
Mon Nov 21 2016,0,Minnesota Timberwolves,-6,93,8:00 pm,Boston Celtics,99
Mon Nov 21 2016,1,Philadelphia 76ers,7,101,7:00 pm,Miami Heat,94
Mon Nov 21 2016,1,San Antonio Spurs,5,96,8:30 pm,Dallas Mavericks,91
Mon Nov 21 2016,1,Washington Wizards,5,106,7:00 pm,Phoenix Suns,101
Tue Nov 22 2016,0,Atlanta Hawks,-18,94,7:30 pm,New Orleans Pelicans,112
Tue Nov 22 2016,1,Denver Nuggets,3,110,9:00 pm,Chicago Bulls,107
Tue Nov 22 2016,1,Los Angeles Lakers,2,111,10:30 pm,Oklahoma City Thunder,109
Tue Nov 22 2016,1,New York Knicks,4,107,7:30 pm,Portland Trail Blazers,103
Wed Nov 23 2016,0,Brooklyn Nets,-19,92,7:30 pm,Boston Celtics,111
Wed Nov 23 2016,0,Charlotte Hornets,-5,114,7:00 pm,San Antonio Spurs,119
Wed Nov 23 2016,1,Cleveland Cavaliers,12,137,7:00 pm,Portland Trail Blazers,125
Wed Nov 23 2016,0,Dallas Mavericks,-20,104,8:30 pm,Los Angeles Clippers,124
Wed Nov 23 2016,1,Detroit Pistons,23,107,7:30 pm,Miami Heat,84
Wed Nov 23 2016,1,Golden State Warriors,43,149,10:30 pm,Los Angeles Lakers,106
Wed Nov 23 2016,0,Houston Rockets,-13,102,8:00 pm,Toronto Raptors,115
Wed Nov 23 2016,0,Indiana Pacers,-11,85,7:00 pm,Atlanta Hawks,96
Wed Nov 23 2016,1,New Orleans Pelicans,21,117,9:30 pm,Minnesota Timberwolves,96
Wed Nov 23 2016,0,Orlando Magic,-5,87,7:00 pm,Phoenix Suns,92
Wed Nov 23 2016,0,Philadelphia 76ers,-5,99,7:00 pm,Memphis Grizzlies,104
Wed Nov 23 2016,1,Sacramento Kings,15,116,10:30 pm,Oklahoma City Thunder,101
Wed Nov 23 2016,1,Utah Jazz,25,108,9:00 pm,Denver Nuggets,83
Fri Nov 25 2016,0,Boston Celtics,-6,103,1:00 pm,San Antonio Spurs,109
Fri Nov 25 2016,1,Cleveland Cavaliers,38,128,7:30 pm,Dallas Mavericks,90
Fri Nov 25 2016,0,Denver Nuggets,-3,129,9:00 pm,Oklahoma City Thunder,132
Fri Nov 25 2016,1,Detroit Pistons,11,108,7:30 pm,Los Angeles Clippers,97
Fri Nov 25 2016,1,Indiana Pacers,21,118,8:00 pm,Brooklyn Nets,97
Fri Nov 25 2016,0,Los Angeles Lakers,-24,85,10:30 pm,Golden State Warriors,109
Fri Nov 25 2016,0,Memphis Grizzlies,-9,81,8:00 pm,Miami Heat,90
Fri Nov 25 2016,0,Milwaukee Bucks,-6,99,8:00 pm,Toronto Raptors,105
Fri Nov 25 2016,1,New York Knicks,2,113,7:30 pm,Charlotte Hornets,111
Fri Nov 25 2016,0,Orlando Magic,-3,91,7:00 pm,Washington Wizards,94
Fri Nov 25 2016,0,Philadelphia 76ers,-16,89,7:30 pm,Chicago Bulls,105
Fri Nov 25 2016,0,Phoenix Suns,-13,85,9:00 pm,Minnesota Timberwolves,98
Fri Nov 25 2016,1,Portland Trail Blazers,15,119,10:00 pm,New Orleans Pelicans,104
Fri Nov 25 2016,0,Sacramento Kings,-13,104,10:30 pm,Houston Rockets,117
Fri Nov 25 2016,1,Utah Jazz,27,95,8:00 pm,Atlanta Hawks,68
Sat Nov 26 2016,1,Charlotte Hornets,5,107,7:00 pm,New York Knicks,102
Sat Nov 26 2016,1,Golden State Warriors,13,115,10:30 pm,Minnesota Timberwolves,102
Sat Nov 26 2016,0,Miami Heat,-3,107,8:00 pm,Memphis Grizzlies,110
Sat Nov 26 2016,1,Oklahoma City Thunder,18,106,8:00 pm,Detroit Pistons,88
Sat Nov 26 2016,0,Washington Wizards,-12,100,7:00 pm,San Antonio Spurs,112
Sun Nov 27 2016,0,Brooklyn Nets,-17,105,6:00 pm,Sacramento Kings,122
Sun Nov 27 2016,1,Dallas Mavericks,10,91,7:00 pm,New Orleans Pelicans,81
Sun Nov 27 2016,1,Indiana Pacers,21,91,6:00 pm,Los Angeles Clippers,70
Sun Nov 27 2016,1,Los Angeles Lakers,15,109,9:30 pm,Atlanta Hawks,94
Sun Nov 27 2016,0,Orlando Magic,-8,96,6:00 pm,Milwaukee Bucks,104
Sun Nov 27 2016,0,Philadelphia 76ers,-4,108,1:00 pm,Cleveland Cavaliers,112
Sun Nov 27 2016,0,Phoenix Suns,-6,114,3:30 pm,Denver Nuggets,120
Sun Nov 27 2016,0,Portland Trail Blazers,-16,114,9:00 pm,Houston Rockets,130
Mon Nov 28 2016,1,Golden State Warriors,5,105,10:30 pm,Atlanta Hawks,100
Mon Nov 28 2016,0,Memphis Grizzlies,-19,85,8:00 pm,Charlotte Hornets,104
Mon Nov 28 2016,0,Miami Heat,-8,104,7:30 pm,Boston Celtics,112
Mon Nov 28 2016,0,Minnesota Timberwolves,-9,103,8:00 pm,Utah Jazz,112
Mon Nov 28 2016,0,New York Knicks,-9,103,7:30 pm,Oklahoma City Thunder,112
Mon Nov 28 2016,1,Toronto Raptors,27,122,7:30 pm,Philadelphia 76ers,95
Mon Nov 28 2016,1,Washington Wizards,6,101,7:00 pm,Sacramento Kings,95
Tue Nov 29 2016,1,Brooklyn Nets,5,127,7:30 pm,Los Angeles Clippers,122
Tue Nov 29 2016,0,Charlotte Hornets,-23,89,7:00 pm,Detroit Pistons,112
Tue Nov 29 2016,1,Milwaukee Bucks,17,118,8:00 pm,Cleveland Cavaliers,101
Tue Nov 29 2016,1,New Orleans Pelicans,17,105,8:00 pm,Los Angeles Lakers,88
Tue Nov 29 2016,0,San Antonio Spurs,-12,83,8:30 pm,Orlando Magic,95
Tue Nov 29 2016,1,Utah Jazz,19,120,9:00 pm,Houston Rockets,101
Wed Nov 30 2016,0,Boston Celtics,-7,114,7:30 pm,Detroit Pistons,121
Wed Nov 30 2016,0,Chicago Bulls,-6,90,8:00 pm,Los Angeles Lakers,96
Wed Nov 30 2016,0,Dallas Mavericks,-7,87,8:30 pm,San Antonio Spurs,94
Wed Nov 30 2016,0,Denver Nuggets,-8,98,9:00 pm,Miami Heat,106
Wed Nov 30 2016,0,Minnesota Timberwolves,-2,104,8:00 pm,New York Knicks,106
Wed Nov 30 2016,1,Oklahoma City Thunder,11,126,8:00 pm,Washington Wizards,115
Wed Nov 30 2016,1,Phoenix Suns,2,109,9:00 pm,Atlanta Hawks,107
Wed Nov 30 2016,1,Portland Trail Blazers,22,131,10:00 pm,Indiana Pacers,109
Wed Nov 30 2016,1,Toronto Raptors,15,120,7:30 pm,Memphis Grizzlies,105
Thu Dec 1 2016,0,Brooklyn Nets,-18,93,7:30 pm,Milwaukee Bucks,111
Thu Dec 1 2016,1,Charlotte Hornets,10,97,7:00 pm,Dallas Mavericks,87
Thu Dec 1 2016,0,Cleveland Cavaliers,-19,94,8:00 pm,Los Angeles Clippers,113
Thu Dec 1 2016,0,Golden State Warriors,-5,127,10:30 pm,Houston Rockets,132
Thu Dec 1 2016,1,Memphis Grizzlies,1,95,8:00 pm,Orlando Magic,94
Thu Dec 1 2016,0,Utah Jazz,-1,110,9:00 pm,Miami Heat,111
Fri Dec 2 2016,0,Atlanta Hawks,-36,85,8:00 pm,Detroit Pistons,121
Fri Dec 2 2016,1,Boston Celtics,5,97,7:30 pm,Sacramento Kings,92
Fri Dec 2 2016,1,Chicago Bulls,6,111,8:00 pm,Cleveland Cavaliers,105
Fri Dec 2 2016,0,Denver Nuggets,-18,110,10:30 pm,Houston Rockets,128
Fri Dec 2 2016,0,New Orleans Pelicans,-18,96,8:00 pm,Los Angeles Clippers,114
Fri Dec 2 2016,1,New York Knicks,4,118,7:30 pm,Minnesota Timberwolves,114
Fri Dec 2 2016,0,Philadelphia 76ers,-17,88,7:00 pm,Orlando Magic,105
Fri Dec 2 2016,1,San Antonio Spurs,2,107,8:30 pm,Washington Wizards,105
Fri Dec 2 2016,1,Toronto Raptors,33,113,7:30 pm,Los Angeles Lakers,80
Sat Dec 3 2016,0,Charlotte Hornets,-5,120,7:00 pm,Minnesota Timberwolves,125
Sat Dec 3 2016,1,Dallas Mavericks,25,107,8:30 pm,Chicago Bulls,82
Sat Dec 3 2016,1,Golden State Warriors,29,138,10:30 pm,Phoenix Suns,109
Sat Dec 3 2016,1,Memphis Grizzlies,3,103,8:00 pm,Los Angeles Lakers,100
Sat Dec 3 2016,1,Milwaukee Bucks,9,112,5:00 pm,Brooklyn Nets,103
Sat Dec 3 2016,0,Philadelphia 76ers,-1,106,7:30 pm,Boston Celtics,107
Sat Dec 3 2016,1,Portland Trail Blazers,7,99,10:00 pm,Miami Heat,92
Sat Dec 3 2016,1,Toronto Raptors,44,128,7:30 pm,Atlanta Hawks,84
Sat Dec 3 2016,1,Utah Jazz,7,105,9:00 pm,Denver Nuggets,98
Sun Dec 4 2016,0,Detroit Pistons,-6,92,6:00 pm,Orlando Magic,98
Sun Dec 4 2016,0,Los Angeles Clippers,-9,102,9:30 pm,Indiana Pacers,111
Sun Dec 4 2016,1,New York Knicks,8,106,7:30 pm,Sacramento Kings,98
Sun Dec 4 2016,1,Oklahoma City Thunder,9,101,7:00 pm,New Orleans Pelicans,92
Mon Dec 5 2016,0,Atlanta Hawks,-3,99,7:30 pm,Oklahoma City Thunder,102
Mon Dec 5 2016,0,Brooklyn Nets,-5,113,7:30 pm,Washington Wizards,118
Mon Dec 5 2016,0,Chicago Bulls,-2,110,8:00 pm,Portland Trail Blazers,112
Mon Dec 5 2016,0,Dallas Mavericks,-8,101,8:30 pm,Charlotte Hornets,109
Mon Dec 5 2016,1,Golden State Warriors,36,142,10:30 pm,Indiana Pacers,106
Mon Dec 5 2016,1,Houston Rockets,1,107,8:00 pm,Boston Celtics,106
Mon Dec 5 2016,0,Los Angeles Lakers,-6,101,10:30 pm,Utah Jazz,107
Mon Dec 5 2016,0,Milwaukee Bucks,-1,96,8:00 pm,San Antonio Spurs,97
Mon Dec 5 2016,0,New Orleans Pelicans,-2,108,8:00 pm,Memphis Grizzlies,110
Mon Dec 5 2016,0,Philadelphia 76ers,-8,98,7:00 pm,Denver Nuggets,106
Mon Dec 5 2016,0,Toronto Raptors,-4,112,7:30 pm,Cleveland Cavaliers,116
Tue Dec 6 2016,1,Detroit Pistons,11,102,7:30 pm,Chicago Bulls,91
Tue Dec 6 2016,1,Memphis Grizzlies,5,96,8:00 pm,Philadelphia 76ers,91
Tue Dec 6 2016,0,Miami Heat,-11,103,7:30 pm,New York Knicks,114
Tue Dec 6 2016,0,Minnesota Timberwolves,-14,91,8:00 pm,San Antonio Spurs,105
Tue Dec 6 2016,1,Utah Jazz,7,112,9:00 pm,Phoenix Suns,105
Tue Dec 6 2016,0,Washington Wizards,-8,116,7:00 pm,Orlando Magic,124
Wed Dec 7 2016,1,Atlanta Hawks,8,103,7:30 pm,Miami Heat,95
Wed Dec 7 2016,1,Brooklyn Nets,5,116,7:30 pm,Denver Nuggets,111
Wed Dec 7 2016,1,Charlotte Hornets,10,87,7:00 pm,Detroit Pistons,77
Wed Dec 7 2016,0,Dallas Mavericks,-31,89,8:30 pm,Sacramento Kings,120
Wed Dec 7 2016,1,Houston Rockets,39,134,8:00 pm,Los Angeles Lakers,95
Wed Dec 7 2016,0,Los Angeles Clippers,-17,98,10:30 pm,Golden State Warriors,115
Wed Dec 7 2016,1,Milwaukee Bucks,8,115,8:00 pm,Portland Trail Blazers,107
Wed Dec 7 2016,0,New York Knicks,-32,94,8:00 pm,Cleveland Cavaliers,126
Wed Dec 7 2016,0,Orlando Magic,-30,87,7:00 pm,Boston Celtics,117
Wed Dec 7 2016,0,Phoenix Suns,-15,94,9:00 pm,Indiana Pacers,109
Thu Dec 8 2016,1,Chicago Bulls,4,95,9:30 pm,San Antonio Spurs,91
Thu Dec 8 2016,1,Memphis Grizzlies,2,88,8:00 pm,Portland Trail Blazers,86
Thu Dec 8 2016,0,New Orleans Pelicans,-11,88,8:00 pm,Philadelphia 76ers,99
Thu Dec 8 2016,1,Toronto Raptors,14,124,7:00 pm,Minnesota Timberwolves,110
Thu Dec 8 2016,0,Utah Jazz,-7,99,9:00 pm,Golden State Warriors,106
Thu Dec 8 2016,1,Washington Wizards,7,92,7:00 pm,Denver Nuggets,85
Fri Dec 9 2016,0,Boston Celtics,-7,94,7:30 pm,Toronto Raptors,101
Fri Dec 9 2016,1,Charlotte Hornets,21,109,7:00 pm,Orlando Magic,88
Fri Dec 9 2016,1,Cleveland Cavaliers,30,114,7:30 pm,Miami Heat,84
Fri Dec 9 2016,1,Dallas Mavericks,8,111,8:30 pm,Indiana Pacers,103
Fri Dec 9 2016,0,Los Angeles Lakers,-4,115,10:30 pm,Phoenix Suns,119
Fri Dec 9 2016,0,Milwaukee Bucks,-4,110,8:00 pm,Atlanta Hawks,114
Fri Dec 9 2016,0,Minnesota Timberwolves,-27,90,8:00 pm,Detroit Pistons,117
Fri Dec 9 2016,0,Oklahoma City Thunder,-3,99,8:00 pm,Houston Rockets,102
Fri Dec 9 2016,0,Sacramento Kings,-3,100,10:30 pm,New York Knicks,103
Sat Dec 10 2016,1,Chicago Bulls,5,105,8:00 pm,Miami Heat,100
Sat Dec 10 2016,1,Cleveland Cavaliers,11,116,7:30 pm,Charlotte Hornets,105
Sat Dec 10 2016,1,Houston Rockets,22,109,8:00 pm,Dallas Mavericks,87
Sat Dec 10 2016,1,Indiana Pacers,7,118,7:00 pm,Portland Trail Blazers,111
Sat Dec 10 2016,1,Los Angeles Clippers,28,133,10:30 pm,New Orleans Pelicans,105
Sat Dec 10 2016,1,Memphis Grizzlies,21,110,8:00 pm,Golden State Warriors,89
Sat Dec 10 2016,0,Orlando Magic,-8,113,7:00 pm,Denver Nuggets,121
Sat Dec 10 2016,1,San Antonio Spurs,29,130,8:30 pm,Brooklyn Nets,101
Sat Dec 10 2016,1,Utah Jazz,20,104,9:00 pm,Sacramento Kings,84
Sat Dec 10 2016,1,Washington Wizards,5,110,7:00 pm,Milwaukee Bucks,105
Sun Dec 11 2016,0,Detroit Pistons,-18,79,6:00 pm,Philadelphia 76ers,97
Sun Dec 11 2016,0,Los Angeles Lakers,-6,112,9:30 pm,New York Knicks,118
Sun Dec 11 2016,0,Minnesota Timberwolves,-8,108,7:00 pm,Golden State Warriors,116
Sun Dec 11 2016,1,Oklahoma City Thunder,3,99,7:00 pm,Boston Celtics,96
Sun Dec 11 2016,0,Phoenix Suns,-1,119,8:30 pm,New Orleans Pelicans,120
Mon Dec 12 2016,1,Dallas Mavericks,20,112,8:30 pm,Denver Nuggets,92
Mon Dec 12 2016,1,Houston Rockets,4,122,8:00 pm,Brooklyn Nets,118
Mon Dec 12 2016,1,Indiana Pacers,16,110,7:00 pm,Charlotte Hornets,94
Mon Dec 12 2016,1,Los Angeles Clippers,1,121,10:30 pm,Portland Trail Blazers,120
Mon Dec 12 2016,1,Miami Heat,11,112,7:30 pm,Washington Wizards,101
Mon Dec 12 2016,1,Sacramento Kings,24,116,10:30 pm,Los Angeles Lakers,92
Mon Dec 12 2016,1,Toronto Raptors,22,122,7:30 pm,Milwaukee Bucks,100
Tue Dec 13 2016,0,Atlanta Hawks,-11,120,7:30 pm,Orlando Magic,131
Tue Dec 13 2016,0,Chicago Bulls,-5,94,8:00 pm,Minnesota Timberwolves,99
Tue Dec 13 2016,1,Cleveland Cavaliers,17,103,7:00 pm,Memphis Grizzlies,86
Tue Dec 13 2016,0,New Orleans Pelicans,-4,109,8:00 pm,Golden State Warriors,113
Tue Dec 13 2016,1,Phoenix Suns,2,113,9:00 pm,New York Knicks,111
Tue Dec 13 2016,1,Portland Trail Blazers,19,114,10:30 pm,Oklahoma City Thunder,95
Wed Dec 14 2016,1,Brooklyn Nets,10,107,7:30 pm,Los Angeles Lakers,97
Wed Dec 14 2016,0,Dallas Mavericks,-10,85,8:30 pm,Detroit Pistons,95
Wed Dec 14 2016,1,Houston Rockets,34,132,8:00 pm,Sacramento Kings,98
Wed Dec 14 2016,1,Memphis Grizzlies,8,93,8:00 pm,Cleveland Cavaliers,85
Wed Dec 14 2016,1,Miami Heat,6,95,7:00 pm,Indiana Pacers,89
Wed Dec 14 2016,0,Orlando Magic,-5,108,7:00 pm,Los Angeles Clippers,113
Wed Dec 14 2016,0,Philadelphia 76ers,-9,114,7:00 pm,Toronto Raptors,123
Wed Dec 14 2016,1,San Antonio Spurs,7,108,9:30 pm,Boston Celtics,101
Wed Dec 14 2016,1,Utah Jazz,20,109,9:00 pm,Oklahoma City Thunder,89
Wed Dec 14 2016,1,Washington Wizards,3,109,7:00 pm,Charlotte Hornets,106
Thu Dec 15 2016,1,Denver Nuggets,12,132,9:00 pm,Portland Trail Blazers,120
Thu Dec 15 2016,1,Golden State Warriors,13,103,10:30 pm,New York Knicks,90
Thu Dec 15 2016,1,Milwaukee Bucks,11,108,8:00 pm,Chicago Bulls,97
Thu Dec 15 2016,1,New Orleans Pelicans,7,102,8:00 pm,Indiana Pacers,95
Thu Dec 15 2016,0,Phoenix Suns,-15,92,9:00 pm,San Antonio Spurs,107
Fri Dec 16 2016,1,Boston Celtics,8,96,7:30 pm,Charlotte Hornets,88
Fri Dec 16 2016,0,Chicago Bulls,-26,69,8:00 pm,Milwaukee Bucks,95
Fri Dec 16 2016,1,Houston Rockets,22,122,8:00 pm,New Orleans Pelicans,100
Fri Dec 16 2016,0,Memphis Grizzlies,-4,92,8:00 pm,Sacramento Kings,96
Fri Dec 16 2016,0,Miami Heat,-4,98,8:00 pm,Los Angeles Clippers,102
Fri Dec 16 2016,1,Orlando Magic,7,118,7:00 pm,Brooklyn Nets,111
Fri Dec 16 2016,0,Philadelphia 76ers,-11,89,8:00 pm,Los Angeles Lakers,100
Fri Dec 16 2016,0,Toronto Raptors,-4,121,7:30 pm,Atlanta Hawks,125
Fri Dec 16 2016,1,Utah Jazz,3,103,10:30 pm,Dallas Mavericks,100
Fri Dec 16 2016,1,Washington Wizards,14,122,7:00 pm,Detroit Pistons,108
Sat Dec 17 2016,0,Atlanta Hawks,-8,99,7:30 pm,Charlotte Hornets,107
Sat Dec 17 2016,1,Cleveland Cavaliers,11,119,7:30 pm,Los Angeles Lakers,108
Sat Dec 17 2016,1,Denver Nuggets,13,127,9:00 pm,New York Knicks,114
Sat Dec 17 2016,0,Detroit Pistons,-15,90,7:00 pm,Indiana Pacers,105
Sat Dec 17 2016,1,Golden State Warriors,45,135,10:30 pm,Portland Trail Blazers,90
Sat Dec 17 2016,0,Minnesota Timberwolves,-2,109,8:00 pm,Houston Rockets,111
Sat Dec 17 2016,1,Oklahoma City Thunder,13,114,5:00 pm,Phoenix Suns,101
Sun Dec 18 2016,1,Dallas Mavericks,20,99,4:00 pm,Sacramento Kings,79
Sun Dec 18 2016,0,Memphis Grizzlies,-9,73,6:00 pm,Utah Jazz,82
Sun Dec 18 2016,0,Miami Heat,-10,95,6:00 pm,Boston Celtics,105
Sun Dec 18 2016,0,Orlando Magic,-30,79,6:00 pm,Toronto Raptors,109
Sun Dec 18 2016,1,Philadelphia 76ers,1,108,6:00 pm,Brooklyn Nets,107
Sun Dec 18 2016,1,San Antonio Spurs,13,113,7:00 pm,New Orleans Pelicans,100
Sun Dec 18 2016,1,Washington Wizards,7,117,3:30 pm,Los Angeles Clippers,110
Mon Dec 19 2016,1,Chicago Bulls,31,113,8:00 pm,Detroit Pistons,82
Mon Dec 19 2016,1,Denver Nuggets,10,117,9:00 pm,Dallas Mavericks,107
Mon Dec 19 2016,1,Indiana Pacers,2,107,7:00 pm,Washington Wizards,105
Mon Dec 19 2016,1,Minnesota Timberwolves,7,115,8:00 pm,Phoenix Suns,108
Mon Dec 19 2016,0,Oklahoma City Thunder,-2,108,8:00 pm,Atlanta Hawks,110
Tue Dec 20 2016,1,Charlotte Hornets,4,117,7:00 pm,Los Angeles Lakers,113
Tue Dec 20 2016,1,Golden State Warriors,30,104,10:30 pm,Utah Jazz,74
Tue Dec 20 2016,0,Houston Rockets,-2,100,8:00 pm,San Antonio Spurs,102
Tue Dec 20 2016,1,Los Angeles Clippers,17,119,10:30 pm,Denver Nuggets,102
Tue Dec 20 2016,0,Memphis Grizzlies,-3,109,8:00 pm,Boston Celtics,112
Tue Dec 20 2016,0,Miami Heat,-6,130,7:30 pm,Orlando Magic,136
Tue Dec 20 2016,0,Milwaukee Bucks,-6,108,8:00 pm,Cleveland Cavaliers,114
Tue Dec 20 2016,1,New York Knicks,7,118,7:30 pm,Indiana Pacers,111
Tue Dec 20 2016,0,Philadelphia 76ers,-15,93,7:00 pm,New Orleans Pelicans,108
Tue Dec 20 2016,1,Sacramento Kings,5,126,10:30 pm,Portland Trail Blazers,121
Tue Dec 20 2016,1,Toronto Raptors,12,116,7:30 pm,Brooklyn Nets,104
Wed Dec 21 2016,0,Atlanta Hawks,-8,84,7:30 pm,Minnesota Timberwolves,92
Wed Dec 21 2016,0,Chicago Bulls,-10,97,8:00 pm,Washington Wizards,107
Wed Dec 21 2016,1,Cleveland Cavaliers,11,113,7:00 pm,Milwaukee Bucks,102
Wed Dec 21 2016,0,Detroit Pistons,-12,86,7:30 pm,Memphis Grizzlies,98
Wed Dec 21 2016,0,New Orleans Pelicans,-11,110,8:00 pm,Oklahoma City Thunder,121
Wed Dec 21 2016,0,Phoenix Suns,-14,111,9:00 pm,Houston Rockets,125
Wed Dec 21 2016,0,Portland Trail Blazers,-1,95,10:00 pm,Dallas Mavericks,96
Wed Dec 21 2016,0,Utah Jazz,-1,93,9:00 pm,Sacramento Kings,94
Thu Dec 22 2016,0,Brooklyn Nets,-16,101,7:30 pm,Golden State Warriors,117
Thu Dec 22 2016,0,Indiana Pacers,-7,102,7:00 pm,Boston Celtics,109
Thu Dec 22 2016,1,Los Angeles Clippers,5,106,10:30 pm,San Antonio Spurs,101
Thu Dec 22 2016,1,Miami Heat,8,115,8:00 pm,Los Angeles Lakers,107
Thu Dec 22 2016,1,New York Knicks,11,106,7:30 pm,Orlando Magic,95
Fri Dec 23 2016,0,Boston Celtics,-5,112,7:30 pm,Oklahoma City Thunder,117
Fri Dec 23 2016,1,Charlotte Hornets,12,103,7:00 pm,Chicago Bulls,91
Fri Dec 23 2016,1,Cleveland Cavaliers,20,119,7:30 pm,Brooklyn Nets,99
Fri Dec 23 2016,0,Denver Nuggets,-1,108,9:00 pm,Atlanta Hawks,109
Fri Dec 23 2016,0,Detroit Pistons,-6,113,7:30 pm,Golden State Warriors,119
Fri Dec 23 2016,0,Los Angeles Clippers,-2,88,10:30 pm,Dallas Mavericks,90
Fri Dec 23 2016,1,Memphis Grizzlies,6,115,8:00 pm,Houston Rockets,109
Fri Dec 23 2016,1,Milwaukee Bucks,27,123,8:00 pm,Washington Wizards,96
Fri Dec 23 2016,0,Minnesota Timberwolves,-4,105,8:00 pm,Sacramento Kings,109
Fri Dec 23 2016,1,New Orleans Pelicans,4,91,8:00 pm,Miami Heat,87
Fri Dec 23 2016,1,Orlando Magic,19,109,7:00 pm,Los Angeles Lakers,90
Fri Dec 23 2016,1,Phoenix Suns,7,123,9:00 pm,Philadelphia 76ers,116
Fri Dec 23 2016,0,Portland Trail Blazers,-20,90,10:00 pm,San Antonio Spurs,110
Fri Dec 23 2016,0,Utah Jazz,-6,98,9:00 pm,Toronto Raptors,104
Sun Dec 25 2016,1,Cleveland Cavaliers,1,109,2:30 pm,Golden State Warriors,108
Sun Dec 25 2016,1,Los Angeles Lakers,9,111,10:30 pm,Los Angeles Clippers,102
Sun Dec 25 2016,0,New York Knicks,-5,114,12:00 pm,Boston Celtics,119
Sun Dec 25 2016,1,Oklahoma City Thunder,12,112,8:00 pm,Minnesota Timberwolves,100
Sun Dec 25 2016,1,San Antonio Spurs,19,119,5:00 pm,Chicago Bulls,100
Mon Dec 26 2016,1,Brooklyn Nets,2,120,7:30 pm,Charlotte Hornets,118
Mon Dec 26 2016,1,Chicago Bulls,5,90,8:00 pm,Indiana Pacers,85
Mon Dec 26 2016,1,Detroit Pistons,16,106,7:30 pm,Cleveland Cavaliers,90
Mon Dec 26 2016,1,Houston Rockets,16,131,8:00 pm,Phoenix Suns,115
Mon Dec 26 2016,0,Los Angeles Clippers,-4,102,10:30 pm,Denver Nuggets,106
Mon Dec 26 2016,1,Minnesota Timberwolves,14,104,8:00 pm,Atlanta Hawks,90
Mon Dec 26 2016,1,New Orleans Pelicans,7,111,8:00 pm,Dallas Mavericks,104
Mon Dec 26 2016,1,Orlando Magic,10,112,7:00 pm,Memphis Grizzlies,102
Mon Dec 26 2016,0,Portland Trail Blazers,-4,91,10:00 pm,Toronto Raptors,95
Mon Dec 26 2016,1,Sacramento Kings,2,102,10:30 pm,Philadelphia 76ers,100
Mon Dec 26 2016,1,Washington Wizards,5,107,7:00 pm,Milwaukee Bucks,102
Tue Dec 27 2016,1,Boston Celtics,10,113,7:30 pm,Memphis Grizzlies,103
Tue Dec 27 2016,0,Dallas Mavericks,-16,107,8:30 pm,Houston Rockets,123
Tue Dec 27 2016,0,Los Angeles Lakers,-2,100,10:30 pm,Utah Jazz,102
Tue Dec 27 2016,0,Miami Heat,-12,94,7:30 pm,Oklahoma City Thunder,106
Wed Dec 28 2016,1,Atlanta Hawks,4,102,7:30 pm,New York Knicks,98
Wed Dec 28 2016,1,Chicago Bulls,2,101,8:00 pm,Brooklyn Nets,99
Wed Dec 28 2016,1,Denver Nuggets,2,105,9:00 pm,Minnesota Timberwolves,103
Wed Dec 28 2016,0,Detroit Pistons,-25,94,7:30 pm,Milwaukee Bucks,119
Wed Dec 28 2016,1,Golden State Warriors,10,121,10:30 pm,Toronto Raptors,111
Wed Dec 28 2016,1,New Orleans Pelicans,4,102,8:00 pm,Los Angeles Clippers,98
Wed Dec 28 2016,0,Orlando Magic,-19,101,7:00 pm,Charlotte Hornets,120
Wed Dec 28 2016,1,Portland Trail Blazers,13,102,10:00 pm,Sacramento Kings,89
Wed Dec 28 2016,1,San Antonio Spurs,21,119,8:30 pm,Phoenix Suns,98
Wed Dec 28 2016,1,Washington Wizards,6,111,7:00 pm,Indiana Pacers,105
Thu Dec 29 2016,1,Charlotte Hornets,9,91,7:00 pm,Miami Heat,82
Thu Dec 29 2016,1,Cleveland Cavaliers,6,124,8:00 pm,Boston Celtics,118
Thu Dec 29 2016,0,Los Angeles Lakers,-12,89,10:30 pm,Dallas Mavericks,101
Thu Dec 29 2016,1,Memphis Grizzlies,34,114,8:00 pm,Oklahoma City Thunder,80
Thu Dec 29 2016,1,Phoenix Suns,8,99,9:00 pm,Toronto Raptors,91
Thu Dec 29 2016,1,Utah Jazz,17,100,9:00 pm,Philadelphia 76ers,83
Fri Dec 30 2016,1,Atlanta Hawks,7,105,8:00 pm,Detroit Pistons,98
Fri Dec 30 2016,1,Boston Celtics,3,117,7:30 pm,Miami Heat,114
Fri Dec 30 2016,0,Denver Nuggets,-2,122,9:00 pm,Philadelphia 76ers,124
Fri Dec 30 2016,1,Golden State Warriors,9,108,10:30 pm,Dallas Mavericks,99
Fri Dec 30 2016,1,Houston Rockets,24,140,8:00 pm,Los Angeles Clippers,116
Fri Dec 30 2016,1,Indiana Pacers,10,111,4:00 pm,Chicago Bulls,101
Fri Dec 30 2016,1,Minnesota Timberwolves,17,116,8:00 pm,Milwaukee Bucks,99
Fri Dec 30 2016,1,New Orleans Pelicans,12,104,8:00 pm,New York Knicks,92
Fri Dec 30 2016,1,San Antonio Spurs,16,110,8:30 pm,Portland Trail Blazers,94
Fri Dec 30 2016,1,Washington Wizards,23,118,7:00 pm,Brooklyn Nets,95
Sat Dec 31 2016,0,Chicago Bulls,-20,96,7:00 pm,Milwaukee Bucks,116
Sat Dec 31 2016,0,Charlotte Hornets,-12,109,7:00 pm,Cleveland Cavaliers,121
Sat Dec 31 2016,1,Houston Rockets,7,129,8:00 pm,New York Knicks,122
Sat Dec 31 2016,1,Oklahoma City Thunder,26,114,8:00 pm,Los Angeles Clippers,88
Sat Dec 31 2016,0,Sacramento Kings,-14,98,5:00 pm,Memphis Grizzlies,112
Sat Dec 31 2016,1,Utah Jazz,5,91,8:00 pm,Phoenix Suns,86
Sun Jan 1 2017,1,Atlanta Hawks,2,114,6:00 pm,San Antonio Spurs,112
Sun Jan 1 2017,1,Indiana Pacers,13,117,6:00 pm,Orlando Magic,104
Sun Jan 1 2017,0,Los Angeles Lakers,-9,114,9:30 pm,Toronto Raptors,123
Sun Jan 1 2017,0,Miami Heat,-9,98,6:00 pm,Detroit Pistons,107
Sun Jan 1 2017,0,Minnesota Timberwolves,-6,89,7:00 pm,Portland Trail Blazers,95
Mon Jan 2 2017,0,Brooklyn Nets,-12,89,7:30 pm,Utah Jazz,101
Mon Jan 2 2017,1,Chicago Bulls,7,118,8:00 pm,Charlotte Hornets,111
Mon Jan 2 2017,1,Cleveland Cavaliers,8,90,7:00 pm,New Orleans Pelicans,82
Mon Jan 2 2017,1,Golden State Warriors,8,127,10:30 pm,Denver Nuggets,119
Mon Jan 2 2017,1,Houston Rockets,10,101,8:00 pm,Washington Wizards,91
Mon Jan 2 2017,1,Los Angeles Clippers,11,109,10:30 pm,Phoenix Suns,98
Mon Jan 2 2017,1,Milwaukee Bucks,4,98,7:00 pm,Oklahoma City Thunder,94
Mon Jan 2 2017,0,New York Knicks,-12,103,7:30 pm,Orlando Magic,115
Tue Jan 3 2017,1,Boston Celtics,11,115,7:30 pm,Utah Jazz,104
Tue Jan 3 2017,1,Dallas Mavericks,8,113,8:30 pm,Washington Wizards,105
Tue Jan 3 2017,0,Denver Nuggets,-7,113,9:00 pm,Sacramento Kings,120
Tue Jan 3 2017,0,Detroit Pistons,-5,116,7:30 pm,Indiana Pacers,121
Tue Jan 3 2017,1,Los Angeles Lakers,14,116,10:30 pm,Memphis Grizzlies,102
Tue Jan 3 2017,1,Philadelphia 76ers,2,93,7:00 pm,Minnesota Timberwolves,91
Tue Jan 3 2017,1,Phoenix Suns,9,99,9:00 pm,Miami Heat,90
Tue Jan 3 2017,1,San Antonio Spurs,28,110,8:30 pm,Toronto Raptors,82
Wed Jan 4 2017,1,Charlotte Hornets,11,123,7:00 pm,Oklahoma City Thunder,112
Wed Jan 4 2017,0,Cleveland Cavaliers,-12,94,8:00 pm,Chicago Bulls,106
Wed Jan 4 2017,1,Golden State Warriors,8,125,10:30 pm,Portland Trail Blazers,117
Wed Jan 4 2017,1,Los Angeles Clippers,9,115,10:30 pm,Memphis Grizzlies,106
Wed Jan 4 2017,0,New York Knicks,-1,104,7:30 pm,Milwaukee Bucks,105
Wed Jan 4 2017,0,Orlando Magic,-19,92,7:00 pm,Atlanta Hawks,111
Wed Jan 4 2017,0,Sacramento Kings,-5,102,10:30 pm,Miami Heat,107
Thu Jan 5 2017,0,Dallas Mavericks,-7,95,8:30 pm,Phoenix Suns,102
Thu Jan 5 2017,0,Denver Nuggets,-28,99,9:00 pm,San Antonio Spurs,127
Thu Jan 5 2017,1,Detroit Pistons,1,115,7:30 pm,Charlotte Hornets,114
Thu Jan 5 2017,1,Houston Rockets,2,118,8:00 pm,Oklahoma City Thunder,116
Thu Jan 5 2017,1,Indiana Pacers,12,121,7:00 pm,Brooklyn Nets,109
Thu Jan 5 2017,0,New Orleans Pelicans,-5,94,8:00 pm,Atlanta Hawks,99
Thu Jan 5 2017,1,Portland Trail Blazers,9,118,10:30 pm,Los Angeles Lakers,109
Thu Jan 5 2017,1,Toronto Raptors,8,101,7:30 pm,Utah Jazz,93
Fri Jan 6 2017,1,Boston Celtics,4,110,7:30 pm,Philadelphia 76ers,106
Fri Jan 6 2017,0,Brooklyn Nets,-8,108,7:30 pm,Cleveland Cavaliers,116
Fri Jan 6 2017,0,Golden State Warriors,-9,119,10:30 pm,Memphis Grizzlies,128
Fri Jan 6 2017,1,Los Angeles Lakers,27,127,10:30 pm,Miami Heat,100
Fri Jan 6 2017,0,Milwaukee Bucks,-5,111,8:00 pm,New York Knicks,116
Fri Jan 6 2017,0,Orlando Magic,-7,93,7:00 pm,Houston Rockets,100
Fri Jan 6 2017,0,Sacramento Kings,-8,98,10:30 pm,Los Angeles Clippers,106
Fri Jan 6 2017,1,Washington Wizards,7,112,7:00 pm,Minnesota Timberwolves,105
Sat Jan 7 2017,1,Boston Celtics,9,117,7:30 pm,New Orleans Pelicans,108
Sat Jan 7 2017,1,Chicago Bulls,5,123,8:00 pm,Toronto Raptors,118
Sat Jan 7 2017,0,Dallas Mavericks,-15,82,8:30 pm,Atlanta Hawks,97
Sat Jan 7 2017,1,Indiana Pacers,14,123,7:00 pm,New York Knicks,109
Sat Jan 7 2017,0,Minnesota Timberwolves,-2,92,8:00 pm,Utah Jazz,94
Sat Jan 7 2017,1,Oklahoma City Thunder,15,121,8:00 pm,Denver Nuggets,106
Sat Jan 7 2017,1,San Antonio Spurs,17,102,8:30 pm,Charlotte Hornets,85
Sun Jan 8 2017,0,Brooklyn Nets,-10,95,12:00 pm,Philadelphia 76ers,105
Sun Jan 8 2017,1,Los Angeles Clippers,12,98,3:30 pm,Miami Heat,86
Sun Jan 8 2017,1,Los Angeles Lakers,16,111,9:30 pm,Orlando Magic,95
Sun Jan 8 2017,1,Memphis Grizzlies,9,88,8:00 pm,Utah Jazz,79
Sun Jan 8 2017,0,Milwaukee Bucks,-6,101,2:00 pm,Washington Wizards,107
Sun Jan 8 2017,0,Phoenix Suns,-4,116,8:30 pm,Cleveland Cavaliers,120
Sun Jan 8 2017,0,Portland Trail Blazers,-1,124,9:00 pm,Detroit Pistons,125
Sun Jan 8 2017,0,Sacramento Kings,-11,106,9:00 pm,Golden State Warriors,117
Sun Jan 8 2017,0,Toronto Raptors,-7,122,6:00 pm,Houston Rockets,129
Mon Jan 9 2017,0,Chicago Bulls,-15,94,8:00 pm,Oklahoma City Thunder,109
Mon Jan 9 2017,1,Minnesota Timberwolves,9,101,8:00 pm,Dallas Mavericks,92
Mon Jan 9 2017,0,New York Knicks,-14,96,7:30 pm,New Orleans Pelicans,110
Tue Jan 10 2017,0,Brooklyn Nets,-20,97,7:30 pm,Atlanta Hawks,117
Tue Jan 10 2017,1,Golden State Warriors,12,107,10:30 pm,Miami Heat,95
Tue Jan 10 2017,1,Houston Rockets,7,121,8:00 pm,Charlotte Hornets,114
Tue Jan 10 2017,0,Los Angeles Lakers,-21,87,10:30 pm,Portland Trail Blazers,108
Tue Jan 10 2017,1,Sacramento Kings,6,100,10:30 pm,Detroit Pistons,94
Tue Jan 10 2017,0,San Antonio Spurs,-2,107,8:30 pm,Milwaukee Bucks,109
Tue Jan 10 2017,1,Toronto Raptors,8,114,7:30 pm,Boston Celtics,106
Tue Jan 10 2017,1,Utah Jazz,8,100,9:00 pm,Cleveland Cavaliers,92
Tue Jan 10 2017,1,Washington Wizards,2,101,7:00 pm,Chicago Bulls,99
Wed Jan 11 2017,1,Boston Celtics,9,117,8:00 pm,Washington Wizards,108
Wed Jan 11 2017,1,Los Angeles Clippers,9,105,10:30 pm,Orlando Magic,96
Wed Jan 11 2017,1,Minnesota Timberwolves,14,119,8:00 pm,Houston Rockets,105
Wed Jan 11 2017,1,Oklahoma City Thunder,8,103,8:00 pm,Memphis Grizzlies,95
Wed Jan 11 2017,1,Philadelphia 76ers,1,98,7:00 pm,New York Knicks,97
Wed Jan 11 2017,1,Portland Trail Blazers,16,102,10:30 pm,Cleveland Cavaliers,86
Thu Jan 12 2017,0,Brooklyn Nets,-9,95,7:30 pm,New Orleans Pelicans,104
Thu Jan 12 2017,1,Denver Nuggets,28,140,3:00 pm,Indiana Pacers,112
Thu Jan 12 2017,1,Golden State Warriors,20,127,10:30 pm,Detroit Pistons,107
Thu Jan 12 2017,1,New York Knicks,15,104,8:00 pm,Chicago Bulls,89
Thu Jan 12 2017,0,Phoenix Suns,-5,108,10:00 pm,Dallas Mavericks,113
Thu Jan 12 2017,1,San Antonio Spurs,40,134,8:30 pm,Los Angeles Lakers,94
Fri Jan 13 2017,0,Atlanta Hawks,-2,101,8:00 pm,Boston Celtics,103
Fri Jan 13 2017,0,Houston Rockets,-5,105,8:00 pm,Memphis Grizzlies,110
Fri Jan 13 2017,1,Milwaukee Bucks,8,116,8:00 pm,Miami Heat,108
Fri Jan 13 2017,1,Minnesota Timberwolves,10,96,8:00 pm,Oklahoma City Thunder,86
Fri Jan 13 2017,1,Philadelphia 76ers,9,102,7:00 pm,Charlotte Hornets,93
Fri Jan 13 2017,0,Portland Trail Blazers,-6,109,10:00 pm,Orlando Magic,115
Fri Jan 13 2017,0,Sacramento Kings,-12,108,10:30 pm,Cleveland Cavaliers,120
Fri Jan 13 2017,1,Toronto Raptors,19,132,7:30 pm,Brooklyn Nets,113
Fri Jan 13 2017,1,Utah Jazz,33,110,10:30 pm,Detroit Pistons,77
Sat Jan 14 2017,1,Chicago Bulls,8,107,5:00 pm,New Orleans Pelicans,99
Sat Jan 14 2017,1,Los Angeles Clippers,16,113,3:30 pm,Los Angeles Lakers,97
Sat Jan 14 2017,1,Phoenix Suns,3,108,6:00 pm,San Antonio Spurs,105
Sat Jan 14 2017,1,Utah Jazz,7,114,9:00 pm,Orlando Magic,107
Sat Jan 14 2017,1,Washington Wizards,16,109,8:00 pm,Philadelphia 76ers,93
Sun Jan 15 2017,1,Atlanta Hawks,13,111,3:00 pm,Milwaukee Bucks,98
Sun Jan 15 2017,0,Brooklyn Nets,-25,112,6:00 pm,Houston Rockets,137
Sun Jan 15 2017,1,Dallas Mavericks,11,98,2:00 pm,Minnesota Timberwolves,87
Sun Jan 15 2017,0,Los Angeles Lakers,-5,97,9:30 pm,Detroit Pistons,102
Sun Jan 15 2017,0,Memphis Grizzlies,-4,104,9:00 pm,Chicago Bulls,108
Sun Jan 15 2017,0,Sacramento Kings,-4,118,9:00 pm,Oklahoma City Thunder,122
Sun Jan 15 2017,1,Toronto Raptors,15,116,3:00 pm,New York Knicks,101
Mon Jan 16 2017,1,Boston Celtics,10,108,7:30 pm,Charlotte Hornets,98
Mon Jan 16 2017,1,Denver Nuggets,13,125,5:00 pm,Orlando Magic,112
Mon Jan 16 2017,1,Golden State Warriors,35,126,8:00 pm,Cleveland Cavaliers,91
Mon Jan 16 2017,1,Indiana Pacers,3,98,4:00 pm,New Orleans Pelicans,95
Mon Jan 16 2017,1,Los Angeles Clippers,22,120,10:30 pm,Oklahoma City Thunder,98
Mon Jan 16 2017,0,Milwaukee Bucks,-9,104,3:30 pm,Philadelphia 76ers,113
Mon Jan 16 2017,0,New York Knicks,-1,107,1:00 pm,Atlanta Hawks,108
Mon Jan 16 2017,0,Phoenix Suns,-5,101,9:00 pm,Utah Jazz,106
Mon Jan 16 2017,1,Washington Wizards,19,120,2:00 pm,Portland Trail Blazers,101
Tue Jan 17 2017,0,Brooklyn Nets,-10,109,7:30 pm,Toronto Raptors,119
Tue Jan 17 2017,0,Chicago Bulls,-1,98,8:00 pm,Dallas Mavericks,99
Tue Jan 17 2017,0,Los Angeles Lakers,-6,121,10:30 pm,Denver Nuggets,127
Tue Jan 17 2017,1,Miami Heat,6,109,7:30 pm,Houston Rockets,103
Tue Jan 17 2017,1,San Antonio Spurs,8,122,8:30 pm,Minnesota Timberwolves,114
Wed Jan 18 2017,0,Boston Celtics,-11,106,7:30 pm,New York Knicks,117
Wed Jan 18 2017,1,Charlotte Hornets,22,107,7:00 pm,Portland Trail Blazers,85
Wed Jan 18 2017,1,Detroit Pistons,23,118,8:00 pm,Atlanta Hawks,95
Wed Jan 18 2017,1,Golden State Warriors,21,121,10:30 pm,Oklahoma City Thunder,100
Wed Jan 18 2017,1,Houston Rockets,19,111,8:00 pm,Milwaukee Bucks,92
Wed Jan 18 2017,1,New Orleans Pelicans,20,118,8:00 pm,Orlando Magic,98
Wed Jan 18 2017,1,Philadelphia 76ers,5,94,7:00 pm,Toronto Raptors,89
Wed Jan 18 2017,0,Sacramento Kings,-6,100,10:30 pm,Indiana Pacers,106
Wed Jan 18 2017,1,Washington Wizards,3,104,7:00 pm,Memphis Grizzlies,101
Thu Jan 19 2017,1,Cleveland Cavaliers,15,118,7:00 pm,Phoenix Suns,103
Thu Jan 19 2017,0,Los Angeles Clippers,-3,101,10:30 pm,Minnesota Timberwolves,104
Thu Jan 19 2017,1,Miami Heat,4,99,7:30 pm,Dallas Mavericks,95
Thu Jan 19 2017,0,New York Knicks,-3,110,8:00 pm,Washington Wizards,113
Thu Jan 19 2017,1,San Antonio Spurs,14,118,8:30 pm,Denver Nuggets,104
Fri Jan 20 2017,1,Atlanta Hawks,9,102,8:00 pm,Chicago Bulls,93
Fri Jan 20 2017,1,Charlotte Hornets,35,113,7:00 pm,Toronto Raptors,78
Fri Jan 20 2017,0,Dallas Mavericks,-5,107,8:30 pm,Utah Jazz,112
Fri Jan 20 2017,0,Houston Rockets,-17,108,8:00 pm,Golden State Warriors,125
Fri Jan 20 2017,1,Los Angeles Lakers,13,108,10:30 pm,Indiana Pacers,95
Fri Jan 20 2017,1,Memphis Grizzlies,16,107,8:00 pm,Sacramento Kings,91
Fri Jan 20 2017,0,New Orleans Pelicans,-29,114,8:00 pm,Brooklyn Nets,143
Fri Jan 20 2017,1,Orlando Magic,16,112,7:00 pm,Milwaukee Bucks,96
Fri Jan 20 2017,1,Philadelphia 76ers,1,93,7:00 pm,Portland Trail Blazers,92
Sat Jan 21 2017,1,Atlanta Hawks,17,110,7:00 pm,Philadelphia 76ers,93
Sat Jan 21 2017,0,Boston Celtics,-4,123,5:00 pm,Portland Trail Blazers,127
Sat Jan 21 2017,1,Chicago Bulls,3,102,9:00 pm,Sacramento Kings,99
Sat Jan 21 2017,1,Charlotte Hornets,7,112,7:00 pm,Brooklyn Nets,105
Sat Jan 21 2017,0,Cleveland Cavaliers,-3,115,8:30 pm,San Antonio Spurs,118
Sat Jan 21 2017,1,Denver Nuggets,25,123,9:00 pm,Los Angeles Clippers,98
Sat Jan 21 2017,1,Detroit Pistons,1,113,6:00 pm,Washington Wizards,112
Sat Jan 21 2017,0,Memphis Grizzlies,-24,95,8:00 pm,Houston Rockets,119
Sat Jan 21 2017,1,Miami Heat,12,109,7:30 pm,Milwaukee Bucks,97
Sat Jan 21 2017,0,New York Knicks,-2,105,7:30 pm,Phoenix Suns,107
Sat Jan 21 2017,1,Utah Jazz,9,109,9:00 pm,Indiana Pacers,100
Sun Jan 22 2017,1,Dallas Mavericks,49,122,3:30 pm,Los Angeles Lakers,73
Sun Jan 22 2017,1,Minnesota Timberwolves,3,111,7:00 pm,Denver Nuggets,108
Sun Jan 22 2017,0,Orlando Magic,-20,98,12:00 pm,Golden State Warriors,118
Sun Jan 22 2017,0,Toronto Raptors,-12,103,6:00 pm,Phoenix Suns,115
Mon Jan 23 2017,0,Atlanta Hawks,-10,105,7:30 pm,Los Angeles Clippers,115
Mon Jan 23 2017,0,Brooklyn Nets,-26,86,7:30 pm,San Antonio Spurs,112
Mon Jan 23 2017,0,Charlotte Hornets,-10,99,7:00 pm,Washington Wizards,109
Mon Jan 23 2017,0,Detroit Pistons,-5,104,7:30 pm,Sacramento Kings,109
Mon Jan 23 2017,0,Indiana Pacers,-6,103,8:00 pm,New York Knicks,109
Mon Jan 23 2017,1,Miami Heat,3,105,7:30 pm,Golden State Warriors,102
Mon Jan 23 2017,1,Milwaukee Bucks,13,127,8:00 pm,Houston Rockets,114
Mon Jan 23 2017,1,New Orleans Pelicans,2,124,8:00 pm,Cleveland Cavaliers,122
Mon Jan 23 2017,0,Utah Jazz,-2,95,9:00 pm,Oklahoma City Thunder,97
Tue Jan 24 2017,1,Denver Nuggets,10,103,9:00 pm,Utah Jazz,93
Tue Jan 24 2017,0,Orlando Magic,-8,92,7:00 pm,Chicago Bulls,100
Tue Jan 24 2017,1,Philadelphia 76ers,11,121,7:00 pm,Los Angeles Clippers,110
Tue Jan 24 2017,0,Phoenix Suns,-1,111,9:00 pm,Minnesota Timberwolves,112
Tue Jan 24 2017,0,Toronto Raptors,-2,106,7:00 pm,San Antonio Spurs,108
Tue Jan 24 2017,1,Washington Wizards,15,123,7:00 pm,Boston Celtics,108
Wed Jan 25 2017,1,Boston Celtics,11,120,7:30 pm,Houston Rockets,109
Wed Jan 25 2017,0,Brooklyn Nets,-3,106,7:30 pm,Miami Heat,109
Wed Jan 25 2017,0,Chicago Bulls,-5,114,8:00 pm,Atlanta Hawks,119
Wed Jan 25 2017,0,Charlotte Hornets,-10,103,8:00 pm,Golden State Warriors,113
Wed Jan 25 2017,0,Cleveland Cavaliers,-4,112,7:00 pm,Sacramento Kings,116
Wed Jan 25 2017,1,Dallas Mavericks,8,103,8:30 pm,New York Knicks,95
Wed Jan 25 2017,1,Memphis Grizzlies,2,101,8:00 pm,Toronto Raptors,99
Wed Jan 25 2017,0,Milwaukee Bucks,-5,109,8:00 pm,Philadelphia 76ers,114
Wed Jan 25 2017,0,New Orleans Pelicans,-9,105,8:00 pm,Oklahoma City Thunder,114
Wed Jan 25 2017,1,Portland Trail Blazers,7,105,10:30 pm,Los Angeles Lakers,98
Thu Jan 26 2017,1,Denver Nuggets,7,127,9:00 pm,Phoenix Suns,120
Thu Jan 26 2017,0,Minnesota Timberwolves,-6,103,8:00 pm,Indiana Pacers,109
Thu Jan 26 2017,1,Oklahoma City Thunder,11,109,8:00 pm,Dallas Mavericks,98
Thu Jan 26 2017,1,Utah Jazz,8,96,10:30 pm,Los Angeles Lakers,88
Fri Jan 27 2017,0,Atlanta Hawks,-26,86,8:00 pm,Washington Wizards,112
Fri Jan 27 2017,1,Boston Celtics,30,128,7:30 pm,Orlando Magic,98
Fri Jan 27 2017,0,Chicago Bulls,-12,88,8:00 pm,Miami Heat,100
Fri Jan 27 2017,1,Cleveland Cavaliers,8,124,7:30 pm,Brooklyn Nets,116
Fri Jan 27 2017,1,Indiana Pacers,4,115,7:00 pm,Sacramento Kings,111
Fri Jan 27 2017,1,New Orleans Pelicans,16,119,8:00 pm,San Antonio Spurs,103
Fri Jan 27 2017,1,New York Knicks,3,110,7:30 pm,Charlotte Hornets,107
Fri Jan 27 2017,0,Philadelphia 76ers,-5,118,8:00 pm,Houston Rockets,123
Fri Jan 27 2017,1,Portland Trail Blazers,3,112,10:00 pm,Memphis Grizzlies,109
Fri Jan 27 2017,1,Toronto Raptors,16,102,7:30 pm,Milwaukee Bucks,86
Sat Jan 28 2017,0,Charlotte Hornets,-3,106,7:00 pm,Sacramento Kings,109
Sat Jan 28 2017,1,Golden State Warriors,46,144,8:30 pm,Los Angeles Clippers,98
Sat Jan 28 2017,1,Miami Heat,13,116,7:30 pm,Detroit Pistons,103
Sat Jan 28 2017,0,Milwaukee Bucks,-4,108,8:00 pm,Boston Celtics,112
Sat Jan 28 2017,1,Minnesota Timberwolves,20,129,9:00 pm,Brooklyn Nets,109
Sat Jan 28 2017,0,Phoenix Suns,-11,112,9:00 pm,Denver Nuggets,123
Sat Jan 28 2017,0,Utah Jazz,-7,95,9:00 pm,Memphis Grizzlies,102
Sun Jan 29 2017,1,Atlanta Hawks,3,142,3:00 pm,New York Knicks,139
Sun Jan 29 2017,1,Chicago Bulls,13,121,7:00 pm,Philadelphia 76ers,108
Sun Jan 29 2017,1,Cleveland Cavaliers,16,107,3:30 pm,Oklahoma City Thunder,91
Sun Jan 29 2017,1,Indiana Pacers,19,120,6:00 pm,Houston Rockets,101
Sun Jan 29 2017,0,New Orleans Pelicans,-13,94,6:00 pm,Washington Wizards,107
Sun Jan 29 2017,0,Portland Trail Blazers,-2,111,9:00 pm,Golden State Warriors,113
Sun Jan 29 2017,0,San Antonio Spurs,-4,101,7:00 pm,Dallas Mavericks,105
Sun Jan 29 2017,0,Toronto Raptors,-1,113,6:00 pm,Orlando Magic,114
Mon Jan 30 2017,1,Boston Celtics,4,113,8:00 pm,Detroit Pistons,109
Mon Jan 30 2017,1,Dallas Mavericks,7,104,8:30 pm,Cleveland Cavaliers,97
Mon Jan 30 2017,1,Miami Heat,8,104,7:30 pm,Brooklyn Nets,96
Mon Jan 30 2017,1,Minnesota Timberwolves,6,111,8:00 pm,Orlando Magic,105
Mon Jan 30 2017,1,Philadelphia 76ers,3,122,6:00 pm,Sacramento Kings,119
Mon Jan 30 2017,0,Phoenix Suns,-19,96,10:30 pm,Memphis Grizzlies,115
Tue Jan 31 2017,1,Houston Rockets,22,105,8:00 pm,Sacramento Kings,83
Tue Jan 31 2017,1,Los Angeles Lakers,4,120,10:30 pm,Denver Nuggets,116
Tue Jan 31 2017,1,Portland Trail Blazers,17,115,10:00 pm,Charlotte Hornets,98
Tue Jan 31 2017,1,San Antonio Spurs,14,108,8:30 pm,Oklahoma City Thunder,94
Tue Jan 31 2017,1,Toronto Raptors,2,108,7:00 pm,New Orleans Pelicans,106
Tue Jan 31 2017,1,Washington Wizards,16,117,7:00 pm,New York Knicks,101
Wed Feb 1 2017,1,Boston Celtics,5,109,7:30 pm,Toronto Raptors,104
Wed Feb 1 2017,0,Brooklyn Nets,-5,90,7:30 pm,New York Knicks,95
Wed Feb 1 2017,1,Cleveland Cavaliers,28,125,7:00 pm,Minnesota Timberwolves,97
Wed Feb 1 2017,1,Dallas Mavericks,18,113,8:30 pm,Philadelphia 76ers,95
Wed Feb 1 2017,0,Denver Nuggets,-20,99,9:00 pm,Memphis Grizzlies,119
Wed Feb 1 2017,1,Detroit Pistons,20,118,7:30 pm,New Orleans Pelicans,98
Wed Feb 1 2017,1,Golden State Warriors,15,126,10:30 pm,Charlotte Hornets,111
Wed Feb 1 2017,1,Miami Heat,23,116,7:30 pm,Atlanta Hawks,93
Wed Feb 1 2017,0,Oklahoma City Thunder,-28,100,9:30 pm,Chicago Bulls,128
Wed Feb 1 2017,0,Orlando Magic,-10,88,7:00 pm,Indiana Pacers,98
Wed Feb 1 2017,0,Phoenix Suns,-10,114,9:00 pm,Los Angeles Clippers,124
Wed Feb 1 2017,1,Utah Jazz,16,104,9:00 pm,Milwaukee Bucks,88
Thu Feb 2 2017,0,Houston Rockets,-5,108,8:00 pm,Atlanta Hawks,113
Thu Feb 2 2017,0,Los Angeles Clippers,-13,120,10:30 pm,Golden State Warriors,133
Thu Feb 2 2017,1,San Antonio Spurs,16,102,8:30 pm,Philadelphia 76ers,86
Thu Feb 2 2017,1,Washington Wizards,8,116,7:00 pm,Los Angeles Lakers,108
Fri Feb 3 2017,1,Boston Celtics,6,113,8:00 pm,Los Angeles Lakers,107
Fri Feb 3 2017,0,Brooklyn Nets,-9,97,7:30 pm,Indiana Pacers,106
Fri Feb 3 2017,1,Denver Nuggets,4,121,9:00 pm,Milwaukee Bucks,117
Fri Feb 3 2017,1,Detroit Pistons,8,116,7:30 pm,Minnesota Timberwolves,108
Fri Feb 3 2017,1,Houston Rockets,4,121,8:00 pm,Chicago Bulls,117
Fri Feb 3 2017,1,Oklahoma City Thunder,12,114,8:00 pm,Memphis Grizzlies,102
Fri Feb 3 2017,1,Orlando Magic,8,102,7:00 pm,Toronto Raptors,94
Fri Feb 3 2017,0,Portland Trail Blazers,-4,104,10:30 pm,Dallas Mavericks,108
Fri Feb 3 2017,0,Sacramento Kings,-2,103,10:30 pm,Phoenix Suns,105
Sat Feb 4 2017,1,Atlanta Hawks,27,113,7:00 pm,Orlando Magic,86
Sat Feb 4 2017,1,Indiana Pacers,21,105,7:00 pm,Detroit Pistons,84
Sat Feb 4 2017,1,Miami Heat,23,125,7:30 pm,Philadelphia 76ers,102
Sat Feb 4 2017,0,Minnesota Timberwolves,-8,99,9:00 pm,Memphis Grizzlies,107
Sat Feb 4 2017,0,New York Knicks,-7,104,8:30 pm,Cleveland Cavaliers,111
Sat Feb 4 2017,0,Phoenix Suns,-25,112,9:00 pm,Milwaukee Bucks,137
Sat Feb 4 2017,1,Sacramento Kings,3,109,10:30 pm,Golden State Warriors,106
Sat Feb 4 2017,1,San Antonio Spurs,24,121,9:00 pm,Denver Nuggets,97
Sat Feb 4 2017,1,Utah Jazz,7,105,9:00 pm,Charlotte Hornets,98
Sat Feb 4 2017,1,Washington Wizards,14,105,7:00 pm,New Orleans Pelicans,91
Sun Feb 5 2017,1,Boston Celtics,5,107,2:00 pm,Los Angeles Clippers,102
Sun Feb 5 2017,0,Brooklyn Nets,-8,95,12:00 pm,Toronto Raptors,103
Sun Feb 5 2017,1,Oklahoma City Thunder,6,105,3:00 pm,Portland Trail Blazers,99
Mon Feb 6 2017,0,Atlanta Hawks,-25,95,7:30 pm,Utah Jazz,120
Mon Feb 6 2017,1,Denver Nuggets,23,110,9:00 pm,Dallas Mavericks,87
Mon Feb 6 2017,1,Detroit Pistons,17,113,7:30 pm,Philadelphia 76ers,96
Mon Feb 6 2017,1,Indiana Pacers,3,93,7:00 pm,Oklahoma City Thunder,90
Mon Feb 6 2017,1,Memphis Grizzlies,15,89,9:30 pm,San Antonio Spurs,74
Mon Feb 6 2017,0,Minnesota Timberwolves,-2,113,8:00 pm,Miami Heat,115
Mon Feb 6 2017,1,New Orleans Pelicans,5,111,8:00 pm,Phoenix Suns,106
Mon Feb 6 2017,0,New York Knicks,-14,107,7:00 pm,Los Angeles Lakers,121
Mon Feb 6 2017,0,Sacramento Kings,-5,107,10:30 pm,Chicago Bulls,112
Mon Feb 6 2017,1,Toronto Raptors,9,118,7:30 pm,Los Angeles Clippers,109
Mon Feb 6 2017,0,Washington Wizards,-5,135,7:00 pm,Cleveland Cavaliers,140
Tue Feb 7 2017,1,Charlotte Hornets,4,111,7:00 pm,Brooklyn Nets,107
Tue Feb 7 2017,0,Dallas Mavericks,-1,113,8:30 pm,Portland Trail Blazers,114
Tue Feb 7 2017,1,Houston Rockets,24,128,8:00 pm,Orlando Magic,104
Wed Feb 8 2017,1,Atlanta Hawks,11,117,7:30 pm,Denver Nuggets,106
Wed Feb 8 2017,0,Brooklyn Nets,-4,110,7:30 pm,Washington Wizards,114
Wed Feb 8 2017,1,Detroit Pistons,19,121,7:30 pm,Los Angeles Lakers,102
Wed Feb 8 2017,1,Golden State Warriors,31,123,10:30 pm,Chicago Bulls,92
Wed Feb 8 2017,0,Indiana Pacers,-15,117,7:00 pm,Cleveland Cavaliers,132
Wed Feb 8 2017,1,Memphis Grizzlies,19,110,8:00 pm,Phoenix Suns,91
Wed Feb 8 2017,0,Milwaukee Bucks,-18,88,8:00 pm,Miami Heat,106
Wed Feb 8 2017,1,Minnesota Timberwolves,3,112,8:00 pm,Toronto Raptors,109
Wed Feb 8 2017,0,New Orleans Pelicans,-33,94,8:00 pm,Utah Jazz,127
Wed Feb 8 2017,0,New York Knicks,-4,115,8:00 pm,Los Angeles Clippers,119
Wed Feb 8 2017,0,Philadelphia 76ers,-8,103,7:00 pm,San Antonio Spurs,111
Wed Feb 8 2017,1,Sacramento Kings,16,108,10:30 pm,Boston Celtics,92
Thu Feb 9 2017,0,Charlotte Hornets,-12,95,7:00 pm,Houston Rockets,107
Thu Feb 9 2017,1,Dallas Mavericks,7,112,8:30 pm,Utah Jazz,105
Thu Feb 9 2017,1,Oklahoma City Thunder,9,118,8:00 pm,Cleveland Cavaliers,109
Thu Feb 9 2017,0,Orlando Magic,-1,111,7:00 pm,Philadelphia 76ers,112
Thu Feb 9 2017,0,Portland Trail Blazers,-9,111,10:30 pm,Boston Celtics,120
Fri Feb 10 2017,0,Brooklyn Nets,-9,99,7:30 pm,Miami Heat,108
Fri Feb 10 2017,0,Detroit Pistons,-11,92,7:30 pm,San Antonio Spurs,103
Fri Feb 10 2017,0,Memphis Grizzlies,-15,107,8:00 pm,Golden State Warriors,122
Fri Feb 10 2017,0,Milwaukee Bucks,-8,114,8:00 pm,Los Angeles Lakers,122
Fri Feb 10 2017,0,Minnesota Timberwolves,-16,106,8:00 pm,New Orleans Pelicans,122
Fri Feb 10 2017,0,New York Knicks,-8,123,7:30 pm,Denver Nuggets,131
Fri Feb 10 2017,1,Phoenix Suns,18,115,10:30 pm,Chicago Bulls,97
Fri Feb 10 2017,1,Sacramento Kings,1,108,10:30 pm,Atlanta Hawks,107
Fri Feb 10 2017,1,Washington Wizards,5,112,8:00 pm,Indiana Pacers,107
Sat Feb 11 2017,0,Charlotte Hornets,-5,102,5:00 pm,Los Angeles Clippers,107
Sat Feb 11 2017,1,Cleveland Cavaliers,16,125,7:30 pm,Denver Nuggets,109
Sat Feb 11 2017,1,Dallas Mavericks,32,112,9:00 pm,Orlando Magic,80
Sat Feb 11 2017,1,Houston Rockets,31,133,9:00 pm,Phoenix Suns,102
Sat Feb 11 2017,0,Indiana Pacers,-16,100,7:00 pm,Milwaukee Bucks,116
Sat Feb 11 2017,0,Oklahoma City Thunder,-16,114,8:30 pm,Golden State Warriors,130
Sat Feb 11 2017,1,Philadelphia 76ers,8,117,7:30 pm,Miami Heat,109
Sat Feb 11 2017,0,Utah Jazz,-8,104,10:00 pm,Boston Celtics,112
Sun Feb 12 2017,1,Minnesota Timberwolves,28,117,3:30 pm,Chicago Bulls,89
Sun Feb 12 2017,1,New York Knicks,4,94,3:30 pm,San Antonio Spurs,90
Sun Feb 12 2017,1,Sacramento Kings,6,105,9:00 pm,New Orleans Pelicans,99
Sun Feb 12 2017,0,Toronto Raptors,-1,101,6:00 pm,Detroit Pistons,102
Mon Feb 13 2017,0,Brooklyn Nets,-9,103,7:30 pm,Memphis Grizzlies,112
Mon Feb 13 2017,0,Charlotte Hornets,-6,99,7:00 pm,Philadelphia 76ers,105
Mon Feb 13 2017,0,Dallas Mavericks,-13,98,8:30 pm,Boston Celtics,111
Mon Feb 13 2017,1,Denver Nuggets,22,132,9:00 pm,Golden State Warriors,110
Mon Feb 13 2017,0,Indiana Pacers,-4,106,7:00 pm,San Antonio Spurs,110
Mon Feb 13 2017,0,Miami Heat,-9,107,7:30 pm,Orlando Magic,116
Mon Feb 13 2017,1,Milwaukee Bucks,13,102,8:00 pm,Detroit Pistons,89
Mon Feb 13 2017,0,Phoenix Suns,-2,108,9:00 pm,New Orleans Pelicans,110
Mon Feb 13 2017,0,Portland Trail Blazers,-5,104,10:30 pm,Atlanta Hawks,109
Mon Feb 13 2017,0,Utah Jazz,-16,72,9:00 pm,Los Angeles Clippers,88
Mon Feb 13 2017,1,Washington Wizards,22,120,8:00 pm,Oklahoma City Thunder,98
Tue Feb 14 2017,1,Chicago Bulls,11,105,8:00 pm,Toronto Raptors,94
Tue Feb 14 2017,0,Los Angeles Lakers,-1,96,10:30 pm,Sacramento Kings,97
Tue Feb 14 2017,0,Minnesota Timberwolves,-8,108,8:00 pm,Cleveland Cavaliers,116
Wed Feb 15 2017,1,Boston Celtics,8,116,7:30 pm,Philadelphia 76ers,108
Wed Feb 15 2017,0,Brooklyn Nets,-4,125,7:30 pm,Milwaukee Bucks,129
Wed Feb 15 2017,1,Cleveland Cavaliers,9,113,7:00 pm,Indiana Pacers,104
Wed Feb 15 2017,0,Denver Nuggets,-13,99,9:00 pm,Minnesota Timberwolves,112
Wed Feb 15 2017,1,Detroit Pistons,7,98,7:30 pm,Dallas Mavericks,91
Wed Feb 15 2017,1,Golden State Warriors,23,109,10:30 pm,Sacramento Kings,86
Wed Feb 15 2017,0,Houston Rockets,-8,109,8:00 pm,Miami Heat,117
Wed Feb 15 2017,1,Los Angeles Clippers,15,99,10:30 pm,Atlanta Hawks,84
Wed Feb 15 2017,0,Memphis Grizzlies,-4,91,8:00 pm,New Orleans Pelicans,95
Wed Feb 15 2017,1,Oklahoma City Thunder,11,116,9:30 pm,New York Knicks,105
Wed Feb 15 2017,0,Orlando Magic,-28,79,7:00 pm,San Antonio Spurs,107
Wed Feb 15 2017,1,Phoenix Suns,36,137,9:00 pm,Los Angeles Lakers,101
Wed Feb 15 2017,1,Toronto Raptors,5,90,7:30 pm,Charlotte Hornets,85
Wed Feb 15 2017,1,Utah Jazz,23,111,9:00 pm,Portland Trail Blazers,88
Thu Feb 16 2017,1,Chicago Bulls,1,104,8:00 pm,Boston Celtics,103
Thu Feb 16 2017,0,Indiana Pacers,-13,98,7:00 pm,Washington Wizards,111
Thu Feb 23 2017,1,Cleveland Cavaliers,15,119,8:00 pm,New York Knicks,104
Thu Feb 23 2017,1,Detroit Pistons,6,114,7:30 pm,Charlotte Hornets,108
Thu Feb 23 2017,1,Golden State Warriors,10,123,10:30 pm,Los Angeles Clippers,113
Thu Feb 23 2017,0,New Orleans Pelicans,-30,99,8:00 pm,Houston Rockets,129
Thu Feb 23 2017,0,Orlando Magic,-9,103,7:00 pm,Portland Trail Blazers,112
Thu Feb 23 2017,1,Sacramento Kings,16,116,10:30 pm,Denver Nuggets,100
Fri Feb 24 2017,0,Atlanta Hawks,-18,90,8:00 pm,Miami Heat,108
Fri Feb 24 2017,1,Chicago Bulls,7,128,8:00 pm,Phoenix Suns,121
Fri Feb 24 2017,1,Denver Nuggets,20,129,9:00 pm,Brooklyn Nets,109
Fri Feb 24 2017,1,Indiana Pacers,10,102,7:00 pm,Memphis Grizzlies,92
Fri Feb 24 2017,0,Los Angeles Clippers,-8,97,10:30 pm,San Antonio Spurs,105
Fri Feb 24 2017,0,Milwaukee Bucks,-14,95,8:00 pm,Utah Jazz,109
Fri Feb 24 2017,1,Minnesota Timberwolves,13,97,8:00 pm,Dallas Mavericks,84
Fri Feb 24 2017,1,Oklahoma City Thunder,17,110,8:00 pm,Los Angeles Lakers,93
Fri Feb 24 2017,1,Philadelphia 76ers,8,120,7:00 pm,Washington Wizards,112
Fri Feb 24 2017,1,Toronto Raptors,10,107,8:00 pm,Boston Celtics,97
Sat Feb 25 2017,0,Cleveland Cavaliers,-18,99,8:30 pm,Chicago Bulls,117
Sat Feb 25 2017,1,Dallas Mavericks,13,96,8:30 pm,New Orleans Pelicans,83
Sat Feb 25 2017,1,Golden State Warriors,17,112,10:30 pm,Brooklyn Nets,95
Sat Feb 25 2017,1,Houston Rockets,12,142,9:00 pm,Minnesota Timberwolves,130
Sat Feb 25 2017,1,Miami Heat,18,113,8:00 pm,Indiana Pacers,95
Sat Feb 25 2017,1,New York Knicks,1,110,7:30 pm,Philadelphia 76ers,109
Sat Feb 25 2017,1,Orlando Magic,19,105,7:00 pm,Atlanta Hawks,86
Sat Feb 25 2017,0,Sacramento Kings,-14,85,5:00 pm,Charlotte Hornets,99
Sun Feb 26 2017,0,Denver Nuggets,-7,98,5:00 pm,Memphis Grizzlies,105
Sun Feb 26 2017,0,Detroit Pistons,-6,98,6:00 pm,Boston Celtics,104
Sun Feb 26 2017,1,Los Angeles Clippers,3,124,9:30 pm,Charlotte Hornets,121
Sun Feb 26 2017,0,Los Angeles Lakers,-21,98,3:30 pm,San Antonio Spurs,119
Sun Feb 26 2017,1,Milwaukee Bucks,4,100,3:30 pm,Phoenix Suns,96
Sun Feb 26 2017,1,Oklahoma City Thunder,8,118,7:00 pm,New Orleans Pelicans,110
Sun Feb 26 2017,1,Toronto Raptors,6,112,6:00 pm,Portland Trail Blazers,106
Sun Feb 26 2017,0,Washington Wizards,-10,92,5:00 pm,Utah Jazz,102
Mon Feb 27 2017,0,Boston Celtics,-16,98,7:30 pm,Atlanta Hawks,114
Mon Feb 27 2017,1,Cleveland Cavaliers,7,102,7:00 pm,Milwaukee Bucks,95
Mon Feb 27 2017,1,Dallas Mavericks,7,96,8:30 pm,Miami Heat,89
Mon Feb 27 2017,0,Houston Rockets,-9,108,9:30 pm,Indiana Pacers,117
Mon Feb 27 2017,0,New York Knicks,-1,91,7:00 pm,Toronto Raptors,92
Mon Feb 27 2017,0,Philadelphia 76ers,-11,108,7:00 pm,Golden State Warriors,119
Mon Feb 27 2017,0,Sacramento Kings,-14,88,10:30 pm,Minnesota Timberwolves,102
Tue Feb 28 2017,0,Chicago Bulls,-18,107,8:00 pm,Denver Nuggets,125
Tue Feb 28 2017,1,Detroit Pistons,7,120,7:30 pm,Portland Trail Blazers,113
Tue Feb 28 2017,0,Los Angeles Lakers,-5,104,10:30 pm,Charlotte Hornets,109
Tue Feb 28 2017,1,Memphis Grizzlies,18,130,8:00 pm,Phoenix Suns,112
Tue Feb 28 2017,1,Oklahoma City Thunder,3,109,8:00 pm,Utah Jazz,106
Tue Feb 28 2017,1,Washington Wizards,4,112,7:00 pm,Golden State Warriors,108
Wed Mar 1 2017,1,Atlanta Hawks,5,100,7:30 pm,Dallas Mavericks,95
Wed Mar 1 2017,1,Boston Celtics,4,103,8:00 pm,Cleveland Cavaliers,99
Wed Mar 1 2017,0,Los Angeles Clippers,-19,103,10:30 pm,Houston Rockets,122
Wed Mar 1 2017,1,Miami Heat,27,125,7:30 pm,Philadelphia 76ers,98
Wed Mar 1 2017,0,Milwaukee Bucks,-12,98,8:00 pm,Denver Nuggets,110
Wed Mar 1 2017,1,New Orleans Pelicans,23,109,8:00 pm,Detroit Pistons,86
Wed Mar 1 2017,0,Orlando Magic,-11,90,7:00 pm,New York Knicks,101
Wed Mar 1 2017,0,Sacramento Kings,-9,100,10:30 pm,Brooklyn Nets,109
Wed Mar 1 2017,1,San Antonio Spurs,1,100,8:30 pm,Indiana Pacers,99
Wed Mar 1 2017,0,Toronto Raptors,-9,96,7:30 pm,Washington Wizards,105
Wed Mar 1 2017,0,Utah Jazz,-27,80,9:00 pm,Minnesota Timberwolves,107
Thu Mar 2 2017,1,Chicago Bulls,7,94,8:00 pm,Golden State Warriors,87
Thu Mar 2 2017,1,Phoenix Suns,17,120,9:00 pm,Charlotte Hornets,103
Thu Mar 2 2017,1,Portland Trail Blazers,5,114,10:30 pm,Oklahoma City Thunder,109
Fri Mar 3 2017,0,Atlanta Hawks,-5,130,7:00 pm,Cleveland Cavaliers,135
Fri Mar 3 2017,1,Dallas Mavericks,4,104,8:30 pm,Memphis Grizzlies,100
Fri Mar 3 2017,0,Los Angeles Lakers,-20,95,10:30 pm,Boston Celtics,115
Fri Mar 3 2017,1,Milwaukee Bucks,11,112,8:00 pm,Los Angeles Clippers,101
Fri Mar 3 2017,0,New Orleans Pelicans,-3,98,9:30 pm,San Antonio Spurs,101
Fri Mar 3 2017,1,Orlando Magic,11,110,7:00 pm,Miami Heat,99
Fri Mar 3 2017,1,Philadelphia 76ers,3,105,7:00 pm,New York Knicks,102
Fri Mar 3 2017,1,Phoenix Suns,7,118,9:00 pm,Oklahoma City Thunder,111
Fri Mar 3 2017,1,Utah Jazz,15,112,9:00 pm,Brooklyn Nets,97
Fri Mar 3 2017,0,Washington Wizards,-8,106,7:00 pm,Toronto Raptors,114
Sat Mar 4 2017,0,Chicago Bulls,-10,91,8:30 pm,Los Angeles Clippers,101
Sat Mar 4 2017,0,Denver Nuggets,-10,102,9:00 pm,Charlotte Hornets,112
Sat Mar 4 2017,1,Houston Rockets,15,123,9:00 pm,Memphis Grizzlies,108
Sat Mar 4 2017,1,Miami Heat,28,120,8:00 pm,Cleveland Cavaliers,92
Sat Mar 4 2017,1,Milwaukee Bucks,7,101,8:00 pm,Toronto Raptors,94
Sat Mar 4 2017,0,Philadelphia 76ers,-30,106,6:00 pm,Detroit Pistons,136
Sat Mar 4 2017,1,Portland Trail Blazers,14,130,10:00 pm,Brooklyn Nets,116
Sat Mar 4 2017,1,San Antonio Spurs,7,97,9:00 pm,Minnesota Timberwolves,90
Sun Mar 5 2017,0,Atlanta Hawks,-1,96,1:00 pm,Indiana Pacers,97
Sun Mar 5 2017,1,Dallas Mavericks,15,104,8:30 pm,Oklahoma City Thunder,89
Sun Mar 5 2017,0,Los Angeles Lakers,-8,97,9:30 pm,New Orleans Pelicans,105
Sun Mar 5 2017,0,New York Knicks,-7,105,3:30 pm,Golden State Warriors,112
Sun Mar 5 2017,1,Phoenix Suns,3,109,5:00 pm,Boston Celtics,106
Sun Mar 5 2017,0,Sacramento Kings,-1,109,6:00 pm,Utah Jazz,110
Sun Mar 5 2017,1,Washington Wizards,1,115,5:00 pm,Orlando Magic,114
Mon Mar 6 2017,0,Atlanta Hawks,-8,111,7:30 pm,Golden State Warriors,119
Mon Mar 6 2017,1,Charlotte Hornets,12,100,8:00 pm,Indiana Pacers,88
Mon Mar 6 2017,0,Cleveland Cavaliers,-8,98,7:00 pm,Miami Heat,106
Mon Mar 6 2017,1,Denver Nuggets,12,108,9:00 pm,Sacramento Kings,96
Mon Mar 6 2017,1,Detroit Pistons,14,109,7:30 pm,Chicago Bulls,95
Mon Mar 6 2017,1,Los Angeles Clippers,14,116,10:30 pm,Boston Celtics,102
Mon Mar 6 2017,0,Memphis Grizzlies,-13,109,8:00 pm,Brooklyn Nets,122
Mon Mar 6 2017,0,Orlando Magic,-8,105,7:00 pm,New York Knicks,113
Mon Mar 6 2017,0,Philadelphia 76ers,-14,98,7:00 pm,Milwaukee Bucks,112
Mon Mar 6 2017,1,San Antonio Spurs,2,112,8:30 pm,Houston Rockets,110
Mon Mar 6 2017,1,Utah Jazz,5,88,9:00 pm,New Orleans Pelicans,83
Tue Mar 7 2017,1,Dallas Mavericks,11,122,8:30 pm,Los Angeles Lakers,111
Tue Mar 7 2017,0,Oklahoma City Thunder,-5,121,8:00 pm,Portland Trail Blazers,126
Tue Mar 7 2017,0,Phoenix Suns,-4,127,9:00 pm,Washington Wizards,131
Wed Mar 8 2017,1,Atlanta Hawks,5,110,7:30 pm,Brooklyn Nets,105
Wed Mar 8 2017,0,Denver Nuggets,-10,113,9:00 pm,Washington Wizards,123
Wed Mar 8 2017,0,Golden State Warriors,-13,86,10:30 pm,Boston Celtics,99
Wed Mar 8 2017,0,Houston Rockets,-7,108,8:00 pm,Utah Jazz,115
Wed Mar 8 2017,1,Indiana Pacers,17,115,8:00 pm,Detroit Pistons,98
Wed Mar 8 2017,1,Miami Heat,7,108,7:30 pm,Charlotte Hornets,101
Wed Mar 8 2017,1,Milwaukee Bucks,11,104,8:00 pm,New York Knicks,93
Wed Mar 8 2017,1,Minnesota Timberwolves,16,107,8:00 pm,Los Angeles Clippers,91
Wed Mar 8 2017,0,New Orleans Pelicans,-7,87,8:00 pm,Toronto Raptors,94
Wed Mar 8 2017,1,Orlando Magic,7,98,7:00 pm,Chicago Bulls,91
Wed Mar 8 2017,1,San Antonio Spurs,10,114,8:30 pm,Sacramento Kings,104
Thu Mar 9 2017,1,Detroit Pistons,5,106,7:30 pm,Cleveland Cavaliers,101
Thu Mar 9 2017,0,Memphis Grizzlies,-16,98,8:00 pm,Los Angeles Clippers,114
Thu Mar 9 2017,1,Oklahoma City Thunder,10,102,8:00 pm,San Antonio Spurs,92
Thu Mar 9 2017,0,Phoenix Suns,-12,110,10:30 pm,Los Angeles Lakers,122
Thu Mar 9 2017,1,Portland Trail Blazers,6,114,10:00 pm,Philadelphia 76ers,108
Fri Mar 10 2017,1,Atlanta Hawks,6,105,8:00 pm,Toronto Raptors,99
Fri Mar 10 2017,0,Chicago Bulls,-21,94,8:00 pm,Houston Rockets,115
Fri Mar 10 2017,1,Charlotte Hornets,40,121,7:00 pm,Orlando Magic,81
Fri Mar 10 2017,1,Dallas Mavericks,9,105,9:00 pm,Brooklyn Nets,96
Fri Mar 10 2017,1,Denver Nuggets,20,119,9:00 pm,Boston Celtics,99
Fri Mar 10 2017,1,Milwaukee Bucks,14,99,8:00 pm,Indiana Pacers,85
Fri Mar 10 2017,1,Minnesota Timberwolves,1,103,8:00 pm,Golden State Warriors,102
Fri Mar 10 2017,0,Sacramento Kings,-8,122,10:30 pm,Washington Wizards,130
Sat Mar 11 2017,0,Charlotte Hornets,-3,122,7:00 pm,New Orleans Pelicans,125
Sat Mar 11 2017,0,Dallas Mavericks,-2,98,9:00 pm,Phoenix Suns,100
Sat Mar 11 2017,1,Detroit Pistons,20,112,5:00 pm,New York Knicks,92
Sat Mar 11 2017,1,Los Angeles Clippers,12,112,3:30 pm,Philadelphia 76ers,100
Sat Mar 11 2017,0,Memphis Grizzlies,-17,90,9:00 pm,Atlanta Hawks,107
Sat Mar 11 2017,1,Miami Heat,15,104,8:00 pm,Toronto Raptors,89
Sat Mar 11 2017,1,Milwaukee Bucks,7,102,8:00 pm,Minnesota Timberwolves,95
Sat Mar 11 2017,1,Oklahoma City Thunder,8,112,3:00 pm,Utah Jazz,104
Sat Mar 11 2017,0,Orlando Magic,-12,104,7:00 pm,Cleveland Cavaliers,116
Sat Mar 11 2017,0,Portland Trail Blazers,-1,124,10:00 pm,Washington Wizards,125
Sat Mar 11 2017,0,Sacramento Kings,-13,92,10:30 pm,Denver Nuggets,105
Sat Mar 11 2017,1,San Antonio Spurs,22,107,8:30 pm,Golden State Warriors,85
Sun Mar 12 2017,1,Boston Celtics,20,100,3:30 pm,Chicago Bulls,80
Sun Mar 12 2017,1,Brooklyn Nets,8,120,6:00 pm,New York Knicks,112
Sun Mar 12 2017,1,Houston Rockets,5,117,9:00 pm,Cleveland Cavaliers,112
Sun Mar 12 2017,1,Indiana Pacers,4,102,6:00 pm,Miami Heat,98
Sun Mar 12 2017,0,Los Angeles Lakers,-2,116,9:30 pm,Philadelphia 76ers,118
Sun Mar 12 2017,0,Phoenix Suns,-9,101,9:00 pm,Portland Trail Blazers,110
Mon Mar 13 2017,0,Charlotte Hornets,-6,109,7:00 pm,Chicago Bulls,115
Mon Mar 13 2017,1,Denver Nuggets,28,129,10:30 pm,Los Angeles Lakers,101
Mon Mar 13 2017,1,Memphis Grizzlies,20,113,8:00 pm,Milwaukee Bucks,93
Mon Mar 13 2017,1,Minnesota Timberwolves,15,119,8:00 pm,Washington Wizards,104
Mon Mar 13 2017,1,Sacramento Kings,5,120,10:30 pm,Orlando Magic,115
Mon Mar 13 2017,1,San Antonio Spurs,8,107,8:00 pm,Atlanta Hawks,99
Mon Mar 13 2017,1,Toronto Raptors,22,100,7:30 pm,Dallas Mavericks,78
Mon Mar 13 2017,1,Utah Jazz,6,114,9:00 pm,Los Angeles Clippers,108
Tue Mar 14 2017,0,Brooklyn Nets,-18,104,7:30 pm,Oklahoma City Thunder,122
Tue Mar 14 2017,1,Cleveland Cavaliers,32,128,7:00 pm,Detroit Pistons,96
Tue Mar 14 2017,1,Golden State Warriors,2,106,10:30 pm,Philadelphia 76ers,104
Tue Mar 14 2017,1,New Orleans Pelicans,23,100,8:00 pm,Portland Trail Blazers,77
Tue Mar 14 2017,1,New York Knicks,6,87,7:30 pm,Indiana Pacers,81
Wed Mar 15 2017,1,Boston Celtics,13,117,7:30 pm,Minnesota Timberwolves,104
Wed Mar 15 2017,0,Chicago Bulls,-7,91,8:00 pm,Memphis Grizzlies,98
Wed Mar 15 2017,0,Detroit Pistons,-14,83,7:30 pm,Utah Jazz,97
Wed Mar 15 2017,1,Houston Rockets,39,139,8:00 pm,Los Angeles Lakers,100
Wed Mar 15 2017,1,Indiana Pacers,21,98,7:00 pm,Charlotte Hornets,77
Wed Mar 15 2017,0,Los Angeles Clippers,-1,96,10:30 pm,Milwaukee Bucks,97
Wed Mar 15 2017,1,Miami Heat,8,120,7:30 pm,New Orleans Pelicans,112
Wed Mar 15 2017,0,Phoenix Suns,-6,101,10:00 pm,Sacramento Kings,107
Wed Mar 15 2017,0,San Antonio Spurs,-4,106,8:00 pm,Portland Trail Blazers,110
Wed Mar 15 2017,0,Washington Wizards,-5,107,7:00 pm,Dallas Mavericks,112
Thu Mar 16 2017,0,Atlanta Hawks,-12,91,7:30 pm,Memphis Grizzlies,103
Thu Mar 16 2017,1,Cleveland Cavaliers,8,91,7:00 pm,Utah Jazz,83
Thu Mar 16 2017,1,Denver Nuggets,15,129,9:00 pm,Los Angeles Clippers,114
Thu Mar 16 2017,1,Golden State Warriors,30,122,10:30 pm,Orlando Magic,92
Thu Mar 16 2017,0,New York Knicks,-11,110,7:30 pm,Brooklyn Nets,121
Thu Mar 16 2017,0,Toronto Raptors,-21,102,7:00 pm,Oklahoma City Thunder,123
Fri Mar 17 2017,0,Brooklyn Nets,-3,95,7:30 pm,Boston Celtics,98
Fri Mar 17 2017,0,Detroit Pistons,-12,75,7:30 pm,Toronto Raptors,87
Fri Mar 17 2017,0,Los Angeles Lakers,-4,103,10:30 pm,Milwaukee Bucks,107
Fri Mar 17 2017,1,Miami Heat,18,123,8:00 pm,Minnesota Timberwolves,105
Fri Mar 17 2017,1,New Orleans Pelicans,16,128,8:00 pm,Houston Rockets,112
Fri Mar 17 2017,1,Philadelphia 76ers,42,116,7:00 pm,Dallas Mavericks,74
Fri Mar 17 2017,0,Phoenix Suns,-6,103,10:00 pm,Orlando Magic,109
Fri Mar 17 2017,1,Washington Wizards,5,112,7:00 pm,Chicago Bulls,107
Sat Mar 18 2017,0,Atlanta Hawks,-16,97,6:00 pm,Portland Trail Blazers,113
Sat Mar 18 2017,1,Chicago Bulls,9,95,9:00 pm,Utah Jazz,86
Sat Mar 18 2017,1,Charlotte Hornets,5,98,7:00 pm,Washington Wizards,93
Sat Mar 18 2017,0,Denver Nuggets,-4,105,9:30 pm,Houston Rockets,109
Sat Mar 18 2017,1,Golden State Warriors,25,117,10:30 pm,Milwaukee Bucks,92
Sat Mar 18 2017,1,Los Angeles Clippers,30,108,8:30 pm,Cleveland Cavaliers,78
Sat Mar 18 2017,1,Memphis Grizzlies,8,104,9:00 pm,San Antonio Spurs,96
Sat Mar 18 2017,1,Oklahoma City Thunder,16,110,3:00 pm,Sacramento Kings,94
Sun Mar 19 2017,0,Brooklyn Nets,-7,104,12:00 pm,Dallas Mavericks,111
Sun Mar 19 2017,1,Detroit Pistons,17,112,4:30 pm,Phoenix Suns,95
Sun Mar 19 2017,0,Los Angeles Lakers,-5,120,9:30 pm,Cleveland Cavaliers,125
Sun Mar 19 2017,0,Miami Heat,-11,104,6:00 pm,Portland Trail Blazers,115
Sun Mar 19 2017,1,New Orleans Pelicans,14,123,6:00 pm,Minnesota Timberwolves,109
Sun Mar 19 2017,1,Philadelphia 76ers,6,105,1:00 pm,Boston Celtics,99
Sun Mar 19 2017,1,San Antonio Spurs,16,118,7:00 pm,Sacramento Kings,102
Sun Mar 19 2017,1,Toronto Raptors,25,116,6:00 pm,Indiana Pacers,91
Mon Mar 20 2017,1,Boston Celtics,8,110,7:30 pm,Washington Wizards,102
Mon Mar 20 2017,1,Charlotte Hornets,15,105,7:00 pm,Atlanta Hawks,90
Mon Mar 20 2017,1,Houston Rockets,1,125,8:00 pm,Denver Nuggets,124
Mon Mar 20 2017,1,Indiana Pacers,7,107,7:00 pm,Utah Jazz,100
Mon Mar 20 2017,1,Los Angeles Clippers,9,114,10:30 pm,New York Knicks,105
Mon Mar 20 2017,0,Oklahoma City Thunder,-16,95,8:00 pm,Golden State Warriors,111
Mon Mar 20 2017,1,Orlando Magic,3,112,7:00 pm,Philadelphia 76ers,109
Tue Mar 21 2017,1,Brooklyn Nets,2,98,7:30 pm,Detroit Pistons,96
Tue Mar 21 2017,0,Dallas Mavericks,-25,87,8:30 pm,Golden State Warriors,112
Tue Mar 21 2017,0,Los Angeles Lakers,-24,109,10:30 pm,Los Angeles Clippers,133
Tue Mar 21 2017,1,Miami Heat,15,112,7:30 pm,Phoenix Suns,97
Tue Mar 21 2017,0,Minnesota Timberwolves,-7,93,9:30 pm,San Antonio Spurs,100
Tue Mar 21 2017,1,New Orleans Pelicans,13,95,8:00 pm,Memphis Grizzlies,82
Tue Mar 21 2017,0,Portland Trail Blazers,-3,90,10:00 pm,Milwaukee Bucks,93
Tue Mar 21 2017,1,Toronto Raptors,2,122,7:00 pm,Chicago Bulls,120
Wed Mar 22 2017,1,Boston Celtics,9,109,7:30 pm,Indiana Pacers,100
Wed Mar 22 2017,1,Chicago Bulls,22,117,8:00 pm,Detroit Pistons,95
Wed Mar 22 2017,1,Denver Nuggets,13,126,9:00 pm,Cleveland Cavaliers,113
Wed Mar 22 2017,1,Oklahoma City Thunder,25,122,8:00 pm,Philadelphia 76ers,97
Wed Mar 22 2017,0,Orlando Magic,-7,102,7:00 pm,Charlotte Hornets,109
Wed Mar 22 2017,0,Sacramento Kings,-18,98,10:30 pm,Milwaukee Bucks,116
Wed Mar 22 2017,1,Utah Jazz,7,108,10:30 pm,New York Knicks,101
Wed Mar 22 2017,1,Washington Wizards,4,104,8:00 pm,Atlanta Hawks,100
Thu Mar 23 2017,1,Brooklyn Nets,28,126,7:30 pm,Phoenix Suns,98
Thu Mar 23 2017,1,Dallas Mavericks,2,97,8:30 pm,Los Angeles Clippers,95
Thu Mar 23 2017,0,Miami Heat,-17,84,7:30 pm,Toronto Raptors,101
Thu Mar 23 2017,1,Portland Trail Blazers,15,110,10:00 pm,New York Knicks,95
Thu Mar 23 2017,1,San Antonio Spurs,7,97,8:30 pm,Memphis Grizzlies,90
Fri Mar 24 2017,1,Boston Celtics,10,130,7:30 pm,Phoenix Suns,120
Fri Mar 24 2017,0,Chicago Bulls,-10,107,8:00 pm,Philadelphia 76ers,117
Fri Mar 24 2017,0,Charlotte Hornets,-7,105,7:00 pm,Cleveland Cavaliers,112
Fri Mar 24 2017,1,Golden State Warriors,14,114,10:30 pm,Sacramento Kings,100
Fri Mar 24 2017,1,Houston Rockets,10,117,8:00 pm,New Orleans Pelicans,107
Fri Mar 24 2017,0,Indiana Pacers,-8,117,7:00 pm,Denver Nuggets,125
Fri Mar 24 2017,1,Los Angeles Lakers,11,130,10:30 pm,Minnesota Timberwolves,119
Fri Mar 24 2017,1,Milwaukee Bucks,3,100,8:00 pm,Atlanta Hawks,97
Fri Mar 24 2017,1,Orlando Magic,28,115,7:00 pm,Detroit Pistons,87
Fri Mar 24 2017,1,Washington Wizards,21,129,7:00 pm,Brooklyn Nets,108
Sat Mar 25 2017,0,Cleveland Cavaliers,-12,115,7:30 pm,Washington Wizards,127
Sat Mar 25 2017,0,Dallas Mavericks,-8,86,8:30 pm,Toronto Raptors,94
Sat Mar 25 2017,1,Los Angeles Clippers,13,108,3:30 pm,Utah Jazz,95
Sat Mar 25 2017,1,Portland Trail Blazers,12,112,10:00 pm,Minnesota Timberwolves,100
Sat Mar 25 2017,1,San Antonio Spurs,8,106,8:30 pm,New York Knicks,98
Sun Mar 26 2017,0,Atlanta Hawks,-15,92,1:00 pm,Brooklyn Nets,107
Sun Mar 26 2017,1,Boston Celtics,4,112,6:00 pm,Miami Heat,108
Sun Mar 26 2017,1,Charlotte Hornets,14,120,1:00 pm,Phoenix Suns,106
Sun Mar 26 2017,0,Denver Nuggets,-25,90,8:00 pm,New Orleans Pelicans,115
Sun Mar 26 2017,1,Golden State Warriors,12,106,8:00 pm,Memphis Grizzlies,94
Sun Mar 26 2017,1,Houston Rockets,12,137,3:30 pm,Oklahoma City Thunder,125
Sun Mar 26 2017,1,Indiana Pacers,13,107,6:00 pm,Philadelphia 76ers,94
Sun Mar 26 2017,0,Los Angeles Clippers,-1,97,3:30 pm,Sacramento Kings,98
Sun Mar 26 2017,0,Los Angeles Lakers,-16,81,9:30 pm,Portland Trail Blazers,97
Sun Mar 26 2017,0,Milwaukee Bucks,-15,94,3:30 pm,Chicago Bulls,109
Mon Mar 27 2017,0,Dallas Mavericks,-1,91,8:30 pm,Oklahoma City Thunder,92
Mon Mar 27 2017,1,New York Knicks,14,109,7:30 pm,Detroit Pistons,95
Mon Mar 27 2017,1,Sacramento Kings,1,91,10:30 pm,Memphis Grizzlies,90
Mon Mar 27 2017,1,San Antonio Spurs,29,103,8:00 pm,Cleveland Cavaliers,74
Mon Mar 27 2017,1,Toronto Raptors,19,131,7:30 pm,Orlando Magic,112
Mon Mar 27 2017,1,Utah Jazz,8,108,10:30 pm,New Orleans Pelicans,100
Tue Mar 28 2017,1,Atlanta Hawks,4,95,7:30 pm,Phoenix Suns,91
Tue Mar 28 2017,0,Brooklyn Nets,-5,101,7:30 pm,Philadelphia 76ers,106
Tue Mar 28 2017,0,Charlotte Hornets,-10,108,7:00 pm,Milwaukee Bucks,118
Tue Mar 28 2017,0,Detroit Pistons,-1,96,7:30 pm,Miami Heat,97
Tue Mar 28 2017,0,Houston Rockets,-7,106,8:00 pm,Golden State Warriors,113
Tue Mar 28 2017,0,Indiana Pacers,-1,114,7:00 pm,Minnesota Timberwolves,115
Tue Mar 28 2017,0,Los Angeles Lakers,-11,108,10:30 pm,Washington Wizards,119
Tue Mar 28 2017,1,Portland Trail Blazers,9,122,10:00 pm,Denver Nuggets,113
Wed Mar 29 2017,0,Boston Celtics,-3,100,7:30 pm,Milwaukee Bucks,103
Wed Mar 29 2017,1,Los Angeles Clippers,9,133,10:30 pm,Washington Wizards,124
Wed Mar 29 2017,1,Memphis Grizzlies,13,110,8:00 pm,Indiana Pacers,97
Wed Mar 29 2017,1,New Orleans Pelicans,3,121,8:00 pm,Dallas Mavericks,118
Wed Mar 29 2017,0,New York Knicks,-17,88,7:30 pm,Miami Heat,105
Wed Mar 29 2017,0,Orlando Magic,-8,106,7:00 pm,Oklahoma City Thunder,114
Wed Mar 29 2017,0,Philadelphia 76ers,-7,92,7:00 pm,Atlanta Hawks,99
Wed Mar 29 2017,0,Sacramento Kings,-30,82,10:30 pm,Utah Jazz,112
Wed Mar 29 2017,0,San Antonio Spurs,-12,98,9:30 pm,Golden State Warriors,110
Wed Mar 29 2017,0,Toronto Raptors,-4,106,7:30 pm,Charlotte Hornets,110
Thu Mar 30 2017,1,Chicago Bulls,6,99,8:00 pm,Cleveland Cavaliers,93
Thu Mar 30 2017,1,Detroit Pistons,1,90,7:30 pm,Brooklyn Nets,89
Thu Mar 30 2017,1,Minnesota Timberwolves,15,119,8:00 pm,Los Angeles Lakers,104
Thu Mar 30 2017,0,Phoenix Suns,-6,118,10:00 pm,Los Angeles Clippers,124
Thu Mar 30 2017,1,Portland Trail Blazers,10,117,10:30 pm,Houston Rockets,107
Fri Mar 31 2017,1,Boston Celtics,1,117,7:30 pm,Orlando Magic,116
Fri Mar 31 2017,1,Charlotte Hornets,8,122,7:00 pm,Denver Nuggets,114
Fri Mar 31 2017,1,Cleveland Cavaliers,17,122,7:30 pm,Philadelphia 76ers,105
Fri Mar 31 2017,1,Golden State Warriors,9,107,10:30 pm,Houston Rockets,98
Fri Mar 31 2017,1,Memphis Grizzlies,9,99,8:00 pm,Dallas Mavericks,90
Fri Mar 31 2017,0,Miami Heat,-4,94,8:00 pm,New York Knicks,98
Fri Mar 31 2017,1,Milwaukee Bucks,3,108,8:00 pm,Detroit Pistons,105
Fri Mar 31 2017,1,New Orleans Pelicans,28,117,8:00 pm,Sacramento Kings,89
Fri Mar 31 2017,0,Oklahoma City Thunder,-5,95,8:00 pm,San Antonio Spurs,100
Fri Mar 31 2017,1,Toronto Raptors,11,111,7:00 pm,Indiana Pacers,100
Fri Mar 31 2017,1,Utah Jazz,7,95,9:00 pm,Washington Wizards,88
Tue Oct 27 2015,0,Atlanta Hawks,-12,94,8:00 pm,Detroit Pistons,106
Tue Oct 27 2015,1,Chicago Bulls,2,97,8:00 pm,Cleveland Cavaliers,95
Tue Oct 27 2015,1,Golden State Warriors,16,111,10:30 pm,New Orleans Pelicans,95
Wed Oct 28 2015,1,Boston Celtics,17,112,7:30 pm,Philadelphia 76ers,95
Wed Oct 28 2015,0,Brooklyn Nets,-15,100,7:30 pm,Chicago Bulls,115
Wed Oct 28 2015,1,Detroit Pistons,5,92,7:30 pm,Utah Jazz,87
Wed Oct 28 2015,0,Houston Rockets,-20,85,8:00 pm,Denver Nuggets,105
Wed Oct 28 2015,0,Los Angeles Lakers,-1,111,10:30 pm,Minnesota Timberwolves,112
Wed Oct 28 2015,0,Memphis Grizzlies,-30,76,8:00 pm,Cleveland Cavaliers,106
Wed Oct 28 2015,1,Miami Heat,10,104,7:30 pm,Charlotte Hornets,94
Wed Oct 28 2015,0,Milwaukee Bucks,-25,97,8:00 pm,New York Knicks,122
Wed Oct 28 2015,1,Oklahoma City Thunder,6,112,8:00 pm,San Antonio Spurs,106
Wed Oct 28 2015,0,Orlando Magic,-1,87,7:00 pm,Washington Wizards,88
Wed Oct 28 2015,0,Phoenix Suns,-16,95,10:00 pm,Dallas Mavericks,111
Wed Oct 28 2015,1,Portland Trail Blazers,18,112,10:00 pm,New Orleans Pelicans,94
Wed Oct 28 2015,0,Sacramento Kings,-7,104,10:00 pm,Los Angeles Clippers,111
Wed Oct 28 2015,1,Toronto Raptors,7,106,7:30 pm,Indiana Pacers,99
Thu Oct 29 2015,0,Indiana Pacers,-9,103,7:00 pm,Memphis Grizzlies,112
Thu Oct 29 2015,1,Los Angeles Clippers,16,104,10:30 pm,Dallas Mavericks,88
Thu Oct 29 2015,0,New York Knicks,-11,101,8:00 pm,Atlanta Hawks,112
Fri Oct 30 2015,1,Atlanta Hawks,3,97,8:00 pm,Charlotte Hornets,94
Fri Oct 30 2015,0,Boston Celtics,-10,103,7:30 pm,Toronto Raptors,113
Fri Oct 30 2015,1,Cleveland Cavaliers,10,102,7:00 pm,Miami Heat,92
Fri Oct 30 2015,0,Denver Nuggets,-17,78,9:00 pm,Minnesota Timberwolves,95
Fri Oct 30 2015,1,Detroit Pistons,4,98,7:30 pm,Chicago Bulls,94
Fri Oct 30 2015,0,Houston Rockets,-20,92,9:30 pm,Golden State Warriors,112
Fri Oct 30 2015,0,Milwaukee Bucks,-5,113,8:00 pm,Washington Wizards,118
Fri Oct 30 2015,0,Orlando Magic,-3,136,7:00 pm,Oklahoma City Thunder,139
Fri Oct 30 2015,0,Philadelphia 76ers,-28,71,7:00 pm,Utah Jazz,99
Fri Oct 30 2015,1,Phoenix Suns,18,110,10:30 pm,Portland Trail Blazers,92
Fri Oct 30 2015,1,Sacramento Kings,18,132,10:00 pm,Los Angeles Lakers,114
Fri Oct 30 2015,1,San Antonio Spurs,27,102,8:30 pm,Brooklyn Nets,75
Sat Oct 31 2015,0,Indiana Pacers,-21,76,7:00 pm,Utah Jazz,97
Sat Oct 31 2015,1,Los Angeles Clippers,5,114,10:30 pm,Sacramento Kings,109
Sat Oct 31 2015,1,Memphis Grizzlies,10,101,8:00 pm,Brooklyn Nets,91
Sat Oct 31 2015,0,New Orleans Pelicans,-14,120,7:30 pm,Golden State Warriors,134
Sat Oct 31 2015,0,Portland Trail Blazers,-11,90,10:00 pm,Phoenix Suns,101
Sat Oct 31 2015,0,Washington Wizards,-7,110,7:00 pm,New York Knicks,117
Sun Nov 1 2015,0,Boston Celtics,-8,87,3:30 pm,San Antonio Spurs,95
Sun Nov 1 2015,1,Chicago Bulls,5,92,7:00 pm,Orlando Magic,87
Sun Nov 1 2015,0,Charlotte Hornets,-2,92,2:00 pm,Atlanta Hawks,94
Sun Nov 1 2015,0,Los Angeles Lakers,-10,93,9:30 pm,Dallas Mavericks,103
Sun Nov 1 2015,1,Miami Heat,20,109,6:00 pm,Houston Rockets,89
Sun Nov 1 2015,1,Oklahoma City Thunder,24,117,7:00 pm,Denver Nuggets,93
Sun Nov 1 2015,1,Toronto Raptors,19,106,6:00 pm,Milwaukee Bucks,87
Mon Nov 2 2015,0,Brooklyn Nets,-7,96,7:30 pm,Milwaukee Bucks,103
Mon Nov 2 2015,1,Golden State Warriors,50,119,10:30 pm,Memphis Grizzlies,69
Mon Nov 2 2015,1,Houston Rockets,5,110,8:00 pm,Oklahoma City Thunder,105
Mon Nov 2 2015,1,Los Angeles Clippers,6,102,10:30 pm,Phoenix Suns,96
Mon Nov 2 2015,0,Minnesota Timberwolves,-5,101,8:00 pm,Portland Trail Blazers,106
Mon Nov 2 2015,0,New York Knicks,-10,84,7:30 pm,San Antonio Spurs,94
Mon Nov 2 2015,0,Philadelphia 76ers,-7,100,7:00 pm,Cleveland Cavaliers,107
Tue Nov 3 2015,1,Charlotte Hornets,25,130,7:00 pm,Chicago Bulls,105
Tue Nov 3 2015,0,Dallas Mavericks,-11,91,8:30 pm,Toronto Raptors,102
Tue Nov 3 2015,0,Detroit Pistons,-12,82,7:30 pm,Indiana Pacers,94
Tue Nov 3 2015,0,Los Angeles Lakers,-11,109,10:30 pm,Denver Nuggets,120
Tue Nov 3 2015,0,Miami Heat,-6,92,7:30 pm,Atlanta Hawks,98
Tue Nov 3 2015,0,New Orleans Pelicans,-9,94,8:00 pm,Orlando Magic,103
Tue Nov 3 2015,0,Sacramento Kings,-14,89,10:00 pm,Memphis Grizzlies,103
Wed Nov 4 2015,1,Atlanta Hawks,14,101,8:00 pm,Brooklyn Nets,87
Wed Nov 4 2015,1,Cleveland Cavaliers,10,96,8:00 pm,New York Knicks,86
Wed Nov 4 2015,1,Golden State Warriors,4,112,10:30 pm,Los Angeles Clippers,108
Wed Nov 4 2015,1,Houston Rockets,5,119,8:00 pm,Orlando Magic,114
Wed Nov 4 2015,1,Indiana Pacers,2,100,7:00 pm,Boston Celtics,98
Wed Nov 4 2015,1,Milwaukee Bucks,4,91,8:00 pm,Philadelphia 76ers,87
Wed Nov 4 2015,0,Oklahoma City Thunder,-5,98,8:00 pm,Toronto Raptors,103
Wed Nov 4 2015,1,Phoenix Suns,21,118,9:00 pm,Sacramento Kings,97
Wed Nov 4 2015,0,Utah Jazz,-16,92,9:00 pm,Portland Trail Blazers,108
Wed Nov 4 2015,1,Washington Wizards,3,102,7:00 pm,San Antonio Spurs,99
Thu Nov 5 2015,1,Chicago Bulls,6,104,8:00 pm,Oklahoma City Thunder,98
Thu Nov 5 2015,0,Dallas Mavericks,-14,94,8:30 pm,Charlotte Hornets,108
Thu Nov 5 2015,0,Denver Nuggets,-12,84,9:00 pm,Utah Jazz,96
Thu Nov 5 2015,0,Minnesota Timberwolves,-12,84,8:00 pm,Miami Heat,96
Thu Nov 5 2015,1,Portland Trail Blazers,19,115,10:30 pm,Memphis Grizzlies,96
Fri Nov 6 2015,1,Boston Celtics,20,118,7:30 pm,Washington Wizards,98
Fri Nov 6 2015,0,Brooklyn Nets,-6,98,7:30 pm,Los Angeles Lakers,104
Fri Nov 6 2015,1,Cleveland Cavaliers,6,108,7:30 pm,Philadelphia 76ers,102
Fri Nov 6 2015,1,Golden State Warriors,15,119,10:30 pm,Denver Nuggets,104
Fri Nov 6 2015,1,Indiana Pacers,3,90,8:00 pm,Miami Heat,87
Fri Nov 6 2015,0,New Orleans Pelicans,-6,115,8:00 pm,Atlanta Hawks,121
Fri Nov 6 2015,0,New York Knicks,-7,92,7:30 pm,Milwaukee Bucks,99
Fri Nov 6 2015,1,Orlando Magic,5,92,7:00 pm,Toronto Raptors,87
Fri Nov 6 2015,0,Phoenix Suns,-8,92,9:30 pm,Detroit Pistons,100
Fri Nov 6 2015,0,Sacramento Kings,-6,110,10:30 pm,Houston Rockets,116
Sat Nov 7 2015,1,Atlanta Hawks,15,114,7:30 pm,Washington Wizards,99
Sat Nov 7 2015,0,Chicago Bulls,-9,93,6:00 pm,Minnesota Timberwolves,102
Sat Nov 7 2015,1,Dallas Mavericks,9,107,8:30 pm,New Orleans Pelicans,98
Sat Nov 7 2015,0,Los Angeles Clippers,-4,105,10:30 pm,Houston Rockets,109
Sat Nov 7 2015,1,Milwaukee Bucks,8,94,8:30 pm,Brooklyn Nets,86
Sat Nov 7 2015,0,Philadelphia 76ers,-8,97,7:00 pm,Orlando Magic,105
Sat Nov 7 2015,0,Sacramento Kings,-9,94,10:00 pm,Golden State Warriors,103
Sat Nov 7 2015,1,San Antonio Spurs,20,114,8:30 pm,Charlotte Hornets,94
Sat Nov 7 2015,1,Utah Jazz,10,89,9:00 pm,Memphis Grizzlies,79
Sun Nov 8 2015,1,Cleveland Cavaliers,4,101,3:30 pm,Indiana Pacers,97
Sun Nov 8 2015,1,Miami Heat,20,96,6:00 pm,Toronto Raptors,76
Sun Nov 8 2015,1,New York Knicks,4,99,3:30 pm,Los Angeles Lakers,95
Sun Nov 8 2015,1,Oklahoma City Thunder,21,124,7:00 pm,Phoenix Suns,103
Sun Nov 8 2015,0,Portland Trail Blazers,-17,103,9:00 pm,Detroit Pistons,120
Mon Nov 9 2015,0,Atlanta Hawks,-10,107,8:00 pm,Minnesota Timberwolves,117
Mon Nov 9 2015,1,Denver Nuggets,4,108,9:00 pm,Portland Trail Blazers,104
Mon Nov 9 2015,1,Golden State Warriors,14,109,10:30 pm,Detroit Pistons,95
Mon Nov 9 2015,1,Indiana Pacers,13,97,7:00 pm,Orlando Magic,84
Mon Nov 9 2015,1,Los Angeles Clippers,2,94,10:30 pm,Memphis Grizzlies,92
Mon Nov 9 2015,0,Philadelphia 76ers,-23,88,7:00 pm,Chicago Bulls,111
Mon Nov 9 2015,0,Sacramento Kings,-18,88,10:00 pm,San Antonio Spurs,106
Tue Nov 10 2015,1,Cleveland Cavaliers,4,118,7:00 pm,Utah Jazz,114
Tue Nov 10 2015,1,Miami Heat,13,101,7:30 pm,Los Angeles Lakers,88
Tue Nov 10 2015,0,Milwaukee Bucks,-16,83,8:00 pm,Boston Celtics,99
Tue Nov 10 2015,0,Minnesota Timberwolves,-9,95,8:00 pm,Charlotte Hornets,104
Tue Nov 10 2015,1,New Orleans Pelicans,15,120,8:00 pm,Dallas Mavericks,105
Tue Nov 10 2015,0,Toronto Raptors,-2,109,7:30 pm,New York Knicks,111
Tue Nov 10 2015,0,Washington Wizards,-24,101,7:00 pm,Oklahoma City Thunder,125
Wed Nov 11 2015,1,Atlanta Hawks,8,106,8:00 pm,New Orleans Pelicans,98
Wed Nov 11 2015,0,Boston Celtics,-11,91,7:30 pm,Indiana Pacers,102
Wed Nov 11 2015,1,Charlotte Hornets,2,95,7:00 pm,New York Knicks,93
Wed Nov 11 2015,1,Dallas Mavericks,10,118,8:00 pm,Los Angeles Clippers,108
Wed Nov 11 2015,1,Denver Nuggets,1,103,9:00 pm,Milwaukee Bucks,102
Wed Nov 11 2015,0,Houston Rockets,-8,98,8:00 pm,Brooklyn Nets,106
Wed Nov 11 2015,0,Memphis Grizzlies,-16,84,8:00 pm,Golden State Warriors,100
Wed Nov 11 2015,1,Orlando Magic,2,101,7:00 pm,Los Angeles Lakers,99
Wed Nov 11 2015,0,Philadelphia 76ers,-16,103,7:00 pm,Toronto Raptors,119
Wed Nov 11 2015,0,Portland Trail Blazers,-12,101,10:30 pm,San Antonio Spurs,113
Wed Nov 11 2015,1,Sacramento Kings,9,101,10:00 pm,Detroit Pistons,92
Thu Nov 12 2015,1,Miami Heat,1,92,7:30 pm,Utah Jazz,91
Thu Nov 12 2015,0,Minnesota Timberwolves,-13,116,8:00 pm,Golden State Warriors,129
Thu Nov 12 2015,1,Phoenix Suns,14,118,10:30 pm,Los Angeles Clippers,104
Fri Nov 13 2015,1,Boston Celtics,13,106,7:30 pm,Atlanta Hawks,93
Fri Nov 13 2015,1,Chicago Bulls,5,102,8:00 pm,Charlotte Hornets,97
Fri Nov 13 2015,1,Dallas Mavericks,8,90,8:30 pm,Los Angeles Lakers,82
Fri Nov 13 2015,1,Denver Nuggets,9,107,9:00 pm,Houston Rockets,98
Fri Nov 13 2015,1,Indiana Pacers,4,107,7:00 pm,Minnesota Timberwolves,103
Fri Nov 13 2015,1,Memphis Grizzlies,1,101,8:00 pm,Portland Trail Blazers,100
Fri Nov 13 2015,0,New York Knicks,-6,84,7:30 pm,Cleveland Cavaliers,90
Fri Nov 13 2015,1,Oklahoma City Thunder,17,102,8:00 pm,Philadelphia 76ers,85
Fri Nov 13 2015,1,Orlando Magic,9,102,7:00 pm,Utah Jazz,93
Fri Nov 13 2015,1,Sacramento Kings,2,111,10:00 pm,Brooklyn Nets,109
Fri Nov 13 2015,1,Toronto Raptors,19,100,7:30 pm,New Orleans Pelicans,81
Sat Nov 14 2015,1,Golden State Warriors,8,107,10:30 pm,Brooklyn Nets,99
Sat Nov 14 2015,0,Houston Rockets,-12,98,8:00 pm,Dallas Mavericks,110
Sat Nov 14 2015,1,Los Angeles Clippers,5,101,3:30 pm,Detroit Pistons,96
Sat Nov 14 2015,1,Milwaukee Bucks,3,108,8:30 pm,Cleveland Cavaliers,105
Sat Nov 14 2015,1,Phoenix Suns,24,105,9:00 pm,Denver Nuggets,81
Sat Nov 14 2015,1,San Antonio Spurs,9,92,8:30 pm,Philadelphia 76ers,83
Sat Nov 14 2015,1,Washington Wizards,9,108,7:00 pm,Orlando Magic,99
Sun Nov 15 2015,0,Atlanta Hawks,-1,96,6:00 pm,Utah Jazz,97
Sun Nov 15 2015,1,Charlotte Hornets,12,106,5:00 pm,Portland Trail Blazers,94
Sun Nov 15 2015,1,Los Angeles Lakers,12,97,9:30 pm,Detroit Pistons,85
Sun Nov 15 2015,0,Minnesota Timberwolves,-8,106,3:30 pm,Memphis Grizzlies,114
Sun Nov 15 2015,1,New York Knicks,8,95,12:00 pm,New Orleans Pelicans,87
Sun Nov 15 2015,0,Oklahoma City Thunder,-15,85,7:00 pm,Boston Celtics,100
Sun Nov 15 2015,1,Sacramento Kings,6,107,9:00 pm,Toronto Raptors,101
Mon Nov 16 2015,1,Chicago Bulls,1,96,8:00 pm,Indiana Pacers,95
Mon Nov 16 2015,0,Houston Rockets,-16,95,8:00 pm,Boston Celtics,111
Mon Nov 16 2015,1,Memphis Grizzlies,8,122,8:00 pm,Oklahoma City Thunder,114
Mon Nov 16 2015,0,Philadelphia 76ers,-6,86,7:00 pm,Dallas Mavericks,92
Mon Nov 16 2015,1,Phoenix Suns,19,120,9:00 pm,Los Angeles Lakers,101
Mon Nov 16 2015,1,San Antonio Spurs,13,93,8:30 pm,Portland Trail Blazers,80
Tue Nov 17 2015,1,Brooklyn Nets,2,90,7:30 pm,Atlanta Hawks,88
Tue Nov 17 2015,1,Detroit Pistons,5,104,7:30 pm,Cleveland Cavaliers,99
Tue Nov 17 2015,1,Golden State Warriors,5,115,10:30 pm,Toronto Raptors,110
Tue Nov 17 2015,0,Miami Heat,-12,91,7:30 pm,Minnesota Timberwolves,103
Tue Nov 17 2015,0,New Orleans Pelicans,-17,98,8:00 pm,Denver Nuggets,115
Tue Nov 17 2015,1,New York Knicks,8,102,7:30 pm,Charlotte Hornets,94
Tue Nov 17 2015,1,Washington Wizards,29,115,7:00 pm,Milwaukee Bucks,86
Wed Nov 18 2015,1,Atlanta Hawks,6,103,8:00 pm,Sacramento Kings,97
Wed Nov 18 2015,0,Boston Celtics,-4,102,7:30 pm,Dallas Mavericks,106
Wed Nov 18 2015,1,Charlotte Hornets,5,116,7:00 pm,Brooklyn Nets,111
Wed Nov 18 2015,1,Houston Rockets,5,108,8:00 pm,Portland Trail Blazers,103
Wed Nov 18 2015,1,Oklahoma City Thunder,7,110,8:00 pm,New Orleans Pelicans,103
Wed Nov 18 2015,1,Orlando Magic,3,104,7:00 pm,Minnesota Timberwolves,101
Wed Nov 18 2015,0,Philadelphia 76ers,-27,85,7:00 pm,Indiana Pacers,112
Wed Nov 18 2015,0,Phoenix Suns,-6,97,10:30 pm,Chicago Bulls,103
Wed Nov 18 2015,1,San Antonio Spurs,11,109,8:30 pm,Denver Nuggets,98
Wed Nov 18 2015,1,Utah Jazz,4,93,9:00 pm,Toronto Raptors,89
Thu Nov 19 2015,1,Cleveland Cavaliers,15,115,8:00 pm,Milwaukee Bucks,100
Thu Nov 19 2015,0,Los Angeles Clippers,-7,117,10:30 pm,Golden State Warriors,124
Thu Nov 19 2015,1,Miami Heat,7,116,7:30 pm,Sacramento Kings,109
Fri Nov 20 2015,1,Boston Celtics,25,120,7:30 pm,Brooklyn Nets,95
Fri Nov 20 2015,1,Charlotte Hornets,25,113,7:00 pm,Philadelphia 76ers,88
Fri Nov 20 2015,1,Dallas Mavericks,9,102,8:30 pm,Utah Jazz,93
Fri Nov 20 2015,0,Denver Nuggets,-7,107,9:00 pm,Phoenix Suns,114
Fri Nov 20 2015,1,Golden State Warriors,12,106,10:30 pm,Chicago Bulls,94
Fri Nov 20 2015,0,Los Angeles Lakers,-11,91,10:30 pm,Toronto Raptors,102
Fri Nov 20 2015,1,Memphis Grizzlies,12,96,8:00 pm,Houston Rockets,84
Fri Nov 20 2015,0,Minnesota Timberwolves,-10,86,8:00 pm,Detroit Pistons,96
Fri Nov 20 2015,1,New Orleans Pelicans,14,104,8:00 pm,San Antonio Spurs,90
Fri Nov 20 2015,0,Oklahoma City Thunder,-3,90,8:00 pm,New York Knicks,93
Fri Nov 20 2015,1,Portland Trail Blazers,11,102,10:00 pm,Los Angeles Clippers,91
Sat Nov 21 2015,1,Cleveland Cavaliers,12,109,7:30 pm,Atlanta Hawks,97
Sat Nov 21 2015,0,Detroit Pistons,-2,95,7:30 pm,Washington Wizards,97
Sat Nov 21 2015,0,Houston Rockets,-5,102,8:00 pm,New York Knicks,107
Sat Nov 21 2015,1,Indiana Pacers,37,123,7:00 pm,Milwaukee Bucks,86
Sat Nov 21 2015,1,Miami Heat,5,96,8:00 pm,Philadelphia 76ers,91
Sat Nov 21 2015,0,Orlando Magic,-6,91,5:00 pm,Sacramento Kings,97
Sat Nov 21 2015,1,San Antonio Spurs,10,92,8:30 pm,Memphis Grizzlies,82
Sun Nov 22 2015,1,Brooklyn Nets,10,111,6:00 pm,Boston Celtics,101
Sun Nov 22 2015,0,Denver Nuggets,-13,105,8:00 pm,Golden State Warriors,118
Sun Nov 22 2015,0,Los Angeles Clippers,-11,80,3:30 pm,Toronto Raptors,91
Sun Nov 22 2015,0,Los Angeles Lakers,-14,93,9:30 pm,Portland Trail Blazers,107
Sun Nov 22 2015,1,New Orleans Pelicans,6,122,6:00 pm,Phoenix Suns,116
Sun Nov 22 2015,1,Oklahoma City Thunder,3,117,7:00 pm,Dallas Mavericks,114
Mon Nov 23 2015,1,Charlotte Hornets,5,127,7:00 pm,Sacramento Kings,122
Mon Nov 23 2015,1,Cleveland Cavaliers,14,117,7:00 pm,Orlando Magic,103
Mon Nov 23 2015,1,Miami Heat,17,95,7:30 pm,New York Knicks,78
Mon Nov 23 2015,1,Milwaukee Bucks,21,109,8:00 pm,Detroit Pistons,88
Mon Nov 23 2015,1,Minnesota Timberwolves,5,100,8:00 pm,Philadelphia 76ers,95
Mon Nov 23 2015,1,San Antonio Spurs,14,98,8:30 pm,Phoenix Suns,84
Mon Nov 23 2015,0,Utah Jazz,-22,89,9:00 pm,Oklahoma City Thunder,111
Tue Nov 24 2015,1,Atlanta Hawks,24,121,8:00 pm,Boston Celtics,97
Tue Nov 24 2015,0,Denver Nuggets,-17,94,9:00 pm,Los Angeles Clippers,111
Tue Nov 24 2015,1,Golden State Warriors,34,111,10:30 pm,Los Angeles Lakers,77
Tue Nov 24 2015,1,Memphis Grizzlies,14,110,8:00 pm,Dallas Mavericks,96
Tue Nov 24 2015,0,Portland Trail Blazers,-5,88,10:00 pm,Chicago Bulls,93
Tue Nov 24 2015,0,Washington Wizards,-17,106,7:00 pm,Indiana Pacers,123
Wed Nov 25 2015,1,Boston Celtics,4,84,7:30 pm,Philadelphia 76ers,80
Wed Nov 25 2015,1,Charlotte Hornets,14,101,7:00 pm,Washington Wizards,87
Wed Nov 25 2015,1,Detroit Pistons,23,104,7:30 pm,Miami Heat,81
Wed Nov 25 2015,0,Houston Rockets,-9,93,8:00 pm,Memphis Grizzlies,102
Wed Nov 25 2015,0,Los Angeles Clippers,-11,91,10:30 pm,Utah Jazz,102
Wed Nov 25 2015,0,Milwaukee Bucks,-11,118,8:00 pm,Sacramento Kings,129
Wed Nov 25 2015,1,Minnesota Timberwolves,4,99,8:00 pm,Atlanta Hawks,95
Wed Nov 25 2015,1,Oklahoma City Thunder,11,110,8:00 pm,Brooklyn Nets,99
Wed Nov 25 2015,1,Orlando Magic,9,100,7:00 pm,New York Knicks,91
Wed Nov 25 2015,0,Phoenix Suns,-6,114,9:00 pm,New Orleans Pelicans,120
Wed Nov 25 2015,1,San Antonio Spurs,5,88,8:30 pm,Dallas Mavericks,83
Wed Nov 25 2015,1,Toronto Raptors,4,103,7:30 pm,Cleveland Cavaliers,99
Fri Nov 27 2015,1,Boston Celtics,33,111,7:30 pm,Washington Wizards,78
Fri Nov 27 2015,0,Charlotte Hornets,-5,90,7:00 pm,Cleveland Cavaliers,95
Fri Nov 27 2015,0,Denver Nuggets,-11,80,9:00 pm,San Antonio Spurs,91
Fri Nov 27 2015,1,Houston Rockets,2,116,8:00 pm,Philadelphia 76ers,114
Fri Nov 27 2015,1,Indiana Pacers,12,104,8:00 pm,Chicago Bulls,92
Fri Nov 27 2015,1,Los Angeles Clippers,21,111,10:30 pm,New Orleans Pelicans,90
Fri Nov 27 2015,0,Memphis Grizzlies,-15,101,8:00 pm,Atlanta Hawks,116
Fri Nov 27 2015,0,New York Knicks,-19,78,7:30 pm,Miami Heat,97
Fri Nov 27 2015,1,Oklahoma City Thunder,16,103,8:00 pm,Detroit Pistons,87
Fri Nov 27 2015,1,Orlando Magic,24,114,7:00 pm,Milwaukee Bucks,90
Fri Nov 27 2015,0,Phoenix Suns,-19,116,9:30 pm,Golden State Warriors,135
Fri Nov 27 2015,0,Sacramento Kings,-10,91,10:00 pm,Minnesota Timberwolves,101
Sat Nov 28 2015,1,Cleveland Cavaliers,2,90,7:30 pm,Brooklyn Nets,88
Sat Nov 28 2015,1,Dallas Mavericks,11,92,8:30 pm,Denver Nuggets,81
Sat Nov 28 2015,1,Golden State Warriors,19,120,10:30 pm,Sacramento Kings,101
Sat Nov 28 2015,1,Portland Trail Blazers,12,108,10:00 pm,Los Angeles Lakers,96
Sat Nov 28 2015,1,San Antonio Spurs,20,108,8:30 pm,Atlanta Hawks,88
Sat Nov 28 2015,1,Utah Jazz,14,101,9:00 pm,New Orleans Pelicans,87
Sat Nov 28 2015,0,Washington Wizards,-2,82,7:00 pm,Toronto Raptors,84
Sun Nov 29 2015,1,Brooklyn Nets,4,87,6:00 pm,Detroit Pistons,83
Sun Nov 29 2015,1,Charlotte Hornets,5,87,2:00 pm,Milwaukee Bucks,82
Sun Nov 29 2015,1,Los Angeles Clippers,8,107,3:30 pm,Minnesota Timberwolves,99
Sun Nov 29 2015,0,Los Angeles Lakers,-4,103,9:30 pm,Indiana Pacers,107
Sun Nov 29 2015,1,Memphis Grizzlies,8,92,6:00 pm,Philadelphia 76ers,84
Sun Nov 29 2015,0,New York Knicks,-5,111,7:30 pm,Houston Rockets,116
Sun Nov 29 2015,1,Orlando Magic,19,110,6:00 pm,Boston Celtics,91
Sun Nov 29 2015,0,Toronto Raptors,-5,102,6:00 pm,Phoenix Suns,107
Mon Nov 30 2015,1,Atlanta Hawks,6,106,8:00 pm,Oklahoma City Thunder,100
Mon Nov 30 2015,1,Chicago Bulls,3,92,8:00 pm,San Antonio Spurs,89
Mon Nov 30 2015,1,Detroit Pistons,11,116,7:30 pm,Houston Rockets,105
Mon Nov 30 2015,1,Los Angeles Clippers,15,102,10:30 pm,Portland Trail Blazers,87
Mon Nov 30 2015,0,Miami Heat,-10,95,7:30 pm,Boston Celtics,105
Mon Nov 30 2015,1,Milwaukee Bucks,18,92,8:00 pm,Denver Nuggets,74
Mon Nov 30 2015,1,Sacramento Kings,14,112,10:00 pm,Dallas Mavericks,98
Mon Nov 30 2015,0,Utah Jazz,-3,103,9:00 pm,Golden State Warriors,106
Tue Dec 1 2015,1,Brooklyn Nets,3,94,7:30 pm,Phoenix Suns,91
Tue Dec 1 2015,0,Cleveland Cavaliers,-12,85,7:00 pm,Washington Wizards,97
Tue Dec 1 2015,0,Minnesota Timberwolves,-3,93,8:00 pm,Orlando Magic,96
Tue Dec 1 2015,0,New Orleans Pelicans,-9,104,8:00 pm,Memphis Grizzlies,113
Tue Dec 1 2015,1,Philadelphia 76ers,12,103,7:00 pm,Los Angeles Lakers,91
Tue Dec 1 2015,0,Portland Trail Blazers,-3,112,10:00 pm,Dallas Mavericks,115
Wed Dec 2 2015,0,Atlanta Hawks,-10,86,8:00 pm,Toronto Raptors,96
Wed Dec 2 2015,1,Chicago Bulls,9,99,8:00 pm,Denver Nuggets,90
Wed Dec 2 2015,0,Charlotte Hornets,-17,99,7:00 pm,Golden State Warriors,116
Wed Dec 2 2015,1,Detroit Pistons,5,127,7:30 pm,Phoenix Suns,122
Wed Dec 2 2015,1,Houston Rockets,7,108,8:00 pm,New Orleans Pelicans,101
Wed Dec 2 2015,0,Los Angeles Clippers,-12,91,10:30 pm,Indiana Pacers,103
Wed Dec 2 2015,1,New York Knicks,12,99,7:30 pm,Philadelphia 76ers,87
Wed Dec 2 2015,1,San Antonio Spurs,25,95,8:30 pm,Milwaukee Bucks,70
Wed Dec 2 2015,0,Washington Wizards,-4,104,7:00 pm,Los Angeles Lakers,108
Thu Dec 3 2015,0,Memphis Grizzlies,-20,83,9:30 pm,San Antonio Spurs,103
Thu Dec 3 2015,1,Miami Heat,2,97,7:00 pm,Oklahoma City Thunder,95
Thu Dec 3 2015,1,Portland Trail Blazers,12,123,10:00 pm,Indiana Pacers,111
Thu Dec 3 2015,0,Sacramento Kings,-17,97,10:00 pm,Boston Celtics,114
Thu Dec 3 2015,0,Toronto Raptors,-1,105,7:30 pm,Denver Nuggets,106
Thu Dec 3 2015,0,Utah Jazz,-9,94,9:00 pm,Orlando Magic,103
Fri Dec 4 2015,1,Atlanta Hawks,13,100,8:00 pm,Los Angeles Lakers,87
Fri Dec 4 2015,0,Dallas Mavericks,-4,96,8:30 pm,Houston Rockets,100
Fri Dec 4 2015,1,Detroit Pistons,7,102,7:30 pm,Milwaukee Bucks,95
Fri Dec 4 2015,1,New Orleans Pelicans,6,114,9:30 pm,Cleveland Cavaliers,108
Fri Dec 4 2015,1,New York Knicks,17,108,7:00 pm,Brooklyn Nets,91
Fri Dec 4 2015,1,Washington Wizards,3,109,7:00 pm,Phoenix Suns,106
Sat Dec 5 2015,0,Chicago Bulls,-6,96,8:00 pm,Charlotte Hornets,102
Sat Dec 5 2015,1,Houston Rockets,7,120,8:00 pm,Sacramento Kings,113
Sat Dec 5 2015,1,Los Angeles Clippers,2,103,10:30 pm,Orlando Magic,101
Sat Dec 5 2015,1,Miami Heat,15,99,8:00 pm,Cleveland Cavaliers,84
Sat Dec 5 2015,1,Milwaukee Bucks,15,106,8:30 pm,New York Knicks,91
Sat Dec 5 2015,0,Minnesota Timberwolves,-6,103,8:00 pm,Portland Trail Blazers,109
Sat Dec 5 2015,0,Philadelphia 76ers,-3,105,1:00 pm,Denver Nuggets,108
Sat Dec 5 2015,1,San Antonio Spurs,3,108,8:30 pm,Boston Celtics,105
Sat Dec 5 2015,0,Toronto Raptors,-3,109,5:00 pm,Golden State Warriors,112
Sat Dec 5 2015,1,Utah Jazz,3,122,9:00 pm,Indiana Pacers,119
Sun Dec 6 2015,0,Brooklyn Nets,-16,98,6:00 pm,Golden State Warriors,114
Sun Dec 6 2015,1,Detroit Pistons,20,111,6:00 pm,Los Angeles Lakers,91
Sun Dec 6 2015,1,Memphis Grizzlies,2,95,3:30 pm,Phoenix Suns,93
Sun Dec 6 2015,1,Oklahoma City Thunder,3,98,7:00 pm,Sacramento Kings,95
Sun Dec 6 2015,0,Washington Wizards,-12,104,6:00 pm,Dallas Mavericks,116
Mon Dec 7 2015,0,Chicago Bulls,-2,101,8:00 pm,Phoenix Suns,103
Mon Dec 7 2015,1,Charlotte Hornets,20,104,7:00 pm,Detroit Pistons,84
Mon Dec 7 2015,0,Miami Heat,-11,103,7:30 pm,Washington Wizards,114
Mon Dec 7 2015,1,Milwaukee Bucks,2,90,8:00 pm,Portland Trail Blazers,88
Mon Dec 7 2015,0,Minnesota Timberwolves,-4,106,8:00 pm,Los Angeles Clippers,110
Mon Dec 7 2015,0,New Orleans Pelicans,-18,93,8:00 pm,Boston Celtics,111
Mon Dec 7 2015,0,New York Knicks,-7,97,7:30 pm,Dallas Mavericks,104
Mon Dec 7 2015,0,Philadelphia 76ers,-51,68,7:00 pm,San Antonio Spurs,119
Mon Dec 7 2015,1,Toronto Raptors,9,102,7:30 pm,Los Angeles Lakers,93
Tue Dec 8 2015,1,Brooklyn Nets,5,110,7:30 pm,Houston Rockets,105
Tue Dec 8 2015,1,Cleveland Cavaliers,5,105,7:00 pm,Portland Trail Blazers,100
Tue Dec 8 2015,0,Denver Nuggets,-11,74,9:00 pm,Orlando Magic,85
Tue Dec 8 2015,0,Indiana Pacers,-8,123,7:00 pm,Golden State Warriors,131
Tue Dec 8 2015,0,Memphis Grizzlies,-37,88,8:00 pm,Oklahoma City Thunder,125
Tue Dec 8 2015,1,Sacramento Kings,8,114,10:00 pm,Utah Jazz,106
Wed Dec 9 2015,1,Boston Celtics,5,105,7:00 pm,Chicago Bulls,100
Wed Dec 9 2015,1,Charlotte Hornets,18,99,7:00 pm,Miami Heat,81
Wed Dec 9 2015,0,Dallas Mavericks,-3,95,9:30 pm,Atlanta Hawks,98
Wed Dec 9 2015,0,Detroit Pistons,-1,92,7:30 pm,Memphis Grizzlies,93
Wed Dec 9 2015,0,Milwaukee Bucks,-14,95,8:00 pm,Los Angeles Clippers,109
Wed Dec 9 2015,1,Minnesota Timberwolves,1,123,8:00 pm,Los Angeles Lakers,122
Wed Dec 9 2015,1,Phoenix Suns,3,107,9:00 pm,Orlando Magic,104
Wed Dec 9 2015,1,Toronto Raptors,3,97,7:30 pm,San Antonio Spurs,94
Wed Dec 9 2015,1,Utah Jazz,21,106,9:00 pm,New York Knicks,85
Wed Dec 9 2015,0,Washington Wizards,-6,103,7:00 pm,Houston Rockets,109
Thu Dec 10 2015,1,Brooklyn Nets,9,100,7:30 pm,Philadelphia 76ers,91
Thu Dec 10 2015,1,Chicago Bulls,3,83,8:00 pm,Los Angeles Clippers,80
Thu Dec 10 2015,1,Oklahoma City Thunder,13,107,8:00 pm,Atlanta Hawks,94
Thu Dec 10 2015,1,Sacramento Kings,2,99,10:30 pm,New York Knicks,97
Fri Dec 11 2015,0,Boston Celtics,-5,119,7:30 pm,Golden State Warriors,124
Fri Dec 11 2015,1,Denver Nuggets,3,111,9:00 pm,Minnesota Timberwolves,108
Fri Dec 11 2015,1,Indiana Pacers,13,96,7:00 pm,Miami Heat,83
Fri Dec 11 2015,0,Memphis Grizzlies,-24,99,8:00 pm,Charlotte Hornets,123
Fri Dec 11 2015,1,New Orleans Pelicans,2,107,8:00 pm,Washington Wizards,105
Fri Dec 11 2015,0,Orlando Magic,-35,76,7:00 pm,Cleveland Cavaliers,111
Fri Dec 11 2015,0,Philadelphia 76ers,-12,95,7:00 pm,Detroit Pistons,107
Fri Dec 11 2015,0,Phoenix Suns,-10,96,9:30 pm,Portland Trail Blazers,106
Fri Dec 11 2015,1,San Antonio Spurs,22,109,9:30 pm,Los Angeles Lakers,87
Fri Dec 11 2015,1,Toronto Raptors,7,90,7:30 pm,Milwaukee Bucks,83
Fri Dec 11 2015,0,Utah Jazz,-4,90,9:00 pm,Oklahoma City Thunder,94
Sat Dec 12 2015,0,Atlanta Hawks,-25,78,8:00 pm,San Antonio Spurs,103
Sat Dec 12 2015,0,Brooklyn Nets,-5,100,5:00 pm,Los Angeles Clippers,105
Sat Dec 12 2015,1,Chicago Bulls,4,98,8:00 pm,New Orleans Pelicans,94
Sat Dec 12 2015,0,Charlotte Hornets,-5,93,7:00 pm,Boston Celtics,98
Sat Dec 12 2015,0,Dallas Mavericks,-3,111,8:30 pm,Washington Wizards,114
Sat Dec 12 2015,1,Detroit Pistons,22,118,7:30 pm,Indiana Pacers,96
Sat Dec 12 2015,1,Houston Rockets,29,126,8:00 pm,Los Angeles Lakers,97
Sat Dec 12 2015,1,Milwaukee Bucks,13,108,8:30 pm,Golden State Warriors,95
Sat Dec 12 2015,0,Portland Trail Blazers,-2,110,10:00 pm,New York Knicks,112
Sun Dec 13 2015,1,Miami Heat,3,100,6:00 pm,Memphis Grizzlies,97
Sun Dec 13 2015,1,Oklahoma City Thunder,6,104,7:00 pm,Utah Jazz,98
Sun Dec 13 2015,1,Phoenix Suns,7,108,3:30 pm,Minnesota Timberwolves,101
Sun Dec 13 2015,1,Toronto Raptors,20,96,6:00 pm,Philadelphia 76ers,76
Mon Dec 14 2015,0,Atlanta Hawks,-12,88,8:00 pm,Miami Heat,100
Mon Dec 14 2015,0,Brooklyn Nets,-23,82,7:30 pm,Orlando Magic,105
Mon Dec 14 2015,1,Chicago Bulls,19,115,8:00 pm,Philadelphia 76ers,96
Mon Dec 14 2015,1,Dallas Mavericks,10,104,8:30 pm,Phoenix Suns,94
Mon Dec 14 2015,1,Denver Nuggets,6,114,9:00 pm,Houston Rockets,108
Mon Dec 14 2015,0,Detroit Pistons,-2,103,7:30 pm,Los Angeles Clippers,105
Mon Dec 14 2015,1,Indiana Pacers,16,106,7:00 pm,Toronto Raptors,90
Mon Dec 14 2015,1,Memphis Grizzlies,17,112,8:00 pm,Washington Wizards,95
Mon Dec 14 2015,1,Portland Trail Blazers,4,105,10:00 pm,New Orleans Pelicans,101
Mon Dec 14 2015,1,San Antonio Spurs,37,118,8:30 pm,Utah Jazz,81
Tue Dec 15 2015,0,Boston Celtics,-12,77,7:30 pm,Cleveland Cavaliers,89
Tue Dec 15 2015,1,Los Angeles Lakers,18,113,10:30 pm,Milwaukee Bucks,95
Tue Dec 15 2015,0,Minnesota Timberwolves,-12,100,8:00 pm,Denver Nuggets,112
Tue Dec 15 2015,1,Sacramento Kings,10,107,10:00 pm,Houston Rockets,97
Wed Dec 16 2015,1,Atlanta Hawks,21,127,8:00 pm,Philadelphia 76ers,106
Wed Dec 16 2015,0,Brooklyn Nets,-6,98,7:30 pm,Miami Heat,104
Wed Dec 16 2015,1,Chicago Bulls,13,98,8:00 pm,Memphis Grizzlies,85
Wed Dec 16 2015,1,Detroit Pistons,3,119,7:30 pm,Boston Celtics,116
Wed Dec 16 2015,1,Golden State Warriors,25,128,10:30 pm,Phoenix Suns,103
Wed Dec 16 2015,1,Indiana Pacers,26,107,7:00 pm,Dallas Mavericks,81
Wed Dec 16 2015,1,Los Angeles Clippers,13,103,10:30 pm,Milwaukee Bucks,90
Wed Dec 16 2015,1,New York Knicks,5,107,7:30 pm,Minnesota Timberwolves,102
Wed Dec 16 2015,1,Oklahoma City Thunder,16,106,8:00 pm,Portland Trail Blazers,90
Wed Dec 16 2015,1,Orlando Magic,15,113,7:00 pm,Charlotte Hornets,98
Wed Dec 16 2015,1,San Antonio Spurs,19,114,8:30 pm,Washington Wizards,95
Wed Dec 16 2015,0,Utah Jazz,-10,94,9:00 pm,New Orleans Pelicans,104
Thu Dec 17 2015,1,Charlotte Hornets,10,109,7:00 pm,Toronto Raptors,99
Thu Dec 17 2015,1,Cleveland Cavaliers,4,104,8:00 pm,Oklahoma City Thunder,100
Thu Dec 17 2015,0,Los Angeles Lakers,-20,87,10:30 pm,Houston Rockets,107
Fri Dec 18 2015,0,Boston Celtics,-8,101,7:30 pm,Atlanta Hawks,109
Fri Dec 18 2015,0,Chicago Bulls,-3,144,8:00 pm,Detroit Pistons,147
Fri Dec 18 2015,1,Dallas Mavericks,9,97,8:30 pm,Memphis Grizzlies,88
Fri Dec 18 2015,1,Golden State Warriors,9,121,10:30 pm,Milwaukee Bucks,112
Fri Dec 18 2015,1,Indiana Pacers,7,104,7:00 pm,Brooklyn Nets,97
Fri Dec 18 2015,0,Miami Heat,-14,94,8:00 pm,Toronto Raptors,108
Fri Dec 18 2015,1,Minnesota Timberwolves,4,99,8:00 pm,Sacramento Kings,95
Fri Dec 18 2015,1,Orlando Magic,8,102,7:00 pm,Portland Trail Blazers,94
Fri Dec 18 2015,0,Philadelphia 76ers,-10,97,7:00 pm,New York Knicks,107
Fri Dec 18 2015,1,Phoenix Suns,16,104,10:30 pm,New Orleans Pelicans,88
Fri Dec 18 2015,1,San Antonio Spurs,8,115,8:00 pm,Los Angeles Clippers,107
Fri Dec 18 2015,1,Utah Jazz,9,97,9:00 pm,Denver Nuggets,88
Sat Dec 19 2015,1,Houston Rockets,10,107,8:00 pm,Los Angeles Clippers,97
Sat Dec 19 2015,1,Memphis Grizzlies,12,96,8:00 pm,Indiana Pacers,84
Sat Dec 19 2015,1,New York Knicks,16,107,7:30 pm,Chicago Bulls,91
Sat Dec 19 2015,1,Oklahoma City Thunder,40,118,5:00 pm,Los Angeles Lakers,78
Sat Dec 19 2015,1,Washington Wizards,8,109,7:00 pm,Charlotte Hornets,101
Sun Dec 20 2015,0,Brooklyn Nets,-15,85,1:00 pm,Minnesota Timberwolves,100
Sun Dec 20 2015,1,Cleveland Cavaliers,22,108,3:30 pm,Philadelphia 76ers,86
Sun Dec 20 2015,0,Denver Nuggets,-5,125,8:00 pm,New Orleans Pelicans,130
Sun Dec 20 2015,1,Miami Heat,7,116,1:00 pm,Portland Trail Blazers,109
Sun Dec 20 2015,0,Orlando Magic,-3,100,6:00 pm,Atlanta Hawks,103
Sun Dec 20 2015,0,Phoenix Suns,-6,95,5:00 pm,Milwaukee Bucks,101
Sun Dec 20 2015,0,Toronto Raptors,-10,94,6:00 pm,Sacramento Kings,104
Mon Dec 21 2015,1,Atlanta Hawks,9,106,8:00 pm,Portland Trail Blazers,97
Mon Dec 21 2015,1,Boston Celtics,14,113,7:30 pm,Minnesota Timberwolves,99
Mon Dec 21 2015,0,Chicago Bulls,-3,102,8:00 pm,Brooklyn Nets,105
Mon Dec 21 2015,1,Houston Rockets,7,102,8:00 pm,Charlotte Hornets,95
Mon Dec 21 2015,0,Los Angeles Clippers,-1,99,10:30 pm,Oklahoma City Thunder,100
Mon Dec 21 2015,0,New York Knicks,-8,99,7:30 pm,Orlando Magic,107
Mon Dec 21 2015,1,San Antonio Spurs,14,106,8:30 pm,Indiana Pacers,92
Mon Dec 21 2015,1,Utah Jazz,21,110,9:00 pm,Phoenix Suns,89
Mon Dec 21 2015,1,Washington Wizards,14,113,7:00 pm,Sacramento Kings,99
Tue Dec 22 2015,0,Denver Nuggets,-4,107,9:00 pm,Los Angeles Lakers,111
Tue Dec 22 2015,0,Miami Heat,-1,92,7:30 pm,Detroit Pistons,93
Tue Dec 22 2015,0,Philadelphia 76ers,-14,90,7:00 pm,Memphis Grizzlies,104
Tue Dec 22 2015,1,Toronto Raptors,4,103,7:30 pm,Dallas Mavericks,99
Wed Dec 23 2015,1,Atlanta Hawks,7,107,8:00 pm,Detroit Pistons,100
Wed Dec 23 2015,0,Brooklyn Nets,-1,118,7:30 pm,Dallas Mavericks,119
Wed Dec 23 2015,0,Charlotte Hornets,-13,89,7:00 pm,Boston Celtics,102
Wed Dec 23 2015,1,Cleveland Cavaliers,7,91,7:00 pm,New York Knicks,84
Wed Dec 23 2015,1,Golden State Warriors,18,103,10:30 pm,Utah Jazz,85
Wed Dec 23 2015,0,Indiana Pacers,-2,106,7:00 pm,Sacramento Kings,108
Wed Dec 23 2015,0,Los Angeles Lakers,-35,85,10:30 pm,Oklahoma City Thunder,120
Wed Dec 23 2015,1,Milwaukee Bucks,13,113,8:00 pm,Philadelphia 76ers,100
Wed Dec 23 2015,0,Minnesota Timberwolves,-25,83,8:00 pm,San Antonio Spurs,108
Wed Dec 23 2015,1,New Orleans Pelicans,26,115,8:00 pm,Portland Trail Blazers,89
Wed Dec 23 2015,1,Orlando Magic,3,104,7:00 pm,Houston Rockets,101
Wed Dec 23 2015,0,Phoenix Suns,-8,96,9:00 pm,Denver Nuggets,104
Wed Dec 23 2015,1,Washington Wizards,9,100,7:00 pm,Memphis Grizzlies,91
Fri Dec 25 2015,1,Golden State Warriors,6,89,5:00 pm,Cleveland Cavaliers,83
Fri Dec 25 2015,1,Houston Rockets,4,88,8:00 pm,San Antonio Spurs,84
Fri Dec 25 2015,0,Los Angeles Lakers,-10,84,10:30 pm,Los Angeles Clippers,94
Fri Dec 25 2015,1,Miami Heat,6,94,12:00 pm,New Orleans Pelicans,88
Fri Dec 25 2015,0,Oklahoma City Thunder,-9,96,2:30 pm,Chicago Bulls,105
Sat Dec 26 2015,1,Atlanta Hawks,19,117,7:30 pm,New York Knicks,98
Sat Dec 26 2015,0,Brooklyn Nets,-15,96,4:00 pm,Washington Wizards,111
Sat Dec 26 2015,1,Charlotte Hornets,6,98,7:00 pm,Memphis Grizzlies,92
Sat Dec 26 2015,1,Dallas Mavericks,7,118,8:30 pm,Chicago Bulls,111
Sat Dec 26 2015,0,Detroit Pistons,-6,93,7:30 pm,Boston Celtics,99
Sat Dec 26 2015,0,Milwaukee Bucks,-21,90,5:00 pm,Toronto Raptors,111
Sat Dec 26 2015,0,Minnesota Timberwolves,-14,88,8:00 pm,Indiana Pacers,102
Sat Dec 26 2015,1,New Orleans Pelicans,2,110,7:00 pm,Houston Rockets,108
Sat Dec 26 2015,0,Orlando Magic,-7,101,7:00 pm,Miami Heat,108
Sat Dec 26 2015,0,Phoenix Suns,-7,104,9:00 pm,Philadelphia 76ers,111
Sat Dec 26 2015,1,Portland Trail Blazers,29,105,10:00 pm,Cleveland Cavaliers,76
Sat Dec 26 2015,1,San Antonio Spurs,15,101,8:30 pm,Denver Nuggets,86
Sat Dec 26 2015,0,Utah Jazz,-5,104,9:00 pm,Los Angeles Clippers,109
Sun Dec 27 2015,1,Boston Celtics,9,100,7:00 pm,New York Knicks,91
Sun Dec 27 2015,1,Memphis Grizzlies,16,112,6:00 pm,Los Angeles Lakers,96
Sun Dec 27 2015,1,Oklahoma City Thunder,10,122,7:00 pm,Denver Nuggets,112
Sun Dec 27 2015,0,Sacramento Kings,-4,94,9:00 pm,Portland Trail Blazers,98
Mon Dec 28 2015,1,Chicago Bulls,7,104,8:00 pm,Toronto Raptors,97
Mon Dec 28 2015,1,Charlotte Hornets,10,108,7:00 pm,Los Angeles Lakers,98
Mon Dec 28 2015,1,Dallas Mavericks,10,103,8:30 pm,Milwaukee Bucks,93
Mon Dec 28 2015,1,Golden State Warriors,19,122,10:30 pm,Sacramento Kings,103
Mon Dec 28 2015,1,Indiana Pacers,6,93,7:00 pm,Atlanta Hawks,87
Mon Dec 28 2015,0,Miami Heat,-6,105,7:30 pm,Brooklyn Nets,111
Mon Dec 28 2015,1,Orlando Magic,15,104,7:00 pm,New Orleans Pelicans,89
Mon Dec 28 2015,0,Phoenix Suns,-4,97,9:00 pm,Cleveland Cavaliers,101
Mon Dec 28 2015,1,San Antonio Spurs,6,101,8:30 pm,Minnesota Timberwolves,95
Mon Dec 28 2015,1,Utah Jazz,4,95,9:00 pm,Philadelphia 76ers,91
Mon Dec 28 2015,0,Washington Wizards,-17,91,7:00 pm,Los Angeles Clippers,108
Tue Dec 29 2015,0,Denver Nuggets,-6,87,9:00 pm,Cleveland Cavaliers,93
Tue Dec 29 2015,0,Houston Rockets,-6,115,8:00 pm,Atlanta Hawks,121
Tue Dec 29 2015,1,Memphis Grizzlies,9,99,8:00 pm,Miami Heat,90
Tue Dec 29 2015,1,New York Knicks,12,108,7:30 pm,Detroit Pistons,96
Tue Dec 29 2015,1,Oklahoma City Thunder,8,131,8:00 pm,Milwaukee Bucks,123
Wed Dec 30 2015,0,Boston Celtics,-8,104,7:30 pm,Los Angeles Lakers,112
Wed Dec 30 2015,1,Chicago Bulls,2,102,8:00 pm,Indiana Pacers,100
Wed Dec 30 2015,0,Charlotte Hornets,-5,117,7:00 pm,Los Angeles Clippers,122
Wed Dec 30 2015,1,Dallas Mavericks,23,114,8:30 pm,Golden State Warriors,91
Wed Dec 30 2015,1,Minnesota Timberwolves,14,94,8:00 pm,Utah Jazz,80
Wed Dec 30 2015,1,Orlando Magic,7,100,7:00 pm,Brooklyn Nets,93
Wed Dec 30 2015,1,Portland Trail Blazers,7,110,10:00 pm,Denver Nuggets,103
Wed Dec 30 2015,0,Sacramento Kings,-5,105,10:00 pm,Philadelphia 76ers,110
Wed Dec 30 2015,1,San Antonio Spurs,33,112,8:30 pm,Phoenix Suns,79
Wed Dec 30 2015,1,Toronto Raptors,3,94,7:30 pm,Washington Wizards,91
Thu Dec 31 2015,1,Detroit Pistons,25,115,6:00 pm,Minnesota Timberwolves,90
Thu Dec 31 2015,0,Houston Rockets,-4,110,7:00 pm,Golden State Warriors,114
Thu Dec 31 2015,0,Indiana Pacers,-4,116,6:00 pm,Milwaukee Bucks,120
Thu Dec 31 2015,0,New Orleans Pelicans,-6,89,8:00 pm,Los Angeles Clippers,95
Thu Dec 31 2015,1,Oklahoma City Thunder,4,110,8:00 pm,Phoenix Suns,106
Thu Dec 31 2015,1,Utah Jazz,13,109,9:00 pm,Portland Trail Blazers,96
Fri Jan 1 2016,1,Chicago Bulls,27,108,8:00 pm,New York Knicks,81
Fri Jan 1 2016,1,Los Angeles Lakers,9,93,10:30 pm,Philadelphia 76ers,84
Fri Jan 1 2016,1,Miami Heat,24,106,7:30 pm,Dallas Mavericks,82
Fri Jan 1 2016,1,Toronto Raptors,10,104,7:30 pm,Charlotte Hornets,94
Fri Jan 1 2016,1,Washington Wizards,12,103,7:00 pm,Orlando Magic,91
Sat Jan 2 2016,0,Boston Celtics,-3,97,3:00 pm,Brooklyn Nets,100
Sat Jan 2 2016,0,Charlotte Hornets,-19,90,7:00 pm,Oklahoma City Thunder,109
Sat Jan 2 2016,1,Cleveland Cavaliers,25,104,7:30 pm,Orlando Magic,79
Sat Jan 2 2016,0,Dallas Mavericks,-7,98,8:30 pm,New Orleans Pelicans,105
Sat Jan 2 2016,1,Golden State Warriors,3,111,10:30 pm,Denver Nuggets,108
Sat Jan 2 2016,1,Indiana Pacers,12,94,7:00 pm,Detroit Pistons,82
Sat Jan 2 2016,1,Los Angeles Clippers,31,130,10:30 pm,Philadelphia 76ers,99
Sat Jan 2 2016,0,Minnesota Timberwolves,-10,85,8:00 pm,Milwaukee Bucks,95
Sat Jan 2 2016,1,Sacramento Kings,23,142,5:00 pm,Phoenix Suns,119
Sat Jan 2 2016,1,San Antonio Spurs,18,121,8:30 pm,Houston Rockets,103
Sat Jan 2 2016,1,Utah Jazz,5,92,9:00 pm,Memphis Grizzlies,87
Sun Jan 3 2016,0,Denver Nuggets,-6,106,9:00 pm,Portland Trail Blazers,112
Sun Jan 3 2016,1,Los Angeles Lakers,20,97,9:30 pm,Phoenix Suns,77
Sun Jan 3 2016,1,New York Knicks,14,111,3:30 pm,Atlanta Hawks,97
Sun Jan 3 2016,0,Toronto Raptors,-2,113,3:30 pm,Chicago Bulls,115
Sun Jan 3 2016,0,Washington Wizards,-22,75,6:00 pm,Miami Heat,97
Mon Jan 4 2016,0,Brooklyn Nets,-9,94,7:30 pm,Boston Celtics,103
Mon Jan 4 2016,1,Cleveland Cavaliers,22,122,7:00 pm,Toronto Raptors,100
Mon Jan 4 2016,1,Detroit Pistons,26,115,7:30 pm,Orlando Magic,89
Mon Jan 4 2016,1,Golden State Warriors,10,111,10:30 pm,Charlotte Hornets,101
Mon Jan 4 2016,1,Miami Heat,3,103,7:30 pm,Indiana Pacers,100
Mon Jan 4 2016,0,Milwaukee Bucks,-25,98,8:00 pm,San Antonio Spurs,123
Mon Jan 4 2016,0,Oklahoma City Thunder,-12,104,8:00 pm,Sacramento Kings,116
Mon Jan 4 2016,1,Philadelphia 76ers,10,109,7:00 pm,Minnesota Timberwolves,99
Mon Jan 4 2016,0,Portland Trail Blazers,-13,78,10:00 pm,Memphis Grizzlies,91
Mon Jan 4 2016,0,Utah Jazz,-2,91,9:00 pm,Houston Rockets,93
Tue Jan 5 2016,0,Atlanta Hawks,-6,101,8:00 pm,New York Knicks,107
Tue Jan 5 2016,1,Chicago Bulls,11,117,8:00 pm,Milwaukee Bucks,106
Tue Jan 5 2016,1,Dallas Mavericks,1,117,8:30 pm,Sacramento Kings,116
Tue Jan 5 2016,0,Los Angeles Lakers,-21,88,10:30 pm,Golden State Warriors,109
Wed Jan 6 2016,0,Boston Celtics,-5,94,7:30 pm,Detroit Pistons,99
Wed Jan 6 2016,0,Brooklyn Nets,-17,74,7:30 pm,Toronto Raptors,91
Wed Jan 6 2016,0,Miami Heat,-8,90,7:00 pm,New York Knicks,98
Wed Jan 6 2016,0,Minnesota Timberwolves,-4,74,8:00 pm,Denver Nuggets,78
Wed Jan 6 2016,0,New Orleans Pelicans,-9,91,8:00 pm,Dallas Mavericks,100
Wed Jan 6 2016,1,Oklahoma City Thunder,18,112,9:30 pm,Memphis Grizzlies,94
Wed Jan 6 2016,0,Orlando Magic,-9,86,7:00 pm,Indiana Pacers,95
Wed Jan 6 2016,1,Phoenix Suns,9,111,9:00 pm,Charlotte Hornets,102
Wed Jan 6 2016,0,Portland Trail Blazers,-11,98,10:00 pm,Los Angeles Clippers,109
Wed Jan 6 2016,1,San Antonio Spurs,25,123,8:30 pm,Utah Jazz,98
Wed Jan 6 2016,0,Washington Wizards,-6,115,7:00 pm,Cleveland Cavaliers,121
Thu Jan 7 2016,1,Chicago Bulls,9,101,8:00 pm,Boston Celtics,92
Thu Jan 7 2016,1,Houston Rockets,9,103,8:00 pm,Utah Jazz,94
Thu Jan 7 2016,0,Philadelphia 76ers,-28,98,7:00 pm,Atlanta Hawks,126
Thu Jan 7 2016,1,Sacramento Kings,3,118,10:30 pm,Los Angeles Lakers,115
Fri Jan 8 2016,0,Brooklyn Nets,-6,77,7:30 pm,Orlando Magic,83
Fri Jan 8 2016,0,Los Angeles Lakers,-4,113,10:30 pm,Oklahoma City Thunder,117
Fri Jan 8 2016,1,Memphis Grizzlies,7,91,8:00 pm,Denver Nuggets,84
Fri Jan 8 2016,1,Milwaukee Bucks,1,96,8:00 pm,Dallas Mavericks,95
Fri Jan 8 2016,0,Minnesota Timberwolves,-26,99,8:00 pm,Cleveland Cavaliers,125
Fri Jan 8 2016,0,New Orleans Pelicans,-5,86,8:00 pm,Indiana Pacers,91
Fri Jan 8 2016,0,Phoenix Suns,-8,95,9:30 pm,Miami Heat,103
Fri Jan 8 2016,0,Portland Trail Blazers,-20,108,10:00 pm,Golden State Warriors,128
Fri Jan 8 2016,1,San Antonio Spurs,1,100,8:30 pm,New York Knicks,99
Fri Jan 8 2016,0,Washington Wizards,-9,88,7:00 pm,Toronto Raptors,97
Sat Jan 9 2016,1,Atlanta Hawks,15,120,5:00 pm,Chicago Bulls,105
Sat Jan 9 2016,1,Detroit Pistons,14,103,7:30 pm,Brooklyn Nets,89
Sat Jan 9 2016,1,Los Angeles Clippers,14,97,3:30 pm,Charlotte Hornets,83
Sat Jan 9 2016,0,Orlando Magic,-6,99,7:00 pm,Washington Wizards,105
Sat Jan 9 2016,0,Philadelphia 76ers,-13,95,7:30 pm,Toronto Raptors,108
Sat Jan 9 2016,0,Sacramento Kings,-12,116,10:00 pm,Golden State Warriors,128
Sat Jan 9 2016,1,Utah Jazz,15,98,9:00 pm,Miami Heat,83
Sun Jan 10 2016,1,Denver Nuggets,3,95,8:00 pm,Charlotte Hornets,92
Sun Jan 10 2016,1,Houston Rockets,4,107,7:00 pm,Indiana Pacers,103
Sun Jan 10 2016,1,Los Angeles Clippers,3,114,3:30 pm,New Orleans Pelicans,111
Sun Jan 10 2016,0,Los Angeles Lakers,-12,74,9:30 pm,Utah Jazz,86
Sun Jan 10 2016,1,Memphis Grizzlies,3,101,6:00 pm,Boston Celtics,98
Sun Jan 10 2016,0,Minnesota Timberwolves,-6,87,5:00 pm,Dallas Mavericks,93
Sun Jan 10 2016,1,New York Knicks,12,100,7:30 pm,Milwaukee Bucks,88
Sun Jan 10 2016,0,Philadelphia 76ers,-10,85,6:00 pm,Cleveland Cavaliers,95
Sun Jan 10 2016,1,Portland Trail Blazers,5,115,9:00 pm,Oklahoma City Thunder,110
Mon Jan 11 2016,0,Brooklyn Nets,-27,79,7:30 pm,San Antonio Spurs,106
Mon Jan 11 2016,0,Chicago Bulls,-14,100,8:00 pm,Washington Wizards,114
Mon Jan 11 2016,1,Golden State Warriors,8,111,10:30 pm,Miami Heat,103
Tue Jan 12 2016,0,Dallas Mavericks,-3,107,8:30 pm,Cleveland Cavaliers,110
Tue Jan 12 2016,0,Detroit Pistons,-10,99,7:30 pm,San Antonio Spurs,109
Tue Jan 12 2016,1,Indiana Pacers,19,116,7:00 pm,Phoenix Suns,97
Tue Jan 12 2016,1,Los Angeles Lakers,4,95,10:30 pm,New Orleans Pelicans,91
Tue Jan 12 2016,0,Memphis Grizzlies,-16,91,8:00 pm,Houston Rockets,107
Tue Jan 12 2016,1,Milwaukee Bucks,5,106,8:00 pm,Chicago Bulls,101
Tue Jan 12 2016,0,Minnesota Timberwolves,-5,96,8:00 pm,Oklahoma City Thunder,101
Tue Jan 12 2016,1,New York Knicks,6,120,7:30 pm,Boston Celtics,114
Wed Jan 13 2016,1,Boston Celtics,9,103,8:00 pm,Indiana Pacers,94
Wed Jan 13 2016,1,Brooklyn Nets,6,110,7:30 pm,New York Knicks,104
Wed Jan 13 2016,1,Charlotte Hornets,23,107,7:00 pm,Atlanta Hawks,84
Wed Jan 13 2016,1,Denver Nuggets,2,112,9:00 pm,Golden State Warriors,110
Wed Jan 13 2016,1,Houston Rockets,3,107,8:00 pm,Minnesota Timberwolves,104
Wed Jan 13 2016,1,Los Angeles Clippers,14,104,10:30 pm,Miami Heat,90
Wed Jan 13 2016,1,Oklahoma City Thunder,19,108,8:00 pm,Dallas Mavericks,89
Wed Jan 13 2016,1,Portland Trail Blazers,14,99,10:00 pm,Utah Jazz,85
Wed Jan 13 2016,0,Sacramento Kings,-12,97,10:00 pm,New Orleans Pelicans,109
Wed Jan 13 2016,1,Washington Wizards,5,106,7:00 pm,Milwaukee Bucks,101
Thu Jan 14 2016,1,Golden State Warriors,18,116,10:30 pm,Los Angeles Lakers,98
Thu Jan 14 2016,1,Memphis Grizzlies,2,103,8:00 pm,Detroit Pistons,101
Thu Jan 14 2016,0,Orlando Magic,-3,103,3:00 pm,Toronto Raptors,106
Thu Jan 14 2016,0,Philadelphia 76ers,-4,111,7:00 pm,Chicago Bulls,115
Thu Jan 14 2016,1,San Antonio Spurs,4,99,8:00 pm,Cleveland Cavaliers,95
Thu Jan 14 2016,0,Utah Jazz,-2,101,9:00 pm,Sacramento Kings,103
Fri Jan 15 2016,1,Boston Celtics,14,117,7:30 pm,Phoenix Suns,103
Fri Jan 15 2016,0,Brooklyn Nets,-12,104,7:30 pm,Portland Trail Blazers,116
Fri Jan 15 2016,0,Chicago Bulls,-6,77,8:00 pm,Dallas Mavericks,83
Fri Jan 15 2016,0,Denver Nuggets,-3,95,9:00 pm,Miami Heat,98
Fri Jan 15 2016,0,Houston Rockets,-14,77,9:30 pm,Cleveland Cavaliers,91
Fri Jan 15 2016,0,Indiana Pacers,-14,104,7:00 pm,Washington Wizards,118
Fri Jan 15 2016,1,Milwaukee Bucks,7,108,8:00 pm,Atlanta Hawks,101
Fri Jan 15 2016,1,New Orleans Pelicans,2,109,8:00 pm,Charlotte Hornets,107
Fri Jan 15 2016,1,Oklahoma City Thunder,20,113,7:00 pm,Minnesota Timberwolves,93
Sat Jan 16 2016,1,Atlanta Hawks,28,114,7:30 pm,Brooklyn Nets,86
Sat Jan 16 2016,0,Charlotte Hornets,-13,92,7:00 pm,Milwaukee Bucks,105
Sat Jan 16 2016,1,Detroit Pistons,18,113,7:30 pm,Golden State Warriors,95
Sat Jan 16 2016,0,Los Angeles Clippers,-7,103,10:30 pm,Sacramento Kings,110
Sat Jan 16 2016,1,Memphis Grizzlies,8,103,8:00 pm,New York Knicks,95
Sat Jan 16 2016,1,Philadelphia 76ers,25,114,7:30 pm,Portland Trail Blazers,89
Sat Jan 16 2016,1,Utah Jazz,27,109,9:00 pm,Los Angeles Lakers,82
Sat Jan 16 2016,0,Washington Wizards,-2,117,7:30 pm,Boston Celtics,119
Sun Jan 17 2016,1,Denver Nuggets,3,129,8:00 pm,Indiana Pacers,126
Sun Jan 17 2016,0,Los Angeles Lakers,-17,95,9:30 pm,Houston Rockets,112
Sun Jan 17 2016,1,Minnesota Timberwolves,30,117,3:30 pm,Phoenix Suns,87
Sun Jan 17 2016,1,Oklahoma City Thunder,25,99,7:00 pm,Miami Heat,74
Sun Jan 17 2016,1,San Antonio Spurs,29,112,7:00 pm,Dallas Mavericks,83
Mon Jan 18 2016,1,Atlanta Hawks,17,98,5:00 pm,Orlando Magic,81
Mon Jan 18 2016,1,Charlotte Hornets,5,124,2:00 pm,Utah Jazz,119
Mon Jan 18 2016,0,Cleveland Cavaliers,-34,98,8:00 pm,Golden State Warriors,132
Mon Jan 18 2016,1,Dallas Mavericks,5,118,8:30 pm,Boston Celtics,113
Mon Jan 18 2016,0,Detroit Pistons,-10,101,3:30 pm,Chicago Bulls,111
Mon Jan 18 2016,1,Los Angeles Clippers,8,140,10:30 pm,Houston Rockets,132
Mon Jan 18 2016,1,Memphis Grizzlies,2,101,2:30 pm,New Orleans Pelicans,99
Mon Jan 18 2016,1,New York Knicks,6,119,1:00 pm,Philadelphia 76ers,113
Mon Jan 18 2016,1,Toronto Raptors,12,112,7:30 pm,Brooklyn Nets,100
Mon Jan 18 2016,0,Washington Wizards,-10,98,2:00 pm,Portland Trail Blazers,108
Tue Jan 19 2016,0,Denver Nuggets,-6,104,9:00 pm,Oklahoma City Thunder,110
Tue Jan 19 2016,0,Miami Heat,-12,79,7:30 pm,Milwaukee Bucks,91
Tue Jan 19 2016,1,New Orleans Pelicans,15,114,8:00 pm,Minnesota Timberwolves,99
Tue Jan 19 2016,0,Phoenix Suns,-3,94,9:00 pm,Indiana Pacers,97
Wed Jan 20 2016,0,Brooklyn Nets,-13,78,7:30 pm,Cleveland Cavaliers,91
Wed Jan 20 2016,0,Chicago Bulls,-31,94,8:00 pm,Golden State Warriors,125
Wed Jan 20 2016,1,Dallas Mavericks,12,106,8:30 pm,Minnesota Timberwolves,94
Wed Jan 20 2016,0,Houston Rockets,-9,114,8:00 pm,Detroit Pistons,123
Wed Jan 20 2016,0,Los Angeles Lakers,-19,93,10:30 pm,Sacramento Kings,112
Wed Jan 20 2016,1,New York Knicks,7,118,7:30 pm,Utah Jazz,111
Wed Jan 20 2016,1,Oklahoma City Thunder,14,109,8:00 pm,Charlotte Hornets,95
Wed Jan 20 2016,0,Orlando Magic,-9,87,7:00 pm,Philadelphia 76ers,96
Wed Jan 20 2016,0,Portland Trail Blazers,-6,98,10:30 pm,Atlanta Hawks,104
Wed Jan 20 2016,1,Toronto Raptors,6,115,7:30 pm,Boston Celtics,109
Wed Jan 20 2016,1,Washington Wizards,19,106,7:00 pm,Miami Heat,87
Thu Jan 21 2016,1,Cleveland Cavaliers,13,115,8:00 pm,Los Angeles Clippers,102
Thu Jan 21 2016,0,Denver Nuggets,-1,101,9:00 pm,Memphis Grizzlies,102
Thu Jan 21 2016,1,New Orleans Pelicans,16,115,8:00 pm,Detroit Pistons,99
Thu Jan 21 2016,0,Phoenix Suns,-28,89,10:30 pm,San Antonio Spurs,117
Thu Jan 21 2016,1,Sacramento Kings,3,91,10:00 pm,Atlanta Hawks,88
Fri Jan 22 2016,1,Boston Celtics,9,110,7:30 pm,Chicago Bulls,101
Fri Jan 22 2016,0,Brooklyn Nets,-22,86,7:30 pm,Utah Jazz,108
Fri Jan 22 2016,0,Dallas Mavericks,-3,106,8:30 pm,Oklahoma City Thunder,109
Fri Jan 22 2016,1,Golden State Warriors,12,122,10:30 pm,Indiana Pacers,110
Fri Jan 22 2016,1,Houston Rockets,4,102,8:00 pm,Milwaukee Bucks,98
Fri Jan 22 2016,0,Los Angeles Lakers,-13,95,10:30 pm,San Antonio Spurs,108
Fri Jan 22 2016,0,New York Knicks,-28,88,7:30 pm,Los Angeles Clippers,116
Fri Jan 22 2016,0,Orlando Magic,-4,116,7:00 pm,Charlotte Hornets,120
Fri Jan 22 2016,1,Toronto Raptors,20,101,8:00 pm,Miami Heat,81
Sat Jan 23 2016,1,Charlotte Hornets,13,97,7:00 pm,New York Knicks,84
Sat Jan 23 2016,0,Cleveland Cavaliers,-13,83,8:30 pm,Chicago Bulls,96
Sat Jan 23 2016,1,Denver Nuggets,3,104,9:30 pm,Detroit Pistons,101
Sat Jan 23 2016,1,Minnesota Timberwolves,5,106,8:00 pm,Memphis Grizzlies,101
Sat Jan 23 2016,1,New Orleans Pelicans,17,116,7:00 pm,Milwaukee Bucks,99
Sat Jan 23 2016,1,Phoenix Suns,3,98,9:00 pm,Atlanta Hawks,95
Sat Jan 23 2016,1,Portland Trail Blazers,18,121,10:30 pm,Los Angeles Lakers,103
Sat Jan 23 2016,1,Sacramento Kings,11,108,10:30 pm,Indiana Pacers,97
Sun Jan 24 2016,1,Brooklyn Nets,10,116,7:30 pm,Oklahoma City Thunder,106
Sun Jan 24 2016,1,Houston Rockets,11,115,3:30 pm,Dallas Mavericks,104
Sun Jan 24 2016,0,Philadelphia 76ers,-20,92,7:00 pm,Boston Celtics,112
Sun Jan 24 2016,1,Toronto Raptors,18,112,6:00 pm,Los Angeles Clippers,94
Mon Jan 25 2016,0,Chicago Bulls,-5,84,8:00 pm,Miami Heat,89
Mon Jan 25 2016,1,Cleveland Cavaliers,7,114,7:00 pm,Minnesota Timberwolves,107
Mon Jan 25 2016,0,Denver Nuggets,-14,105,9:00 pm,Atlanta Hawks,119
Mon Jan 25 2016,1,Golden State Warriors,30,120,10:30 pm,San Antonio Spurs,90
Mon Jan 25 2016,1,Memphis Grizzlies,6,108,8:00 pm,Orlando Magic,102
Mon Jan 25 2016,0,New Orleans Pelicans,-1,111,8:00 pm,Houston Rockets,112
Mon Jan 25 2016,0,Sacramento Kings,-1,128,10:00 pm,Charlotte Hornets,129
Mon Jan 25 2016,0,Utah Jazz,-3,92,9:00 pm,Detroit Pistons,95
Mon Jan 25 2016,0,Washington Wizards,-25,91,7:00 pm,Boston Celtics,116
Tue Jan 26 2016,0,Brooklyn Nets,-4,98,7:30 pm,Miami Heat,102
Tue Jan 26 2016,0,Indiana Pacers,-2,89,7:00 pm,Los Angeles Clippers,91
Tue Jan 26 2016,0,Los Angeles Lakers,-2,90,10:30 pm,Dallas Mavericks,92
Tue Jan 26 2016,1,Milwaukee Bucks,7,107,8:00 pm,Orlando Magic,100
Tue Jan 26 2016,0,New York Knicks,-6,122,7:30 pm,Oklahoma City Thunder,128
Tue Jan 26 2016,1,Philadelphia 76ers,10,113,7:00 pm,Phoenix Suns,103
Tue Jan 26 2016,1,Portland Trail Blazers,15,112,10:00 pm,Sacramento Kings,97
Tue Jan 26 2016,1,Toronto Raptors,17,106,7:30 pm,Washington Wizards,89
Wed Jan 27 2016,0,Atlanta Hawks,-2,83,8:00 pm,Los Angeles Clippers,85
Wed Jan 27 2016,1,Boston Celtics,8,111,7:30 pm,Denver Nuggets,103
Wed Jan 27 2016,1,Cleveland Cavaliers,22,115,7:00 pm,Phoenix Suns,93
Wed Jan 27 2016,1,Detroit Pistons,13,110,7:30 pm,Philadelphia 76ers,97
Wed Jan 27 2016,1,Golden State Warriors,20,127,10:30 pm,Dallas Mavericks,107
Wed Jan 27 2016,0,Minnesota Timberwolves,-3,123,8:00 pm,Oklahoma City Thunder,126
Wed Jan 27 2016,1,San Antonio Spurs,31,130,8:00 pm,Houston Rockets,99
Wed Jan 27 2016,1,Utah Jazz,29,102,9:00 pm,Charlotte Hornets,73
Thu Jan 28 2016,1,Indiana Pacers,19,111,7:00 pm,Atlanta Hawks,92
Thu Jan 28 2016,0,Los Angeles Lakers,-23,91,10:30 pm,Chicago Bulls,114
Thu Jan 28 2016,1,Memphis Grizzlies,20,103,8:00 pm,Milwaukee Bucks,83
Thu Jan 28 2016,1,New Orleans Pelicans,9,114,8:00 pm,Sacramento Kings,105
Thu Jan 28 2016,1,Toronto Raptors,10,103,8:00 pm,New York Knicks,93
Thu Jan 28 2016,0,Washington Wizards,-4,113,7:00 pm,Denver Nuggets,117
Fri Jan 29 2016,1,Boston Celtics,19,113,7:30 pm,Orlando Magic,94
Fri Jan 29 2016,1,Dallas Mavericks,12,91,8:30 pm,Brooklyn Nets,79
Fri Jan 29 2016,0,Detroit Pistons,-8,106,7:30 pm,Cleveland Cavaliers,114
Fri Jan 29 2016,1,Los Angeles Clippers,12,105,10:30 pm,Los Angeles Lakers,93
Fri Jan 29 2016,0,Milwaukee Bucks,-4,103,8:00 pm,Miami Heat,107
Fri Jan 29 2016,1,New York Knicks,18,102,7:30 pm,Phoenix Suns,84
Fri Jan 29 2016,1,Oklahoma City Thunder,8,116,8:00 pm,Houston Rockets,108
Fri Jan 29 2016,1,Portland Trail Blazers,18,109,10:00 pm,Charlotte Hornets,91
Fri Jan 29 2016,1,Utah Jazz,13,103,9:00 pm,Minnesota Timberwolves,90
Sat Jan 30 2016,1,Cleveland Cavaliers,14,117,8:30 pm,San Antonio Spurs,103
Sat Jan 30 2016,0,Houston Rockets,-1,122,8:00 pm,Washington Wizards,123
Sat Jan 30 2016,1,Indiana Pacers,4,109,7:00 pm,Denver Nuggets,105
Sat Jan 30 2016,1,Memphis Grizzlies,4,121,8:00 pm,Sacramento Kings,117
Sat Jan 30 2016,1,New Orleans Pelicans,2,105,7:00 pm,Brooklyn Nets,103
Sat Jan 30 2016,0,Philadelphia 76ers,-3,105,5:00 pm,Golden State Warriors,108
Sat Jan 30 2016,1,Toronto Raptors,4,111,6:30 pm,Detroit Pistons,107
Sun Jan 31 2016,1,Dallas Mavericks,13,91,7:00 pm,Phoenix Suns,78
Sun Jan 31 2016,1,Los Angeles Clippers,27,120,3:30 pm,Chicago Bulls,93
Sun Jan 31 2016,0,Los Angeles Lakers,-19,82,9:30 pm,Charlotte Hornets,101
Sun Jan 31 2016,1,Miami Heat,18,105,6:00 pm,Atlanta Hawks,87
Sun Jan 31 2016,0,New York Knicks,-21,95,7:30 pm,Golden State Warriors,116
Sun Jan 31 2016,1,Orlando Magic,5,119,6:00 pm,Boston Celtics,114
Sun Jan 31 2016,1,Portland Trail Blazers,3,96,9:00 pm,Minnesota Timberwolves,93
Mon Feb 1 2016,1,Atlanta Hawks,15,112,8:00 pm,Dallas Mavericks,97
Mon Feb 1 2016,0,Brooklyn Nets,-5,100,7:30 pm,Detroit Pistons,105
Mon Feb 1 2016,1,Denver Nuggets,19,112,9:00 pm,Toronto Raptors,93
Mon Feb 1 2016,0,Indiana Pacers,-5,106,7:00 pm,Cleveland Cavaliers,111
Mon Feb 1 2016,0,New Orleans Pelicans,-15,95,8:00 pm,Memphis Grizzlies,110
Mon Feb 1 2016,1,Oklahoma City Thunder,16,114,8:00 pm,Washington Wizards,98
Mon Feb 1 2016,1,Sacramento Kings,7,111,10:00 pm,Milwaukee Bucks,104
Mon Feb 1 2016,1,San Antonio Spurs,15,107,8:30 pm,Orlando Magic,92
Mon Feb 1 2016,1,Utah Jazz,9,105,9:00 pm,Chicago Bulls,96
Tue Feb 2 2016,1,Houston Rockets,13,115,8:00 pm,Miami Heat,102
Tue Feb 2 2016,1,Los Angeles Lakers,4,119,10:30 pm,Minnesota Timberwolves,115
Tue Feb 2 2016,0,New York Knicks,-8,89,7:30 pm,Boston Celtics,97
Tue Feb 2 2016,0,Phoenix Suns,-7,97,9:00 pm,Toronto Raptors,104
Tue Feb 2 2016,1,Portland Trail Blazers,12,107,10:00 pm,Milwaukee Bucks,95
Wed Feb 3 2016,1,Boston Celtics,7,102,7:30 pm,Detroit Pistons,95
Wed Feb 3 2016,0,Brooklyn Nets,-14,100,7:30 pm,Indiana Pacers,114
Wed Feb 3 2016,1,Charlotte Hornets,9,106,7:00 pm,Cleveland Cavaliers,97
Wed Feb 3 2016,0,Dallas Mavericks,-3,90,8:30 pm,Miami Heat,93
Wed Feb 3 2016,0,Los Angeles Clippers,-6,102,10:30 pm,Minnesota Timberwolves,108
Wed Feb 3 2016,1,Oklahoma City Thunder,3,117,8:00 pm,Orlando Magic,114
Wed Feb 3 2016,0,Philadelphia 76ers,-38,86,7:00 pm,Atlanta Hawks,124
Wed Feb 3 2016,0,Sacramento Kings,-5,102,10:00 pm,Chicago Bulls,107
Wed Feb 3 2016,1,San Antonio Spurs,13,110,8:30 pm,New Orleans Pelicans,97
Wed Feb 3 2016,1,Utah Jazz,4,85,9:00 pm,Denver Nuggets,81
Wed Feb 3 2016,0,Washington Wizards,-13,121,8:00 pm,Golden State Warriors,134
Thu Feb 4 2016,1,Detroit Pistons,6,111,7:00 pm,New York Knicks,105
Thu Feb 4 2016,0,New Orleans Pelicans,-3,96,9:30 pm,Los Angeles Lakers,99
Thu Feb 4 2016,0,Phoenix Suns,-6,105,9:00 pm,Houston Rockets,111
Thu Feb 4 2016,0,Portland Trail Blazers,-7,103,10:00 pm,Toronto Raptors,110
Fri Feb 5 2016,1,Atlanta Hawks,6,102,7:00 pm,Indiana Pacers,96
Fri Feb 5 2016,1,Brooklyn Nets,9,128,7:30 pm,Sacramento Kings,119
Fri Feb 5 2016,0,Charlotte Hornets,-3,95,7:00 pm,Miami Heat,98
Fri Feb 5 2016,0,Cleveland Cavaliers,-1,103,7:30 pm,Boston Celtics,104
Fri Feb 5 2016,0,Dallas Mavericks,-26,90,9:30 pm,San Antonio Spurs,116
Fri Feb 5 2016,1,Denver Nuggets,5,115,9:00 pm,Chicago Bulls,110
Fri Feb 5 2016,0,New York Knicks,-6,85,7:30 pm,Memphis Grizzlies,91
Fri Feb 5 2016,0,Orlando Magic,-14,93,7:00 pm,Los Angeles Clippers,107
Fri Feb 5 2016,1,Utah Jazz,3,84,9:00 pm,Milwaukee Bucks,81
Fri Feb 5 2016,1,Washington Wizards,12,106,7:00 pm,Philadelphia 76ers,94
Sat Feb 6 2016,1,Charlotte Hornets,4,108,7:00 pm,Washington Wizards,104
Sat Feb 6 2016,1,Cleveland Cavaliers,15,99,7:30 pm,New Orleans Pelicans,84
Sat Feb 6 2016,1,Golden State Warriors,8,116,9:00 pm,Oklahoma City Thunder,108
Sat Feb 6 2016,0,Houston Rockets,-17,79,5:00 pm,Portland Trail Blazers,96
Sat Feb 6 2016,1,Indiana Pacers,8,112,7:00 pm,Detroit Pistons,104
Sat Feb 6 2016,0,Memphis Grizzlies,-4,110,8:00 pm,Dallas Mavericks,114
Sat Feb 6 2016,1,Minnesota Timberwolves,7,112,8:00 pm,Chicago Bulls,105
Sat Feb 6 2016,1,Philadelphia 76ers,5,103,7:30 pm,Brooklyn Nets,98
Sat Feb 6 2016,0,Phoenix Suns,-9,89,9:00 pm,Utah Jazz,98
Sat Feb 6 2016,1,San Antonio Spurs,4,106,8:30 pm,Los Angeles Lakers,102
Sun Feb 7 2016,1,Boston Celtics,9,128,1:00 pm,Sacramento Kings,119
Sun Feb 7 2016,0,Miami Heat,-7,93,2:00 pm,Los Angeles Clippers,100
Sun Feb 7 2016,0,New York Knicks,-5,96,1:00 pm,Denver Nuggets,101
Sun Feb 7 2016,1,Orlando Magic,2,96,1:00 pm,Atlanta Hawks,94
Mon Feb 8 2016,0,Atlanta Hawks,-7,110,8:00 pm,Orlando Magic,117
Mon Feb 8 2016,1,Brooklyn Nets,1,105,7:30 pm,Denver Nuggets,104
Mon Feb 8 2016,1,Charlotte Hornets,17,108,7:00 pm,Chicago Bulls,91
Mon Feb 8 2016,1,Cleveland Cavaliers,20,120,7:00 pm,Sacramento Kings,100
Mon Feb 8 2016,0,Detroit Pistons,-14,89,7:30 pm,Toronto Raptors,103
Mon Feb 8 2016,1,Indiana Pacers,2,89,7:00 pm,Los Angeles Lakers,87
Mon Feb 8 2016,0,Memphis Grizzlies,-6,106,8:00 pm,Portland Trail Blazers,112
Mon Feb 8 2016,0,Minnesota Timberwolves,-14,102,8:00 pm,New Orleans Pelicans,116
Mon Feb 8 2016,0,Philadelphia 76ers,-6,92,7:00 pm,Los Angeles Clippers,98
Mon Feb 8 2016,0,Phoenix Suns,-16,106,9:00 pm,Oklahoma City Thunder,122
Tue Feb 9 2016,0,Dallas Mavericks,-2,119,8:30 pm,Utah Jazz,121
Tue Feb 9 2016,1,Golden State Warriors,13,123,10:30 pm,Houston Rockets,110
Tue Feb 9 2016,0,Miami Heat,-18,101,8:00 pm,San Antonio Spurs,119
Tue Feb 9 2016,1,Milwaukee Bucks,1,112,8:00 pm,Boston Celtics,111
Tue Feb 9 2016,0,New York Knicks,-3,108,8:00 pm,Washington Wizards,111
Wed Feb 10 2016,1,Boston Celtics,5,139,7:30 pm,Los Angeles Clippers,134
Wed Feb 10 2016,0,Brooklyn Nets,-19,90,7:30 pm,Memphis Grizzlies,109
Wed Feb 10 2016,0,Chicago Bulls,-23,90,8:00 pm,Atlanta Hawks,113
Wed Feb 10 2016,1,Cleveland Cavaliers,9,120,8:00 pm,Los Angeles Lakers,111
Wed Feb 10 2016,0,Detroit Pistons,-11,92,7:30 pm,Denver Nuggets,103
Wed Feb 10 2016,0,Indiana Pacers,-22,95,7:00 pm,Charlotte Hornets,117
Wed Feb 10 2016,1,Minnesota Timberwolves,5,117,8:00 pm,Toronto Raptors,112
Wed Feb 10 2016,1,New Orleans Pelicans,4,100,8:00 pm,Utah Jazz,96
Wed Feb 10 2016,0,Orlando Magic,-2,96,7:00 pm,San Antonio Spurs,98
Wed Feb 10 2016,0,Philadelphia 76ers,-4,110,7:00 pm,Sacramento Kings,114
Wed Feb 10 2016,0,Phoenix Suns,-8,104,9:00 pm,Golden State Warriors,112
Wed Feb 10 2016,1,Portland Trail Blazers,13,116,10:30 pm,Houston Rockets,103
Thu Feb 11 2016,1,Milwaukee Bucks,7,99,8:00 pm,Washington Wizards,92
Thu Feb 11 2016,1,Oklahoma City Thunder,26,121,8:00 pm,New Orleans Pelicans,95
Thu Feb 18 2016,1,Cleveland Cavaliers,11,106,8:00 pm,Chicago Bulls,95
Thu Feb 18 2016,1,Los Angeles Clippers,19,105,10:30 pm,San Antonio Spurs,86
Thu Feb 18 2016,1,Washington Wizards,14,103,7:00 pm,Utah Jazz,89
Fri Feb 19 2016,0,Atlanta Hawks,-4,111,8:00 pm,Miami Heat,115
Fri Feb 19 2016,1,Brooklyn Nets,11,109,7:30 pm,New York Knicks,98
Fri Feb 19 2016,1,Chicago Bulls,10,116,8:00 pm,Toronto Raptors,106
Fri Feb 19 2016,0,Los Angeles Lakers,-6,113,10:30 pm,San Antonio Spurs,119
Fri Feb 19 2016,1,Memphis Grizzlies,5,109,8:00 pm,Minnesota Timberwolves,104
Fri Feb 19 2016,0,Milwaukee Bucks,-3,95,8:00 pm,Charlotte Hornets,98
Fri Feb 19 2016,1,New Orleans Pelicans,7,121,8:00 pm,Philadelphia 76ers,114
Fri Feb 19 2016,0,Oklahoma City Thunder,-3,98,8:00 pm,Indiana Pacers,101
Fri Feb 19 2016,1,Orlando Magic,6,110,7:00 pm,Dallas Mavericks,104
Fri Feb 19 2016,0,Phoenix Suns,-16,100,9:30 pm,Houston Rockets,116
Fri Feb 19 2016,1,Portland Trail Blazers,32,137,10:00 pm,Golden State Warriors,105
Fri Feb 19 2016,1,Sacramento Kings,6,116,10:00 pm,Denver Nuggets,110
Fri Feb 19 2016,1,Utah Jazz,18,111,10:30 pm,Boston Celtics,93
Fri Feb 19 2016,1,Washington Wizards,12,98,7:00 pm,Detroit Pistons,86
Sat Feb 20 2016,0,Atlanta Hawks,-8,109,7:30 pm,Milwaukee Bucks,117
Sat Feb 20 2016,0,Los Angeles Clippers,-3,112,8:30 pm,Golden State Warriors,115
Sat Feb 20 2016,1,Miami Heat,20,114,7:30 pm,Washington Wizards,94
Sat Feb 20 2016,0,Minnesota Timberwolves,-8,95,8:00 pm,New York Knicks,103
Sun Feb 21 2016,0,Brooklyn Nets,-8,96,6:00 pm,Charlotte Hornets,104
Sun Feb 21 2016,1,Chicago Bulls,11,126,8:00 pm,Los Angeles Lakers,115
Sun Feb 21 2016,1,Dallas Mavericks,26,129,7:00 pm,Philadelphia 76ers,103
Sun Feb 21 2016,0,Denver Nuggets,-20,101,5:00 pm,Boston Celtics,121
Sun Feb 21 2016,0,Detroit Pistons,-5,106,3:30 pm,New Orleans Pelicans,111
Sun Feb 21 2016,0,Oklahoma City Thunder,-23,92,3:30 pm,Cleveland Cavaliers,115
Sun Feb 21 2016,0,Orlando Magic,-3,102,6:00 pm,Indiana Pacers,105
Sun Feb 21 2016,0,Phoenix Suns,-7,111,5:00 pm,San Antonio Spurs,118
Sun Feb 21 2016,1,Portland Trail Blazers,4,115,9:00 pm,Utah Jazz,111
Sun Feb 21 2016,1,Toronto Raptors,13,98,6:00 pm,Memphis Grizzlies,85
Mon Feb 22 2016,0,Atlanta Hawks,-10,92,8:00 pm,Golden State Warriors,102
Mon Feb 22 2016,0,Cleveland Cavaliers,-8,88,7:00 pm,Detroit Pistons,96
Mon Feb 22 2016,1,Los Angeles Clippers,40,124,10:30 pm,Phoenix Suns,84
Mon Feb 22 2016,1,Miami Heat,8,101,7:30 pm,Indiana Pacers,93
Mon Feb 22 2016,1,Milwaukee Bucks,7,108,8:00 pm,Los Angeles Lakers,101
Mon Feb 22 2016,1,Minnesota Timberwolves,2,124,8:00 pm,Boston Celtics,122
Mon Feb 22 2016,0,New York Knicks,-27,95,7:30 pm,Toronto Raptors,122
Tue Feb 23 2016,0,Denver Nuggets,-4,110,9:00 pm,Sacramento Kings,114
Tue Feb 23 2016,0,Philadelphia 76ers,-9,115,7:00 pm,Orlando Magic,124
Tue Feb 23 2016,1,Portland Trail Blazers,8,112,10:00 pm,Brooklyn Nets,104
Tue Feb 23 2016,1,Utah Jazz,3,117,9:00 pm,Houston Rockets,114
Tue Feb 23 2016,1,Washington Wizards,20,109,7:00 pm,New Orleans Pelicans,89
Wed Feb 24 2016,1,Chicago Bulls,5,109,8:00 pm,Washington Wizards,104
Wed Feb 24 2016,1,Cleveland Cavaliers,11,114,7:00 pm,Charlotte Hornets,103
Wed Feb 24 2016,0,Dallas Mavericks,-13,103,8:30 pm,Oklahoma City Thunder,116
Wed Feb 24 2016,1,Detroit Pistons,20,111,7:30 pm,Philadelphia 76ers,91
Wed Feb 24 2016,1,Indiana Pacers,3,108,7:00 pm,New York Knicks,105
Wed Feb 24 2016,0,Los Angeles Clippers,-6,81,10:30 pm,Denver Nuggets,87
Wed Feb 24 2016,1,Memphis Grizzlies,9,128,8:00 pm,Los Angeles Lakers,119
Wed Feb 24 2016,0,Miami Heat,-6,112,7:30 pm,Golden State Warriors,118
Wed Feb 24 2016,0,Sacramento Kings,-16,92,10:30 pm,San Antonio Spurs,108
Wed Feb 24 2016,1,Toronto Raptors,9,114,7:30 pm,Minnesota Timberwolves,105
Thu Feb 25 2016,1,Boston Celtics,5,112,7:30 pm,Milwaukee Bucks,107
Thu Feb 25 2016,1,New Orleans Pelicans,4,123,8:00 pm,Oklahoma City Thunder,119
Thu Feb 25 2016,0,Orlando Magic,-16,114,7:00 pm,Golden State Warriors,130
Thu Feb 25 2016,0,Phoenix Suns,-10,106,9:00 pm,Brooklyn Nets,116
Thu Feb 25 2016,0,Portland Trail Blazers,-14,105,10:30 pm,Houston Rockets,119
Thu Feb 25 2016,0,Utah Jazz,-18,78,10:30 pm,San Antonio Spurs,96
Fri Feb 26 2016,1,Atlanta Hawks,15,103,8:00 pm,Chicago Bulls,88
Fri Feb 26 2016,1,Dallas Mavericks,6,122,8:30 pm,Denver Nuggets,116
Fri Feb 26 2016,0,Indiana Pacers,-1,95,7:00 pm,Charlotte Hornets,96
Fri Feb 26 2016,0,Los Angeles Lakers,-17,95,10:30 pm,Memphis Grizzlies,112
Fri Feb 26 2016,1,New York Knicks,13,108,7:30 pm,Orlando Magic,95
Fri Feb 26 2016,0,Philadelphia 76ers,-9,94,7:00 pm,Washington Wizards,103
Fri Feb 26 2016,0,Sacramento Kings,-10,107,10:00 pm,Los Angeles Clippers,117
Fri Feb 26 2016,1,Toronto Raptors,2,99,7:30 pm,Cleveland Cavaliers,97
Sat Feb 27 2016,1,Boston Celtics,12,101,3:00 pm,Miami Heat,89
Sat Feb 27 2016,0,Chicago Bulls,-8,95,8:00 pm,Portland Trail Blazers,103
Sat Feb 27 2016,0,Houston Rockets,-10,94,8:00 pm,San Antonio Spurs,104
Sat Feb 27 2016,0,Milwaukee Bucks,-11,91,8:30 pm,Detroit Pistons,102
Sat Feb 27 2016,0,New Orleans Pelicans,-2,110,7:00 pm,Minnesota Timberwolves,112
Sat Feb 27 2016,0,Oklahoma City Thunder,-3,118,8:30 pm,Golden State Warriors,121
Sat Feb 27 2016,1,Phoenix Suns,5,111,9:30 pm,Memphis Grizzlies,106
Sat Feb 27 2016,0,Utah Jazz,-2,96,9:30 pm,Brooklyn Nets,98
Sun Feb 28 2016,1,Atlanta Hawks,11,87,3:30 pm,Charlotte Hornets,76
Sun Feb 28 2016,1,Dallas Mavericks,27,128,7:00 pm,Minnesota Timberwolves,101
Sun Feb 28 2016,1,Detroit Pistons,13,114,6:00 pm,Toronto Raptors,101
Sun Feb 28 2016,0,Indiana Pacers,-9,102,6:00 pm,Portland Trail Blazers,111
Sun Feb 28 2016,0,New York Knicks,-17,81,7:30 pm,Miami Heat,98
Sun Feb 28 2016,1,Orlando Magic,14,130,6:00 pm,Philadelphia 76ers,116
Sun Feb 28 2016,1,Washington Wizards,14,113,1:00 pm,Cleveland Cavaliers,99
Mon Feb 29 2016,1,Boston Celtics,5,100,7:30 pm,Utah Jazz,95
Mon Feb 29 2016,1,Cleveland Cavaliers,4,100,7:00 pm,Indiana Pacers,96
Mon Feb 29 2016,0,Denver Nuggets,-7,96,9:00 pm,Memphis Grizzlies,103
Mon Feb 29 2016,1,Los Angeles Clippers,10,105,10:30 pm,Brooklyn Nets,95
Mon Feb 29 2016,1,Milwaukee Bucks,7,128,8:00 pm,Houston Rockets,121
Mon Feb 29 2016,0,Sacramento Kings,-15,116,10:00 pm,Oklahoma City Thunder,131
Mon Feb 29 2016,1,Washington Wizards,8,116,7:00 pm,Philadelphia 76ers,108
Tue Mar 1 2016,1,Charlotte Hornets,34,126,7:00 pm,Phoenix Suns,92
Tue Mar 1 2016,1,Dallas Mavericks,13,121,8:30 pm,Orlando Magic,108
Tue Mar 1 2016,1,Golden State Warriors,4,109,10:30 pm,Atlanta Hawks,105
Tue Mar 1 2016,1,Los Angeles Lakers,6,107,10:30 pm,Brooklyn Nets,101
Tue Mar 1 2016,1,Miami Heat,18,129,7:30 pm,Chicago Bulls,111
Tue Mar 1 2016,0,New York Knicks,-19,85,7:30 pm,Portland Trail Blazers,104
Wed Mar 2 2016,1,Boston Celtics,23,116,7:30 pm,Portland Trail Blazers,93
Wed Mar 2 2016,1,Denver Nuggets,10,117,9:00 pm,Los Angeles Lakers,107
Wed Mar 2 2016,1,Houston Rockets,5,100,8:00 pm,New Orleans Pelicans,95
Wed Mar 2 2016,1,Los Angeles Clippers,5,103,10:30 pm,Oklahoma City Thunder,98
Wed Mar 2 2016,1,Memphis Grizzlies,6,104,8:00 pm,Sacramento Kings,98
Wed Mar 2 2016,0,Milwaukee Bucks,-5,99,8:00 pm,Indiana Pacers,104
Wed Mar 2 2016,0,Minnesota Timberwolves,-6,98,8:00 pm,Washington Wizards,104
Wed Mar 2 2016,1,Orlando Magic,13,102,7:00 pm,Chicago Bulls,89
Wed Mar 2 2016,0,Philadelphia 76ers,-20,99,7:00 pm,Charlotte Hornets,119
Wed Mar 2 2016,1,San Antonio Spurs,16,97,8:00 pm,Detroit Pistons,81
Wed Mar 2 2016,1,Toronto Raptors,10,104,7:30 pm,Utah Jazz,94
Thu Mar 3 2016,0,Dallas Mavericks,-3,101,8:30 pm,Sacramento Kings,104
Thu Mar 3 2016,1,Golden State Warriors,15,121,10:30 pm,Oklahoma City Thunder,106
Thu Mar 3 2016,1,Miami Heat,16,108,7:30 pm,Phoenix Suns,92
Thu Mar 3 2016,0,New Orleans Pelicans,-8,86,8:00 pm,San Antonio Spurs,94
Fri Mar 4 2016,1,Boston Celtics,1,105,7:30 pm,New York Knicks,104
Fri Mar 4 2016,1,Charlotte Hornets,7,108,7:00 pm,Indiana Pacers,101
Fri Mar 4 2016,1,Cleveland Cavaliers,25,108,8:00 pm,Washington Wizards,83
Fri Mar 4 2016,0,Denver Nuggets,-1,120,9:00 pm,Brooklyn Nets,121
Fri Mar 4 2016,0,Los Angeles Lakers,-29,77,10:30 pm,Atlanta Hawks,106
Fri Mar 4 2016,1,Memphis Grizzlies,6,94,8:00 pm,Utah Jazz,88
Fri Mar 4 2016,1,Milwaukee Bucks,15,116,8:00 pm,Minnesota Timberwolves,101
Fri Mar 4 2016,0,Orlando Magic,-18,84,7:00 pm,Phoenix Suns,102
Fri Mar 4 2016,0,Philadelphia 76ers,-10,102,7:00 pm,Miami Heat,112
Fri Mar 4 2016,1,Toronto Raptors,2,117,7:30 pm,Portland Trail Blazers,115
Sat Mar 5 2016,1,Chicago Bulls,8,108,8:30 pm,Houston Rockets,100
Sat Mar 5 2016,1,Cleveland Cavaliers,17,120,7:00 pm,Boston Celtics,103
Sat Mar 5 2016,0,Los Angeles Clippers,-10,97,10:30 pm,Atlanta Hawks,107
Sat Mar 5 2016,1,Minnesota Timberwolves,14,132,8:00 pm,Brooklyn Nets,118
Sat Mar 5 2016,0,New Orleans Pelicans,-12,94,7:00 pm,Utah Jazz,106
Sat Mar 5 2016,1,New York Knicks,13,102,7:00 pm,Detroit Pistons,89
Sat Mar 5 2016,1,San Antonio Spurs,10,104,8:30 pm,Sacramento Kings,94
Sat Mar 5 2016,0,Washington Wizards,-1,99,7:00 pm,Indiana Pacers,100
Sun Mar 6 2016,1,Denver Nuggets,2,116,5:00 pm,Dallas Mavericks,114
Sun Mar 6 2016,1,Detroit Pistons,20,123,6:00 pm,Portland Trail Blazers,103
Sun Mar 6 2016,1,Los Angeles Lakers,17,112,3:30 pm,Golden State Warriors,95
Sun Mar 6 2016,0,Memphis Grizzlies,-9,100,4:00 pm,Phoenix Suns,109
Sun Mar 6 2016,1,Miami Heat,5,103,6:00 pm,Philadelphia 76ers,98
Sun Mar 6 2016,0,Milwaukee Bucks,-8,96,3:30 pm,Oklahoma City Thunder,104
Sun Mar 6 2016,0,Toronto Raptors,-6,107,6:30 pm,Houston Rockets,113
Mon Mar 7 2016,1,Chicago Bulls,10,100,8:00 pm,Milwaukee Bucks,90
Mon Mar 7 2016,1,Charlotte Hornets,5,108,7:00 pm,Minnesota Timberwolves,103
Mon Mar 7 2016,0,Cleveland Cavaliers,-3,103,7:00 pm,Memphis Grizzlies,106
Mon Mar 7 2016,0,Dallas Mavericks,-19,90,8:30 pm,Los Angeles Clippers,109
Mon Mar 7 2016,1,Golden State Warriors,6,119,10:30 pm,Orlando Magic,113
Mon Mar 7 2016,1,Indiana Pacers,8,99,7:00 pm,San Antonio Spurs,91
Mon Mar 7 2016,1,New Orleans Pelicans,3,115,8:00 pm,Sacramento Kings,112
Tue Mar 8 2016,1,Denver Nuggets,16,110,9:00 pm,New York Knicks,94
Tue Mar 8 2016,1,Los Angeles Lakers,9,107,10:30 pm,Orlando Magic,98
Tue Mar 8 2016,0,Minnesota Timberwolves,-25,91,8:00 pm,San Antonio Spurs,116
Tue Mar 8 2016,1,Portland Trail Blazers,7,116,10:00 pm,Washington Wizards,109
Tue Mar 8 2016,1,Toronto Raptors,5,104,7:30 pm,Brooklyn Nets,99
Tue Mar 8 2016,0,Utah Jazz,-7,84,9:00 pm,Atlanta Hawks,91
Wed Mar 9 2016,1,Boston Celtics,20,116,7:00 pm,Memphis Grizzlies,96
Wed Mar 9 2016,1,Charlotte Hornets,9,122,7:00 pm,New Orleans Pelicans,113
Wed Mar 9 2016,0,Dallas Mavericks,-6,96,8:30 pm,Detroit Pistons,102
Wed Mar 9 2016,1,Golden State Warriors,21,115,10:30 pm,Utah Jazz,94
Wed Mar 9 2016,1,Milwaukee Bucks,6,114,8:00 pm,Miami Heat,108
Wed Mar 9 2016,1,Oklahoma City Thunder,12,120,9:30 pm,Los Angeles Clippers,108
Wed Mar 9 2016,0,Philadelphia 76ers,-14,104,7:00 pm,Houston Rockets,118
Wed Mar 9 2016,0,Phoenix Suns,-31,97,9:00 pm,New York Knicks,128
Wed Mar 9 2016,0,Sacramento Kings,-9,111,10:00 pm,Cleveland Cavaliers,120
Thu Mar 10 2016,1,Denver Nuggets,18,116,9:00 pm,Phoenix Suns,98
Thu Mar 10 2016,0,Los Angeles Lakers,-12,108,10:30 pm,Cleveland Cavaliers,120
Thu Mar 10 2016,1,San Antonio Spurs,8,109,8:00 pm,Chicago Bulls,101
Thu Mar 10 2016,1,Toronto Raptors,8,104,7:30 pm,Atlanta Hawks,96
Fri Mar 11 2016,0,Boston Celtics,-4,98,7:30 pm,Houston Rockets,102
Fri Mar 11 2016,0,Chicago Bulls,-22,96,8:00 pm,Miami Heat,118
Fri Mar 11 2016,1,Charlotte Hornets,15,118,7:00 pm,Detroit Pistons,103
Fri Mar 11 2016,1,Golden State Warriors,16,128,10:30 pm,Portland Trail Blazers,112
Fri Mar 11 2016,1,Los Angeles Clippers,7,101,10:30 pm,New York Knicks,94
Fri Mar 11 2016,1,Memphis Grizzlies,7,121,8:00 pm,New Orleans Pelicans,114
Fri Mar 11 2016,0,Oklahoma City Thunder,-3,96,8:00 pm,Minnesota Timberwolves,99
Fri Mar 11 2016,1,Philadelphia 76ers,6,95,7:00 pm,Brooklyn Nets,89
Fri Mar 11 2016,0,Sacramento Kings,-7,100,10:00 pm,Orlando Magic,107
Fri Mar 11 2016,1,Utah Jazz,21,114,9:00 pm,Washington Wizards,93
Sat Mar 12 2016,1,Atlanta Hawks,12,95,7:30 pm,Memphis Grizzlies,83
Sat Mar 12 2016,1,Charlotte Hornets,16,125,7:00 pm,Houston Rockets,109
Sat Mar 12 2016,0,Dallas Mavericks,-7,105,2:00 pm,Indiana Pacers,112
Sat Mar 12 2016,1,Denver Nuggets,16,116,9:30 pm,Washington Wizards,100
Sat Mar 12 2016,1,Golden State Warriors,7,123,10:30 pm,Phoenix Suns,116
Sat Mar 12 2016,1,Milwaukee Bucks,11,103,7:30 pm,New Orleans Pelicans,92
Sat Mar 12 2016,0,Philadelphia 76ers,-14,111,7:00 pm,Detroit Pistons,125
Sat Mar 12 2016,1,Portland Trail Blazers,37,121,10:30 pm,Orlando Magic,84
Sat Mar 12 2016,1,San Antonio Spurs,8,93,8:30 pm,Oklahoma City Thunder,85
Sat Mar 12 2016,1,Toronto Raptors,8,112,7:00 pm,Miami Heat,104
Sun Mar 13 2016,1,Atlanta Hawks,29,104,6:00 pm,Indiana Pacers,75
Sun Mar 13 2016,0,Brooklyn Nets,-9,100,8:00 pm,Milwaukee Bucks,109
Sun Mar 13 2016,0,Los Angeles Clippers,-24,90,3:30 pm,Cleveland Cavaliers,114
Sun Mar 13 2016,0,Los Angeles Lakers,-3,87,9:30 pm,New York Knicks,90
Sun Mar 13 2016,0,Sacramento Kings,-9,99,6:00 pm,Utah Jazz,108
Mon Mar 14 2016,0,Charlotte Hornets,-11,96,7:00 pm,Dallas Mavericks,107
Mon Mar 14 2016,1,Golden State Warriors,18,125,10:30 pm,New Orleans Pelicans,107
Mon Mar 14 2016,1,Houston Rockets,49,130,8:00 pm,Memphis Grizzlies,81
Mon Mar 14 2016,1,Miami Heat,5,124,7:30 pm,Denver Nuggets,119
Mon Mar 14 2016,1,Oklahoma City Thunder,34,128,8:00 pm,Portland Trail Blazers,94
Mon Mar 14 2016,1,Phoenix Suns,3,107,10:00 pm,Minnesota Timberwolves,104
Mon Mar 14 2016,0,Toronto Raptors,-2,107,7:30 pm,Chicago Bulls,109
Mon Mar 14 2016,1,Utah Jazz,9,94,10:30 pm,Cleveland Cavaliers,85
Mon Mar 14 2016,1,Washington Wizards,43,124,8:00 pm,Detroit Pistons,81
Tue Mar 15 2016,1,Brooklyn Nets,17,131,7:30 pm,Philadelphia 76ers,114
Tue Mar 15 2016,1,Indiana Pacers,5,103,7:00 pm,Boston Celtics,98
Tue Mar 15 2016,0,Los Angeles Lakers,-8,98,10:30 pm,Sacramento Kings,106
Tue Mar 15 2016,0,Milwaukee Bucks,-18,89,8:00 pm,Toronto Raptors,107
Tue Mar 15 2016,1,Orlando Magic,6,116,7:00 pm,Denver Nuggets,110
Tue Mar 15 2016,1,San Antonio Spurs,21,108,8:30 pm,Los Angeles Clippers,87
Wed Mar 16 2016,0,Boston Celtics,-21,109,7:00 pm,Oklahoma City Thunder,130
Wed Mar 16 2016,1,Charlotte Hornets,8,107,7:00 pm,Orlando Magic,99
Wed Mar 16 2016,1,Cleveland Cavaliers,1,99,7:00 pm,Dallas Mavericks,98
Wed Mar 16 2016,0,Detroit Pistons,-4,114,7:30 pm,Atlanta Hawks,118
Wed Mar 16 2016,1,Golden State Warriors,36,121,10:30 pm,New York Knicks,85
Wed Mar 16 2016,0,Houston Rockets,-16,106,9:30 pm,Los Angeles Clippers,122
Wed Mar 16 2016,0,Memphis Grizzlies,-6,108,8:00 pm,Minnesota Timberwolves,114
Wed Mar 16 2016,0,Sacramento Kings,-15,108,10:00 pm,New Orleans Pelicans,123
Wed Mar 16 2016,1,Washington Wizards,21,117,7:00 pm,Chicago Bulls,96
Thu Mar 17 2016,1,Atlanta Hawks,18,116,8:00 pm,Denver Nuggets,98
Thu Mar 17 2016,1,Chicago Bulls,16,118,8:00 pm,Brooklyn Nets,102
Thu Mar 17 2016,0,Indiana Pacers,-7,94,7:00 pm,Toronto Raptors,101
Thu Mar 17 2016,0,Miami Heat,-3,106,7:30 pm,Charlotte Hornets,109
Thu Mar 17 2016,1,Milwaukee Bucks,10,96,8:00 pm,Memphis Grizzlies,86
Thu Mar 17 2016,0,Philadelphia 76ers,-5,94,7:00 pm,Washington Wizards,99
Thu Mar 17 2016,1,San Antonio Spurs,8,118,8:30 pm,Portland Trail Blazers,110
Thu Mar 17 2016,1,Utah Jazz,34,103,9:00 pm,Phoenix Suns,69
Fri Mar 18 2016,0,Dallas Mavericks,-18,112,8:30 pm,Golden State Warriors,130
Fri Mar 18 2016,1,Detroit Pistons,7,115,7:30 pm,Sacramento Kings,108
Fri Mar 18 2016,1,Houston Rockets,5,116,8:00 pm,Minnesota Timberwolves,111
Fri Mar 18 2016,0,Los Angeles Lakers,-5,90,10:30 pm,Phoenix Suns,95
Fri Mar 18 2016,0,New Orleans Pelicans,-5,112,8:00 pm,Portland Trail Blazers,117
Fri Mar 18 2016,0,Orlando Magic,-6,103,7:00 pm,Cleveland Cavaliers,109
Fri Mar 18 2016,0,Philadelphia 76ers,-14,97,7:00 pm,Oklahoma City Thunder,111
Fri Mar 18 2016,1,Toronto Raptors,14,105,7:30 pm,Boston Celtics,91
Sat Mar 19 2016,1,Atlanta Hawks,12,109,7:30 pm,Houston Rockets,97
Sat Mar 19 2016,1,Chicago Bulls,7,92,8:00 pm,Utah Jazz,85
Sat Mar 19 2016,0,Charlotte Hornets,-8,93,6:00 pm,Denver Nuggets,101
Sat Mar 19 2016,1,Detroit Pistons,12,115,7:00 pm,Brooklyn Nets,103
Sat Mar 19 2016,0,Indiana Pacers,-4,111,7:00 pm,Oklahoma City Thunder,115
Sat Mar 19 2016,1,Memphis Grizzlies,11,113,8:00 pm,Los Angeles Clippers,102
Sat Mar 19 2016,1,Miami Heat,21,122,7:30 pm,Cleveland Cavaliers,101
Sat Mar 19 2016,1,San Antonio Spurs,8,87,8:30 pm,Golden State Warriors,79
Sat Mar 19 2016,1,Washington Wizards,10,99,7:00 pm,New York Knicks,89
Sun Mar 20 2016,1,Dallas Mavericks,12,132,4:00 pm,Portland Trail Blazers,120
Sun Mar 20 2016,0,Milwaukee Bucks,-9,85,7:00 pm,Utah Jazz,94
Sun Mar 20 2016,1,New Orleans Pelicans,4,109,6:00 pm,Los Angeles Clippers,105
Sun Mar 20 2016,0,New York Knicks,-8,80,7:30 pm,Sacramento Kings,88
Sun Mar 20 2016,0,Philadelphia 76ers,-15,105,6:00 pm,Boston Celtics,120
Sun Mar 20 2016,1,Toronto Raptors,5,105,4:30 pm,Orlando Magic,100
Mon Mar 21 2016,0,Atlanta Hawks,-15,102,8:00 pm,Washington Wizards,117
Mon Mar 21 2016,1,Boston Celtics,11,107,7:30 pm,Orlando Magic,96
Mon Mar 21 2016,1,Chicago Bulls,7,109,8:00 pm,Sacramento Kings,102
Mon Mar 21 2016,1,Charlotte Hornets,3,91,7:00 pm,San Antonio Spurs,88
Mon Mar 21 2016,1,Cleveland Cavaliers,33,124,7:00 pm,Denver Nuggets,91
Mon Mar 21 2016,1,Detroit Pistons,1,92,7:30 pm,Milwaukee Bucks,91
Mon Mar 21 2016,1,Indiana Pacers,16,91,7:00 pm,Philadelphia 76ers,75
Mon Mar 21 2016,0,Minnesota Timberwolves,-5,104,8:00 pm,Golden State Warriors,109
Mon Mar 21 2016,0,Phoenix Suns,-6,97,10:00 pm,Memphis Grizzlies,103
Tue Mar 22 2016,0,Brooklyn Nets,-5,100,7:30 pm,Charlotte Hornets,105
Tue Mar 22 2016,1,Los Angeles Lakers,7,107,10:30 pm,Memphis Grizzlies,100
Tue Mar 22 2016,0,New Orleans Pelicans,-14,99,8:00 pm,Miami Heat,113
Tue Mar 22 2016,1,Oklahoma City Thunder,4,111,8:00 pm,Houston Rockets,107
Wed Mar 23 2016,1,Boston Celtics,12,91,7:30 pm,Toronto Raptors,79
Wed Mar 23 2016,0,Chicago Bulls,-8,107,8:00 pm,New York Knicks,115
Wed Mar 23 2016,1,Cleveland Cavaliers,9,113,7:00 pm,Milwaukee Bucks,104
Wed Mar 23 2016,1,Denver Nuggets,1,104,9:00 pm,Philadelphia 76ers,103
Wed Mar 23 2016,1,Detroit Pistons,16,118,7:30 pm,Orlando Magic,102
Wed Mar 23 2016,1,Golden State Warriors,16,114,10:30 pm,Los Angeles Clippers,98
Wed Mar 23 2016,0,Houston Rockets,-2,87,8:00 pm,Utah Jazz,89
Wed Mar 23 2016,1,Minnesota Timberwolves,9,113,8:00 pm,Sacramento Kings,104
Wed Mar 23 2016,1,Phoenix Suns,12,119,10:00 pm,Los Angeles Lakers,107
Wed Mar 23 2016,1,Portland Trail Blazers,6,109,10:00 pm,Dallas Mavericks,103
Wed Mar 23 2016,1,San Antonio Spurs,24,112,8:30 pm,Miami Heat,88
Wed Mar 23 2016,0,Washington Wizards,-21,101,7:00 pm,Atlanta Hawks,122
Thu Mar 24 2016,1,Brooklyn Nets,9,104,7:30 pm,Cleveland Cavaliers,95
Thu Mar 24 2016,1,Indiana Pacers,8,92,7:00 pm,New Orleans Pelicans,84
Thu Mar 24 2016,1,Los Angeles Clippers,2,96,10:30 pm,Portland Trail Blazers,94
Thu Mar 24 2016,1,New York Knicks,12,106,7:30 pm,Chicago Bulls,94
Thu Mar 24 2016,1,Oklahoma City Thunder,22,113,8:00 pm,Utah Jazz,91
Fri Mar 25 2016,1,Atlanta Hawks,11,101,8:00 pm,Milwaukee Bucks,90
Fri Mar 25 2016,1,Detroit Pistons,7,112,7:30 pm,Charlotte Hornets,105
Fri Mar 25 2016,1,Golden State Warriors,8,128,10:30 pm,Dallas Mavericks,120
Fri Mar 25 2016,1,Houston Rockets,3,112,8:00 pm,Toronto Raptors,109
Fri Mar 25 2016,0,Los Angeles Lakers,-11,105,10:30 pm,Denver Nuggets,116
Fri Mar 25 2016,1,Miami Heat,11,108,8:00 pm,Orlando Magic,97
Fri Mar 25 2016,1,Sacramento Kings,22,116,10:00 pm,Phoenix Suns,94
Fri Mar 25 2016,1,San Antonio Spurs,6,110,8:30 pm,Memphis Grizzlies,104
Fri Mar 25 2016,0,Washington Wizards,-3,129,7:00 pm,Minnesota Timberwolves,132
Sat Mar 26 2016,1,Brooklyn Nets,10,120,6:00 pm,Indiana Pacers,110
Sat Mar 26 2016,0,Detroit Pistons,-17,95,7:30 pm,Atlanta Hawks,112
Sat Mar 26 2016,0,Milwaukee Bucks,-24,91,8:30 pm,Charlotte Hornets,115
Sat Mar 26 2016,0,Minnesota Timberwolves,-9,84,8:00 pm,Utah Jazz,93
Sat Mar 26 2016,0,New Orleans Pelicans,-24,91,7:00 pm,Toronto Raptors,115
Sat Mar 26 2016,0,New York Knicks,-14,93,7:30 pm,Cleveland Cavaliers,107
Sat Mar 26 2016,1,Oklahoma City Thunder,19,111,8:00 pm,San Antonio Spurs,92
Sat Mar 26 2016,1,Orlando Magic,22,111,7:00 pm,Chicago Bulls,89
Sat Mar 26 2016,0,Phoenix Suns,-3,99,10:00 pm,Boston Celtics,102
Sat Mar 26 2016,1,Portland Trail Blazers,3,108,10:00 pm,Philadelphia 76ers,105
Sun Mar 27 2016,1,Golden State Warriors,12,117,8:00 pm,Philadelphia 76ers,105
Sun Mar 27 2016,1,Indiana Pacers,3,104,6:00 pm,Houston Rockets,101
Sun Mar 27 2016,1,Los Angeles Clippers,15,105,3:30 pm,Denver Nuggets,90
Sun Mar 27 2016,0,Los Angeles Lakers,-13,88,9:30 pm,Washington Wizards,101
Sun Mar 27 2016,1,Sacramento Kings,22,133,6:00 pm,Dallas Mavericks,111
Mon Mar 28 2016,0,Chicago Bulls,-2,100,8:00 pm,Atlanta Hawks,102
Mon Mar 28 2016,0,Denver Nuggets,-9,88,9:00 pm,Dallas Mavericks,97
Mon Mar 28 2016,1,Los Angeles Clippers,24,114,10:30 pm,Boston Celtics,90
Mon Mar 28 2016,0,Memphis Grizzlies,-14,87,8:00 pm,San Antonio Spurs,101
Mon Mar 28 2016,1,Miami Heat,11,110,7:30 pm,Brooklyn Nets,99
Mon Mar 28 2016,1,Minnesota Timberwolves,5,121,8:00 pm,Phoenix Suns,116
Mon Mar 28 2016,1,New Orleans Pelicans,8,99,8:00 pm,New York Knicks,91
Mon Mar 28 2016,1,Portland Trail Blazers,12,105,10:00 pm,Sacramento Kings,93
Mon Mar 28 2016,0,Toronto Raptors,-19,100,7:30 pm,Oklahoma City Thunder,119
Mon Mar 28 2016,1,Utah Jazz,48,123,9:00 pm,Los Angeles Lakers,75
Tue Mar 29 2016,0,Cleveland Cavaliers,-6,100,8:00 pm,Houston Rockets,106
Tue Mar 29 2016,1,Detroit Pistons,6,88,7:30 pm,Oklahoma City Thunder,82
Tue Mar 29 2016,1,Golden State Warriors,8,102,10:30 pm,Washington Wizards,94
Tue Mar 29 2016,0,Indiana Pacers,-2,96,7:00 pm,Chicago Bulls,98
Tue Mar 29 2016,1,Orlando Magic,34,139,7:00 pm,Brooklyn Nets,105
Tue Mar 29 2016,0,Philadelphia 76ers,-15,85,7:00 pm,Charlotte Hornets,100
Wed Mar 30 2016,1,Dallas Mavericks,2,91,8:30 pm,New York Knicks,89
Wed Mar 30 2016,1,Los Angeles Lakers,2,102,10:30 pm,Miami Heat,100
Wed Mar 30 2016,0,Memphis Grizzlies,-4,105,8:00 pm,Denver Nuggets,109
Wed Mar 30 2016,1,Milwaukee Bucks,11,105,8:00 pm,Phoenix Suns,94
Wed Mar 30 2016,0,Minnesota Timberwolves,-20,79,8:00 pm,Los Angeles Clippers,99
Wed Mar 30 2016,1,Sacramento Kings,9,120,10:00 pm,Washington Wizards,111
Wed Mar 30 2016,1,San Antonio Spurs,8,100,8:30 pm,New Orleans Pelicans,92
Wed Mar 30 2016,1,Toronto Raptors,8,105,7:30 pm,Atlanta Hawks,97
Wed Mar 30 2016,0,Utah Jazz,-7,96,9:00 pm,Golden State Warriors,103
Thu Mar 31 2016,1,Cleveland Cavaliers,20,107,7:00 pm,Brooklyn Nets,87
Thu Mar 31 2016,0,Houston Rockets,-3,100,7:00 pm,Chicago Bulls,103
Thu Mar 31 2016,0,Indiana Pacers,-20,94,7:00 pm,Orlando Magic,114
Thu Mar 31 2016,1,New Orleans Pelicans,6,101,8:00 pm,Denver Nuggets,95
Thu Mar 31 2016,1,Oklahoma City Thunder,2,119,9:30 pm,Los Angeles Clippers,117
Thu Mar 31 2016,1,Portland Trail Blazers,7,116,10:00 pm,Boston Celtics,109
Tue Oct 28 2014,0,Los Angeles Lakers,-18,90,10:30 pm,Houston Rockets,108
Tue Oct 28 2014,1,New Orleans Pelicans,17,101,8:00 pm,Orlando Magic,84
Tue Oct 28 2014,1,San Antonio Spurs,1,101,8:00 pm,Dallas Mavericks,100
Wed Oct 29 2014,1,Boston Celtics,16,121,7:30 pm,Brooklyn Nets,105
Wed Oct 29 2014,1,Charlotte Hornets,2,108,7:00 pm,Milwaukee Bucks,106
Wed Oct 29 2014,1,Denver Nuggets,10,89,9:00 pm,Detroit Pistons,79
Wed Oct 29 2014,1,Indiana Pacers,12,103,7:00 pm,Philadelphia 76ers,91
Wed Oct 29 2014,1,Memphis Grizzlies,4,105,8:00 pm,Minnesota Timberwolves,101
Wed Oct 29 2014,1,Miami Heat,12,107,7:30 pm,Washington Wizards,95
Wed Oct 29 2014,0,New York Knicks,-24,80,8:00 pm,Chicago Bulls,104
Wed Oct 29 2014,1,Phoenix Suns,20,119,10:00 pm,Los Angeles Lakers,99
Wed Oct 29 2014,1,Portland Trail Blazers,17,106,10:30 pm,Oklahoma City Thunder,89
Wed Oct 29 2014,0,Sacramento Kings,-18,77,10:00 pm,Golden State Warriors,95
Wed Oct 29 2014,1,Toronto Raptors,7,109,7:30 pm,Atlanta Hawks,102
Wed Oct 29 2014,0,Utah Jazz,-11,93,9:00 pm,Houston Rockets,104
Thu Oct 30 2014,0,Cleveland Cavaliers,-5,90,8:00 pm,New York Knicks,95
Thu Oct 30 2014,1,Dallas Mavericks,18,120,8:30 pm,Utah Jazz,102
Thu Oct 30 2014,1,Los Angeles Clippers,3,93,10:30 pm,Oklahoma City Thunder,90
Thu Oct 30 2014,1,Minnesota Timberwolves,6,97,8:00 pm,Detroit Pistons,91
Thu Oct 30 2014,0,Orlando Magic,-7,98,7:00 pm,Washington Wizards,105
Fri Oct 31 2014,0,Chicago Bulls,-6,108,8:00 pm,Cleveland Cavaliers,114
Fri Oct 31 2014,0,Indiana Pacers,-8,89,7:00 pm,Memphis Grizzlies,97
Fri Oct 31 2014,0,Los Angeles Lakers,-7,111,10:30 pm,Los Angeles Clippers,118
Fri Oct 31 2014,1,Milwaukee Bucks,12,93,8:30 pm,Philadelphia 76ers,81
Fri Oct 31 2014,1,Phoenix Suns,5,94,10:00 pm,San Antonio Spurs,89
Fri Oct 31 2014,1,Sacramento Kings,9,103,10:00 pm,Portland Trail Blazers,94
Sat Nov 1 2014,1,Atlanta Hawks,10,102,7:30 pm,Indiana Pacers,92
Sat Nov 1 2014,0,Charlotte Hornets,-2,69,7:00 pm,Memphis Grizzlies,71
Sat Nov 1 2014,0,Detroit Pistons,-12,90,7:30 pm,Brooklyn Nets,102
Sat Nov 1 2014,1,Golden State Warriors,23,127,10:30 pm,Los Angeles Lakers,104
Sat Nov 1 2014,1,Houston Rockets,14,104,8:00 pm,Boston Celtics,90
Sat Nov 1 2014,0,Minnesota Timberwolves,-1,105,8:00 pm,Chicago Bulls,106
Sat Nov 1 2014,0,New Orleans Pelicans,-5,104,7:00 pm,Dallas Mavericks,109
Sat Nov 1 2014,1,Oklahoma City Thunder,11,102,8:00 pm,Denver Nuggets,91
Sat Nov 1 2014,0,Orlando Magic,-13,95,7:00 pm,Toronto Raptors,108
Sat Nov 1 2014,0,Philadelphia 76ers,-18,96,7:00 pm,Miami Heat,114
Sat Nov 1 2014,1,Utah Jazz,27,118,9:00 pm,Phoenix Suns,91
Sat Nov 1 2014,1,Washington Wizards,11,108,7:00 pm,Milwaukee Bucks,97
Sun Nov 2 2014,0,Los Angeles Clippers,-6,92,3:30 pm,Sacramento Kings,98
Sun Nov 2 2014,1,Miami Heat,5,107,6:00 pm,Toronto Raptors,102
Sun Nov 2 2014,1,New York Knicks,3,96,7:30 pm,Charlotte Hornets,93
Sun Nov 2 2014,0,Portland Trail Blazers,-5,90,9:00 pm,Golden State Warriors,95
Mon Nov 3 2014,1,Brooklyn Nets,31,116,7:30 pm,Oklahoma City Thunder,85
Mon Nov 3 2014,1,Dallas Mavericks,5,118,8:30 pm,Boston Celtics,113
Mon Nov 3 2014,0,Denver Nuggets,-5,105,9:00 pm,Sacramento Kings,110
Mon Nov 3 2014,1,Los Angeles Clippers,6,107,10:30 pm,Utah Jazz,101
Mon Nov 3 2014,1,Memphis Grizzlies,12,93,8:00 pm,New Orleans Pelicans,81
Mon Nov 3 2014,0,Philadelphia 76ers,-11,93,7:00 pm,Houston Rockets,104
Tue Nov 4 2014,1,Chicago Bulls,8,98,8:00 pm,Orlando Magic,90
Tue Nov 4 2014,0,Indiana Pacers,-6,81,7:00 pm,Milwaukee Bucks,87
Tue Nov 4 2014,0,Los Angeles Lakers,-6,106,10:30 pm,Phoenix Suns,112
Tue Nov 4 2014,0,Miami Heat,-17,91,7:30 pm,Houston Rockets,108
Tue Nov 4 2014,1,New Orleans Pelicans,9,100,8:00 pm,Charlotte Hornets,91
Tue Nov 4 2014,0,New York Knicks,-15,83,7:30 pm,Washington Wizards,98
Tue Nov 4 2014,1,Portland Trail Blazers,19,101,10:00 pm,Cleveland Cavaliers,82
Tue Nov 4 2014,1,Toronto Raptors,12,100,7:30 pm,Oklahoma City Thunder,88
Wed Nov 5 2014,0,Boston Celtics,-3,107,7:30 pm,Toronto Raptors,110
Wed Nov 5 2014,0,Brooklyn Nets,-7,91,7:30 pm,Minnesota Timberwolves,98
Wed Nov 5 2014,1,Charlotte Hornets,7,96,7:00 pm,Miami Heat,89
Wed Nov 5 2014,1,Detroit Pistons,3,98,7:30 pm,New York Knicks,95
Wed Nov 5 2014,1,Golden State Warriors,17,121,10:30 pm,Los Angeles Clippers,104
Wed Nov 5 2014,0,Milwaukee Bucks,-9,86,8:00 pm,Chicago Bulls,95
Wed Nov 5 2014,0,Philadelphia 76ers,-2,89,7:00 pm,Orlando Magic,91
Wed Nov 5 2014,0,Phoenix Suns,-11,91,9:00 pm,Memphis Grizzlies,102
Wed Nov 5 2014,1,Sacramento Kings,22,131,10:00 pm,Denver Nuggets,109
Wed Nov 5 2014,1,San Antonio Spurs,2,94,8:30 pm,Atlanta Hawks,92
Wed Nov 5 2014,1,Utah Jazz,2,102,9:00 pm,Cleveland Cavaliers,100
Wed Nov 5 2014,1,Washington Wizards,2,96,8:00 pm,Indiana Pacers,94
Thu Nov 6 2014,1,Houston Rockets,17,98,8:00 pm,San Antonio Spurs,81
Thu Nov 6 2014,1,Portland Trail Blazers,21,108,10:30 pm,Dallas Mavericks,87
Fri Nov 7 2014,1,Boston Celtics,3,101,7:30 pm,Indiana Pacers,98
Fri Nov 7 2014,1,Brooklyn Nets,11,110,7:30 pm,New York Knicks,99
Fri Nov 7 2014,1,Charlotte Hornets,3,122,7:00 pm,Atlanta Hawks,119
Fri Nov 7 2014,0,Denver Nuggets,-9,101,10:30 pm,Cleveland Cavaliers,110
Fri Nov 7 2014,1,Detroit Pistons,3,98,7:30 pm,Milwaukee Bucks,95
Fri Nov 7 2014,0,Oklahoma City Thunder,-2,89,8:00 pm,Memphis Grizzlies,91
Fri Nov 7 2014,1,Orlando Magic,9,112,7:00 pm,Minnesota Timberwolves,103
Fri Nov 7 2014,0,Philadelphia 76ers,-3,115,7:00 pm,Chicago Bulls,118
Fri Nov 7 2014,0,Phoenix Suns,-2,112,9:00 pm,Sacramento Kings,114
Fri Nov 7 2014,1,Toronto Raptors,19,103,7:30 pm,Washington Wizards,84
Fri Nov 7 2014,0,Utah Jazz,-23,82,9:00 pm,Dallas Mavericks,105
Sat Nov 8 2014,1,Atlanta Hawks,7,103,7:30 pm,New York Knicks,96
Sat Nov 8 2014,0,Chicago Bulls,-5,101,8:00 pm,Boston Celtics,106
Sat Nov 8 2014,0,Houston Rockets,-11,87,8:00 pm,Golden State Warriors,98
Sat Nov 8 2014,0,Indiana Pacers,-7,90,7:00 pm,Washington Wizards,97
Sat Nov 8 2014,1,Los Angeles Clippers,4,106,3:30 pm,Portland Trail Blazers,102
Sat Nov 8 2014,1,Miami Heat,10,102,7:30 pm,Minnesota Timberwolves,92
Sat Nov 8 2014,1,Milwaukee Bucks,1,93,8:30 pm,Memphis Grizzlies,92
Sat Nov 8 2014,0,San Antonio Spurs,-1,99,8:30 pm,New Orleans Pelicans,100
Sun Nov 9 2014,1,Brooklyn Nets,8,104,3:30 pm,Orlando Magic,96
Sun Nov 9 2014,0,Dallas Mavericks,-9,96,7:30 pm,Miami Heat,105
Sun Nov 9 2014,0,Detroit Pistons,-1,96,6:00 pm,Utah Jazz,97
Sun Nov 9 2014,1,Los Angeles Lakers,15,107,9:30 pm,Charlotte Hornets,92
Sun Nov 9 2014,1,Oklahoma City Thunder,8,101,7:00 pm,Sacramento Kings,93
Sun Nov 9 2014,1,Phoenix Suns,12,107,8:00 pm,Golden State Warriors,95
Sun Nov 9 2014,1,Portland Trail Blazers,16,116,9:00 pm,Denver Nuggets,100
Sun Nov 9 2014,1,Toronto Raptors,32,120,7:00 pm,Philadelphia 76ers,88
Mon Nov 10 2014,1,Chicago Bulls,11,102,8:00 pm,Detroit Pistons,91
Mon Nov 10 2014,1,Cleveland Cavaliers,7,118,7:00 pm,New Orleans Pelicans,111
Mon Nov 10 2014,1,Indiana Pacers,11,97,7:00 pm,Utah Jazz,86
Mon Nov 10 2014,0,Los Angeles Clippers,-4,85,10:30 pm,San Antonio Spurs,89
Mon Nov 10 2014,0,New York Knicks,-6,85,7:30 pm,Atlanta Hawks,91
Tue Nov 11 2014,1,Dallas Mavericks,8,106,8:30 pm,Sacramento Kings,98
Tue Nov 11 2014,0,Golden State Warriors,-13,100,10:30 pm,San Antonio Spurs,113
Tue Nov 11 2014,1,Memphis Grizzlies,5,107,8:00 pm,Los Angeles Lakers,102
Tue Nov 11 2014,1,Milwaukee Bucks,7,85,8:00 pm,Oklahoma City Thunder,78
Tue Nov 11 2014,1,Portland Trail Blazers,2,102,10:00 pm,Charlotte Hornets,100
Tue Nov 11 2014,1,Toronto Raptors,4,104,7:30 pm,Orlando Magic,100
Wed Nov 12 2014,1,Atlanta Hawks,3,100,7:30 pm,Utah Jazz,97
Wed Nov 12 2014,0,Boston Celtics,-15,94,7:30 pm,Oklahoma City Thunder,109
Wed Nov 12 2014,0,Denver Nuggets,-17,113,9:00 pm,Portland Trail Blazers,130
Wed Nov 12 2014,0,Miami Heat,-6,75,7:30 pm,Indiana Pacers,81
Wed Nov 12 2014,0,Minnesota Timberwolves,-12,101,10:00 pm,Houston Rockets,113
Wed Nov 12 2014,1,New Orleans Pelicans,7,109,8:00 pm,Los Angeles Lakers,102
Wed Nov 12 2014,0,New York Knicks,-2,95,7:30 pm,Orlando Magic,97
Wed Nov 12 2014,1,Phoenix Suns,8,112,9:00 pm,Brooklyn Nets,104
Wed Nov 12 2014,1,Washington Wizards,4,107,7:00 pm,Detroit Pistons,103
Thu Nov 13 2014,1,Dallas Mavericks,53,123,8:30 pm,Philadelphia 76ers,70
Thu Nov 13 2014,1,Golden State Warriors,8,107,10:30 pm,Brooklyn Nets,99
Thu Nov 13 2014,1,Memphis Grizzlies,1,111,8:00 pm,Sacramento Kings,110
Thu Nov 13 2014,0,Toronto Raptors,-7,93,8:00 pm,Chicago Bulls,100
Fri Nov 14 2014,1,Atlanta Hawks,11,114,7:30 pm,Miami Heat,103
Fri Nov 14 2014,0,Boston Celtics,-1,121,7:30 pm,Cleveland Cavaliers,122
Fri Nov 14 2014,1,Houston Rockets,1,88,8:00 pm,Philadelphia 76ers,87
Fri Nov 14 2014,0,Indiana Pacers,-21,87,7:00 pm,Denver Nuggets,108
Fri Nov 14 2014,0,Los Angeles Lakers,-13,80,10:00 pm,San Antonio Spurs,93
Fri Nov 14 2014,1,New Orleans Pelicans,48,139,8:00 pm,Minnesota Timberwolves,91
Fri Nov 14 2014,0,New York Knicks,-2,100,7:30 pm,Utah Jazz,102
Fri Nov 14 2014,0,Oklahoma City Thunder,-7,89,8:00 pm,Detroit Pistons,96
Fri Nov 14 2014,1,Orlando Magic,16,101,7:00 pm,Milwaukee Bucks,85
Fri Nov 14 2014,0,Phoenix Suns,-8,95,9:00 pm,Charlotte Hornets,103
Sat Nov 15 2014,0,Chicago Bulls,-9,90,8:00 pm,Indiana Pacers,99
Sat Nov 15 2014,1,Cleveland Cavaliers,33,127,7:30 pm,Atlanta Hawks,94
Sat Nov 15 2014,1,Dallas Mavericks,14,131,8:30 pm,Minnesota Timberwolves,117
Sat Nov 15 2014,1,Golden State Warriors,25,112,10:30 pm,Charlotte Hornets,87
Sat Nov 15 2014,1,Los Angeles Clippers,13,120,10:30 pm,Phoenix Suns,107
Sat Nov 15 2014,1,Memphis Grizzlies,7,95,8:00 pm,Detroit Pistons,88
Sat Nov 15 2014,1,Portland Trail Blazers,10,97,10:00 pm,Brooklyn Nets,87
Sat Nov 15 2014,1,Sacramento Kings,3,94,10:00 pm,San Antonio Spurs,91
Sat Nov 15 2014,1,Toronto Raptors,18,111,7:30 pm,Utah Jazz,93
Sat Nov 15 2014,1,Washington Wizards,5,98,7:00 pm,Orlando Magic,93
Sun Nov 16 2014,0,Los Angeles Lakers,-21,115,9:30 pm,Golden State Warriors,136
Sun Nov 16 2014,0,Miami Heat,-7,84,6:00 pm,Milwaukee Bucks,91
Sun Nov 16 2014,1,New York Knicks,16,109,1:00 pm,Denver Nuggets,93
Sun Nov 16 2014,0,Oklahoma City Thunder,-4,65,7:00 pm,Houston Rockets,69
Mon Nov 17 2014,0,Boston Celtics,-4,114,7:30 pm,Phoenix Suns,118
Mon Nov 17 2014,0,Brooklyn Nets,-12,83,7:30 pm,Miami Heat,95
Mon Nov 17 2014,0,Charlotte Hornets,-27,80,7:00 pm,Dallas Mavericks,107
Mon Nov 17 2014,0,Cleveland Cavaliers,-9,97,7:00 pm,Denver Nuggets,106
Mon Nov 17 2014,0,Detroit Pistons,-14,93,7:30 pm,Orlando Magic,107
Mon Nov 17 2014,0,Los Angeles Clippers,-16,89,10:30 pm,Chicago Bulls,105
Mon Nov 17 2014,1,Memphis Grizzlies,26,119,8:00 pm,Houston Rockets,93
Mon Nov 17 2014,1,Portland Trail Blazers,9,102,10:00 pm,New Orleans Pelicans,93
Mon Nov 17 2014,1,San Antonio Spurs,25,100,8:30 pm,Philadelphia 76ers,75
Tue Nov 18 2014,0,Atlanta Hawks,-5,109,7:30 pm,Los Angeles Lakers,114
Tue Nov 18 2014,1,Milwaukee Bucks,4,117,8:00 pm,New York Knicks,113
Tue Nov 18 2014,0,Sacramento Kings,-6,100,10:00 pm,New Orleans Pelicans,106
Tue Nov 18 2014,1,Utah Jazz,17,98,9:00 pm,Oklahoma City Thunder,81
Wed Nov 19 2014,0,Brooklyn Nets,-4,118,7:30 pm,Milwaukee Bucks,122
Wed Nov 19 2014,0,Cleveland Cavaliers,-2,90,7:00 pm,San Antonio Spurs,92
Wed Nov 19 2014,1,Denver Nuggets,7,107,9:00 pm,Oklahoma City Thunder,100
Wed Nov 19 2014,0,Detroit Pistons,-2,86,7:30 pm,Phoenix Suns,88
Wed Nov 19 2014,0,Houston Rockets,-6,92,9:30 pm,Los Angeles Lakers,98
Wed Nov 19 2014,1,Indiana Pacers,2,88,7:00 pm,Charlotte Hornets,86
Wed Nov 19 2014,1,Minnesota Timberwolves,16,115,8:00 pm,New York Knicks,99
Wed Nov 19 2014,0,Orlando Magic,-24,90,7:00 pm,Los Angeles Clippers,114
Wed Nov 19 2014,0,Philadelphia 76ers,-11,90,7:00 pm,Boston Celtics,101
Wed Nov 19 2014,1,Toronto Raptors,4,96,7:30 pm,Memphis Grizzlies,92
Wed Nov 19 2014,0,Washington Wizards,-3,102,7:00 pm,Dallas Mavericks,105
Thu Nov 20 2014,0,Miami Heat,-17,93,8:00 pm,Los Angeles Clippers,110
Thu Nov 20 2014,1,Sacramento Kings,15,103,10:30 pm,Chicago Bulls,88
Fri Nov 21 2014,1,Atlanta Hawks,10,99,7:30 pm,Detroit Pistons,89
Fri Nov 21 2014,0,Charlotte Hornets,-5,100,7:00 pm,Orlando Magic,105
Fri Nov 21 2014,1,Dallas Mavericks,34,140,8:30 pm,Los Angeles Lakers,106
Fri Nov 21 2014,1,Denver Nuggets,20,117,9:00 pm,New Orleans Pelicans,97
Fri Nov 21 2014,1,Golden State Warriors,13,101,10:30 pm,Utah Jazz,88
Fri Nov 21 2014,1,Memphis Grizzlies,17,117,8:00 pm,Boston Celtics,100
Fri Nov 21 2014,0,Minnesota Timberwolves,-29,92,8:00 pm,San Antonio Spurs,121
Fri Nov 21 2014,0,Oklahoma City Thunder,-2,92,8:00 pm,Brooklyn Nets,94
Fri Nov 21 2014,0,Philadelphia 76ers,-26,96,7:00 pm,Phoenix Suns,122
Fri Nov 21 2014,1,Portland Trail Blazers,18,105,10:30 pm,Chicago Bulls,87
Fri Nov 21 2014,1,Toronto Raptors,42,124,7:30 pm,Milwaukee Bucks,82
Fri Nov 21 2014,1,Washington Wizards,13,91,8:00 pm,Cleveland Cavaliers,78
Sat Nov 22 2014,0,Cleveland Cavaliers,-17,93,7:30 pm,Toronto Raptors,110
Sat Nov 22 2014,1,Houston Rockets,3,95,8:00 pm,Dallas Mavericks,92
Sat Nov 22 2014,0,Indiana Pacers,-23,83,7:00 pm,Phoenix Suns,106
Sat Nov 22 2014,0,Milwaukee Bucks,-11,100,8:30 pm,Washington Wizards,111
Sat Nov 22 2014,0,Minnesota Timberwolves,-12,101,8:00 pm,Sacramento Kings,113
Sat Nov 22 2014,1,New York Knicks,8,91,7:30 pm,Philadelphia 76ers,83
Sat Nov 22 2014,0,Orlando Magic,-7,92,7:00 pm,Miami Heat,99
Sat Nov 22 2014,1,San Antonio Spurs,12,99,8:30 pm,Brooklyn Nets,87
Sat Nov 22 2014,0,Utah Jazz,-12,94,9:00 pm,New Orleans Pelicans,106
Sun Nov 23 2014,0,Boston Celtics,-6,88,6:00 pm,Portland Trail Blazers,94
Sun Nov 23 2014,0,Los Angeles Lakers,-7,94,9:30 pm,Denver Nuggets,101
Sun Nov 23 2014,1,Memphis Grizzlies,16,107,6:00 pm,Los Angeles Clippers,91
Sun Nov 23 2014,1,Miami Heat,1,94,6:00 pm,Charlotte Hornets,93
Sun Nov 23 2014,0,Oklahoma City Thunder,-5,86,7:00 pm,Golden State Warriors,91
Mon Nov 24 2014,0,Charlotte Hornets,-21,92,7:00 pm,Los Angeles Clippers,113
Mon Nov 24 2014,1,Cleveland Cavaliers,32,106,7:00 pm,Orlando Magic,74
Mon Nov 24 2014,0,Dallas Mavericks,-11,100,8:30 pm,Indiana Pacers,111
Mon Nov 24 2014,1,Houston Rockets,5,91,8:00 pm,New York Knicks,86
Mon Nov 24 2014,0,Philadelphia 76ers,-10,104,7:00 pm,Portland Trail Blazers,114
Mon Nov 24 2014,1,Toronto Raptors,4,104,7:30 pm,Phoenix Suns,100
Mon Nov 24 2014,0,Utah Jazz,-2,95,9:00 pm,Chicago Bulls,97
Tue Nov 25 2014,1,Denver Nuggets,5,114,9:00 pm,Chicago Bulls,109
Tue Nov 25 2014,0,Miami Heat,-17,97,7:30 pm,Golden State Warriors,114
Tue Nov 25 2014,1,Milwaukee Bucks,12,98,8:00 pm,Detroit Pistons,86
Tue Nov 25 2014,0,New Orleans Pelicans,-10,89,8:00 pm,Sacramento Kings,99
Tue Nov 25 2014,0,Washington Wizards,-4,102,7:00 pm,Atlanta Hawks,106
Wed Nov 26 2014,0,Atlanta Hawks,-11,115,7:30 pm,Toronto Raptors,126
Wed Nov 26 2014,0,Charlotte Hornets,-8,97,7:00 pm,Portland Trail Blazers,105
Wed Nov 26 2014,1,Cleveland Cavaliers,26,113,7:00 pm,Washington Wizards,87
Wed Nov 26 2014,1,Dallas Mavericks,7,109,7:30 pm,New York Knicks,102
Wed Nov 26 2014,0,Detroit Pistons,-6,98,7:30 pm,Los Angeles Clippers,104
Wed Nov 26 2014,1,Houston Rockets,13,102,8:00 pm,Sacramento Kings,89
Wed Nov 26 2014,0,Los Angeles Lakers,-6,93,10:30 pm,Memphis Grizzlies,99
Wed Nov 26 2014,0,Minnesota Timberwolves,-17,86,8:00 pm,Milwaukee Bucks,103
Wed Nov 26 2014,1,Oklahoma City Thunder,15,97,8:00 pm,Utah Jazz,82
Wed Nov 26 2014,0,Orlando Magic,-15,96,7:00 pm,Golden State Warriors,111
Wed Nov 26 2014,0,Philadelphia 76ers,-8,91,7:00 pm,Brooklyn Nets,99
Wed Nov 26 2014,1,Phoenix Suns,8,120,9:00 pm,Denver Nuggets,112
Wed Nov 26 2014,1,San Antonio Spurs,6,106,8:30 pm,Indiana Pacers,100
Fri Nov 28 2014,1,Atlanta Hawks,9,100,7:30 pm,New Orleans Pelicans,91
Fri Nov 28 2014,0,Boston Celtics,-7,102,1:00 pm,Chicago Bulls,109
Fri Nov 28 2014,0,Charlotte Hornets,-5,101,7:00 pm,Golden State Warriors,106
Fri Nov 28 2014,1,Denver Nuggets,25,122,9:00 pm,Phoenix Suns,97
Fri Nov 28 2014,0,Detroit Pistons,-16,88,7:30 pm,Milwaukee Bucks,104
Fri Nov 28 2014,0,Houston Rockets,-17,85,8:00 pm,Los Angeles Clippers,102
Fri Nov 28 2014,1,Indiana Pacers,15,98,8:00 pm,Orlando Magic,83
Fri Nov 28 2014,0,Los Angeles Lakers,-1,119,10:30 pm,Minnesota Timberwolves,120
Fri Nov 28 2014,1,Oklahoma City Thunder,27,105,8:00 pm,New York Knicks,78
Fri Nov 28 2014,0,Portland Trail Blazers,-13,99,10:00 pm,Memphis Grizzlies,112
Fri Nov 28 2014,1,San Antonio Spurs,8,112,8:30 pm,Sacramento Kings,104
Fri Nov 28 2014,0,Toronto Raptors,-4,102,7:30 pm,Dallas Mavericks,106
Sat Nov 29 2014,1,Atlanta Hawks,30,105,7:30 pm,Charlotte Hornets,75
Sat Nov 29 2014,1,Cleveland Cavaliers,12,109,7:30 pm,Indiana Pacers,97
Sat Nov 29 2014,0,Milwaukee Bucks,-14,103,9:00 pm,Houston Rockets,117
Sat Nov 29 2014,0,Philadelphia 76ers,-7,103,7:00 pm,Dallas Mavericks,110
Sat Nov 29 2014,0,Utah Jazz,-16,96,9:00 pm,Los Angeles Clippers,112
Sat Nov 29 2014,1,Washington Wizards,3,83,7:00 pm,New Orleans Pelicans,80
Sun Nov 30 2014,0,Boston Celtics,-22,89,1:00 pm,San Antonio Spurs,111
Sun Nov 30 2014,0,Brooklyn Nets,-18,84,3:00 pm,Chicago Bulls,102
Sun Nov 30 2014,0,Detroit Pistons,-11,93,3:30 pm,Golden State Warriors,104
Sun Nov 30 2014,1,Los Angeles Lakers,7,129,9:30 pm,Toronto Raptors,122
Sun Nov 30 2014,0,New York Knicks,-7,79,7:30 pm,Miami Heat,86
Sun Nov 30 2014,0,Phoenix Suns,-3,90,8:00 pm,Orlando Magic,93
Sun Nov 30 2014,1,Portland Trail Blazers,14,107,9:00 pm,Minnesota Timberwolves,93
Sun Nov 30 2014,0,Sacramento Kings,-12,85,6:00 pm,Memphis Grizzlies,97
Mon Dec 1 2014,1,Los Angeles Clippers,26,127,10:30 pm,Minnesota Timberwolves,101
Mon Dec 1 2014,0,Philadelphia 76ers,-6,103,7:00 pm,San Antonio Spurs,109
Mon Dec 1 2014,0,Utah Jazz,-2,101,9:00 pm,Denver Nuggets,103
Mon Dec 1 2014,1,Washington Wizards,21,107,7:00 pm,Miami Heat,86
Tue Dec 2 2014,1,Atlanta Hawks,4,109,7:30 pm,Boston Celtics,105
Tue Dec 2 2014,0,Chicago Bulls,-3,129,8:00 pm,Dallas Mavericks,132
Tue Dec 2 2014,1,Cleveland Cavaliers,3,111,7:00 pm,Milwaukee Bucks,108
Tue Dec 2 2014,0,Denver Nuggets,-2,103,9:00 pm,Portland Trail Blazers,105
Tue Dec 2 2014,0,Detroit Pistons,-10,96,7:30 pm,Los Angeles Lakers,106
Tue Dec 2 2014,1,Golden State Warriors,1,98,10:30 pm,Orlando Magic,97
Tue Dec 2 2014,1,New Orleans Pelicans,8,112,8:00 pm,Oklahoma City Thunder,104
Tue Dec 2 2014,0,New York Knicks,-5,93,7:30 pm,Brooklyn Nets,98
Tue Dec 2 2014,1,Phoenix Suns,17,116,9:00 pm,Indiana Pacers,99
Tue Dec 2 2014,0,Sacramento Kings,-8,109,10:00 pm,Toronto Raptors,117
Wed Dec 3 2014,1,Boston Celtics,7,109,7:30 pm,Detroit Pistons,102
Wed Dec 3 2014,1,Brooklyn Nets,2,95,7:30 pm,San Antonio Spurs,93
Wed Dec 3 2014,0,Charlotte Hornets,-7,95,7:00 pm,Chicago Bulls,102
Wed Dec 3 2014,1,Houston Rockets,9,105,8:00 pm,Memphis Grizzlies,96
Wed Dec 3 2014,1,Los Angeles Clippers,28,114,10:30 pm,Orlando Magic,86
Wed Dec 3 2014,0,Miami Heat,-10,102,7:30 pm,Atlanta Hawks,112
Wed Dec 3 2014,0,Milwaukee Bucks,-2,105,8:00 pm,Dallas Mavericks,107
Wed Dec 3 2014,0,Minnesota Timberwolves,-8,77,8:00 pm,Philadelphia 76ers,85
Wed Dec 3 2014,0,Utah Jazz,-19,104,9:00 pm,Toronto Raptors,123
Wed Dec 3 2014,1,Washington Wizards,16,111,7:00 pm,Los Angeles Lakers,95
Thu Dec 4 2014,1,Golden State Warriors,27,112,10:30 pm,New Orleans Pelicans,85
Thu Dec 4 2014,0,New York Knicks,-3,87,8:00 pm,Cleveland Cavaliers,90
Thu Dec 4 2014,1,Portland Trail Blazers,6,88,10:00 pm,Indiana Pacers,82
Fri Dec 5 2014,1,Boston Celtics,17,113,7:30 pm,Los Angeles Lakers,96
Fri Dec 5 2014,0,Brooklyn Nets,-23,75,7:30 pm,Atlanta Hawks,98
Fri Dec 5 2014,1,Charlotte Hornets,1,103,7:00 pm,New York Knicks,102
Fri Dec 5 2014,0,Dallas Mavericks,-12,106,8:30 pm,Phoenix Suns,118
Fri Dec 5 2014,0,Memphis Grizzlies,-6,101,8:00 pm,San Antonio Spurs,107
Fri Dec 5 2014,1,Milwaukee Bucks,24,109,8:30 pm,Miami Heat,85
Fri Dec 5 2014,0,Minnesota Timberwolves,-2,112,8:00 pm,Houston Rockets,114
Fri Dec 5 2014,0,Philadelphia 76ers,-12,91,7:00 pm,Oklahoma City Thunder,103
Fri Dec 5 2014,1,Sacramento Kings,1,102,10:00 pm,Indiana Pacers,101
Fri Dec 5 2014,0,Toronto Raptors,-14,91,7:30 pm,Cleveland Cavaliers,105
Fri Dec 5 2014,0,Utah Jazz,-5,93,9:00 pm,Orlando Magic,98
Fri Dec 5 2014,1,Washington Wizards,30,119,7:00 pm,Denver Nuggets,89
Sat Dec 6 2014,0,Chicago Bulls,-10,102,8:00 pm,Golden State Warriors,112
Sat Dec 6 2014,0,Detroit Pistons,-7,101,7:30 pm,Philadelphia 76ers,108
Sat Dec 6 2014,1,Houston Rockets,5,100,8:00 pm,Phoenix Suns,95
Sat Dec 6 2014,1,Los Angeles Clippers,20,120,10:30 pm,New Orleans Pelicans,100
Sat Dec 6 2014,0,Sacramento Kings,-9,96,10:00 pm,Orlando Magic,105
Sat Dec 6 2014,1,San Antonio Spurs,22,123,8:30 pm,Minnesota Timberwolves,101
Sun Dec 7 2014,1,Atlanta Hawks,12,96,3:30 pm,Denver Nuggets,84
Sun Dec 7 2014,1,Boston Celtics,8,101,1:00 pm,Washington Wizards,93
Sun Dec 7 2014,1,Dallas Mavericks,23,125,7:30 pm,Milwaukee Bucks,102
Sun Dec 7 2014,0,Detroit Pistons,-2,94,6:00 pm,Oklahoma City Thunder,96
Sun Dec 7 2014,0,Los Angeles Lakers,-17,87,9:30 pm,New Orleans Pelicans,104
Sun Dec 7 2014,1,Memphis Grizzlies,16,103,6:00 pm,Miami Heat,87
Sun Dec 7 2014,0,New York Knicks,-4,99,7:30 pm,Portland Trail Blazers,103
Mon Dec 8 2014,0,Brooklyn Nets,-22,88,7:30 pm,Cleveland Cavaliers,110
Mon Dec 8 2014,0,Indiana Pacers,-16,92,7:00 pm,Atlanta Hawks,108
Mon Dec 8 2014,1,Los Angeles Clippers,1,121,10:30 pm,Phoenix Suns,120
Mon Dec 8 2014,0,Minnesota Timberwolves,-16,86,8:00 pm,Golden State Warriors,102
Mon Dec 8 2014,1,Sacramento Kings,9,101,10:00 pm,Utah Jazz,92
Mon Dec 8 2014,1,Toronto Raptors,5,112,7:30 pm,Denver Nuggets,107
Mon Dec 8 2014,1,Washington Wizards,1,133,7:00 pm,Boston Celtics,132
Tue Dec 9 2014,1,Cleveland Cavaliers,4,105,7:00 pm,Toronto Raptors,101
Tue Dec 9 2014,0,Detroit Pistons,-12,86,7:30 pm,Portland Trail Blazers,98
Tue Dec 9 2014,1,Los Angeles Lakers,3,98,10:30 pm,Sacramento Kings,95
Tue Dec 9 2014,1,Memphis Grizzlies,9,114,8:00 pm,Dallas Mavericks,105
Tue Dec 9 2014,1,New Orleans Pelicans,11,104,8:00 pm,New York Knicks,93
Tue Dec 9 2014,1,Oklahoma City Thunder,13,114,8:00 pm,Milwaukee Bucks,101
Tue Dec 9 2014,0,Phoenix Suns,-6,97,9:00 pm,Miami Heat,103
Tue Dec 9 2014,1,Utah Jazz,4,100,9:00 pm,San Antonio Spurs,96
Wed Dec 10 2014,1,Atlanta Hawks,16,95,7:30 pm,Philadelphia 76ers,79
Wed Dec 10 2014,1,Chicago Bulls,25,105,8:00 pm,Brooklyn Nets,80
Wed Dec 10 2014,1,Charlotte Hornets,9,96,7:00 pm,Boston Celtics,87
Wed Dec 10 2014,1,Dallas Mavericks,5,112,8:00 pm,New Orleans Pelicans,107
Wed Dec 10 2014,1,Denver Nuggets,20,102,10:30 pm,Miami Heat,82
Wed Dec 10 2014,1,Golden State Warriors,12,105,10:30 pm,Houston Rockets,93
Wed Dec 10 2014,0,Indiana Pacers,-7,96,7:00 pm,Los Angeles Clippers,103
Wed Dec 10 2014,1,Minnesota Timberwolves,8,90,8:00 pm,Portland Trail Blazers,82
Wed Dec 10 2014,0,Orlando Magic,-2,89,7:00 pm,Washington Wizards,91
Wed Dec 10 2014,1,San Antonio Spurs,14,109,8:30 pm,New York Knicks,95
Thu Dec 11 2014,1,Oklahoma City Thunder,9,103,8:00 pm,Cleveland Cavaliers,94
Thu Dec 11 2014,0,Sacramento Kings,-4,109,10:30 pm,Houston Rockets,113
Fri Dec 12 2014,1,Atlanta Hawks,6,87,7:30 pm,Orlando Magic,81
Fri Dec 12 2014,0,Boston Celtics,-6,95,7:30 pm,New York Knicks,101
Fri Dec 12 2014,1,Brooklyn Nets,18,88,7:30 pm,Philadelphia 76ers,70
Fri Dec 12 2014,1,Chicago Bulls,9,115,7:00 pm,Portland Trail Blazers,106
Fri Dec 12 2014,1,Memphis Grizzlies,6,113,8:00 pm,Charlotte Hornets,107
Fri Dec 12 2014,0,Minnesota Timberwolves,-19,92,8:00 pm,Oklahoma City Thunder,111
Fri Dec 12 2014,1,New Orleans Pelicans,5,119,8:00 pm,Cleveland Cavaliers,114
Fri Dec 12 2014,0,Phoenix Suns,-2,103,9:00 pm,Detroit Pistons,105
Fri Dec 12 2014,0,San Antonio Spurs,-2,110,9:30 pm,Los Angeles Lakers,112
Fri Dec 12 2014,1,Toronto Raptors,12,106,7:30 pm,Indiana Pacers,94
Fri Dec 12 2014,0,Utah Jazz,-5,95,9:00 pm,Miami Heat,100
Fri Dec 12 2014,1,Washington Wizards,8,104,7:00 pm,Los Angeles Clippers,96
Sat Dec 13 2014,0,Charlotte Hornets,-27,87,7:00 pm,Brooklyn Nets,114
Sat Dec 13 2014,0,Dallas Mavericks,-7,98,2:00 pm,Golden State Warriors,105
Sat Dec 13 2014,1,Houston Rockets,12,108,8:00 pm,Denver Nuggets,96
Sat Dec 13 2014,0,Indiana Pacers,-10,85,7:00 pm,Portland Trail Blazers,95
Sat Dec 13 2014,1,Milwaukee Bucks,5,111,7:30 pm,Los Angeles Clippers,106
Sat Dec 13 2014,1,Orlando Magic,1,100,7:00 pm,Atlanta Hawks,99
Sat Dec 13 2014,0,Philadelphia 76ers,-5,115,7:30 pm,Memphis Grizzlies,120
Sat Dec 13 2014,0,Sacramento Kings,-5,90,10:00 pm,Detroit Pistons,95
Sun Dec 14 2014,0,Denver Nuggets,-8,91,8:00 pm,San Antonio Spurs,99
Sun Dec 14 2014,0,Miami Heat,-18,75,6:00 pm,Chicago Bulls,93
Sun Dec 14 2014,0,Minnesota Timberwolves,-6,94,7:00 pm,Los Angeles Lakers,100
Sun Dec 14 2014,0,New Orleans Pelicans,-6,122,6:00 pm,Golden State Warriors,128
Sun Dec 14 2014,0,New York Knicks,-5,90,7:30 pm,Toronto Raptors,95
Sun Dec 14 2014,1,Oklahoma City Thunder,24,112,7:00 pm,Phoenix Suns,88
Sun Dec 14 2014,1,Washington Wizards,9,93,6:00 pm,Utah Jazz,84
Mon Dec 15 2014,1,Atlanta Hawks,7,93,7:30 pm,Chicago Bulls,86
Mon Dec 15 2014,1,Cleveland Cavaliers,9,97,7:00 pm,Charlotte Hornets,88
Mon Dec 15 2014,1,Indiana Pacers,19,110,7:00 pm,Los Angeles Lakers,91
Mon Dec 15 2014,1,Los Angeles Clippers,22,113,10:30 pm,Detroit Pistons,91
Mon Dec 15 2014,0,Philadelphia 76ers,-18,87,7:00 pm,Boston Celtics,105
Mon Dec 15 2014,0,Phoenix Suns,-2,94,9:00 pm,Milwaukee Bucks,96
Mon Dec 15 2014,1,Portland Trail Blazers,13,108,10:00 pm,San Antonio Spurs,95
Mon Dec 15 2014,1,Toronto Raptors,13,95,7:30 pm,Orlando Magic,82
Tue Dec 16 2014,0,Brooklyn Nets,-4,91,7:30 pm,Miami Heat,95
Tue Dec 16 2014,1,Memphis Grizzlies,7,105,8:00 pm,Golden State Warriors,98
Tue Dec 16 2014,1,New Orleans Pelicans,8,119,8:00 pm,Utah Jazz,111
Tue Dec 16 2014,0,New York Knicks,-20,87,8:00 pm,Dallas Mavericks,107
Tue Dec 16 2014,0,Sacramento Kings,-12,92,10:30 pm,Oklahoma City Thunder,104
Tue Dec 16 2014,1,Washington Wizards,14,109,7:00 pm,Minnesota Timberwolves,95
Wed Dec 17 2014,1,Boston Celtics,17,109,7:30 pm,Orlando Magic,92
Wed Dec 17 2014,0,Charlotte Hornets,-5,106,7:00 pm,Phoenix Suns,111
Wed Dec 17 2014,0,Cleveland Cavaliers,-29,98,7:00 pm,Atlanta Hawks,127
Wed Dec 17 2014,0,Denver Nuggets,-4,111,10:30 pm,Houston Rockets,115
Wed Dec 17 2014,0,Detroit Pistons,-11,106,7:30 pm,Dallas Mavericks,117
Wed Dec 17 2014,1,Los Angeles Clippers,2,102,10:30 pm,Indiana Pacers,100
Wed Dec 17 2014,0,Miami Heat,-18,87,7:30 pm,Utah Jazz,105
Wed Dec 17 2014,1,Portland Trail Blazers,7,104,10:00 pm,Milwaukee Bucks,97
Wed Dec 17 2014,0,San Antonio Spurs,-1,116,8:30 pm,Memphis Grizzlies,117
Wed Dec 17 2014,1,Toronto Raptors,16,105,8:00 pm,Brooklyn Nets,89
Thu Dec 18 2014,1,Chicago Bulls,6,103,8:00 pm,New York Knicks,97
Thu Dec 18 2014,1,Golden State Warriors,5,114,10:30 pm,Oklahoma City Thunder,109
Thu Dec 18 2014,0,Houston Rockets,-9,90,8:30 pm,New Orleans Pelicans,99
Thu Dec 18 2014,0,Sacramento Kings,-1,107,10:00 pm,Milwaukee Bucks,108
Fri Dec 19 2014,1,Boston Celtics,16,114,7:30 pm,Minnesota Timberwolves,98
Fri Dec 19 2014,1,Cleveland Cavaliers,4,95,7:30 pm,Brooklyn Nets,91
Fri Dec 19 2014,1,Denver Nuggets,3,109,9:00 pm,Los Angeles Clippers,106
Fri Dec 19 2014,0,Detroit Pistons,-10,100,7:30 pm,Toronto Raptors,110
Fri Dec 19 2014,0,Los Angeles Lakers,-1,103,10:30 pm,Oklahoma City Thunder,104
Fri Dec 19 2014,0,Memphis Grizzlies,-6,97,8:00 pm,Chicago Bulls,103
Fri Dec 19 2014,0,Miami Heat,-2,103,7:30 pm,Washington Wizards,105
Fri Dec 19 2014,0,Orlando Magic,-7,94,7:00 pm,Utah Jazz,101
Fri Dec 19 2014,0,Philadelphia 76ers,-18,91,7:00 pm,Charlotte Hornets,109
Fri Dec 19 2014,0,San Antonio Spurs,-10,119,8:00 pm,Portland Trail Blazers,129
Sat Dec 20 2014,1,Charlotte Hornets,18,104,7:00 pm,Utah Jazz,86
Sat Dec 20 2014,1,Dallas Mavericks,6,99,8:30 pm,San Antonio Spurs,93
Sat Dec 20 2014,1,Denver Nuggets,3,76,9:00 pm,Indiana Pacers,73
Sat Dec 20 2014,0,Houston Rockets,-7,97,8:00 pm,Atlanta Hawks,104
Sat Dec 20 2014,1,Los Angeles Clippers,4,106,10:30 pm,Milwaukee Bucks,102
Sat Dec 20 2014,0,New Orleans Pelicans,-26,88,7:00 pm,Portland Trail Blazers,114
Sat Dec 20 2014,0,New York Knicks,-9,90,1:00 pm,Phoenix Suns,99
Sun Dec 21 2014,1,Brooklyn Nets,5,110,6:00 pm,Detroit Pistons,105
Sun Dec 21 2014,1,Cleveland Cavaliers,14,105,4:30 pm,Memphis Grizzlies,91
Sun Dec 21 2014,1,Miami Heat,16,100,6:00 pm,Boston Celtics,84
Sun Dec 21 2014,0,Minnesota Timberwolves,-4,96,7:00 pm,Indiana Pacers,100
Sun Dec 21 2014,0,Oklahoma City Thunder,-2,99,7:00 pm,New Orleans Pelicans,101
Sun Dec 21 2014,0,Orlando Magic,-8,88,6:00 pm,Philadelphia 76ers,96
Sun Dec 21 2014,1,Sacramento Kings,7,108,6:00 pm,Los Angeles Lakers,101
Sun Dec 21 2014,1,Toronto Raptors,10,118,3:30 pm,New York Knicks,108
Sun Dec 21 2014,0,Washington Wizards,-12,92,6:00 pm,Phoenix Suns,104
Mon Dec 22 2014,1,Chicago Bulls,9,129,8:00 pm,Toronto Raptors,120
Mon Dec 22 2014,1,Charlotte Hornets,28,110,7:00 pm,Denver Nuggets,82
Mon Dec 22 2014,0,Dallas Mavericks,-3,102,8:30 pm,Atlanta Hawks,105
Mon Dec 22 2014,1,Golden State Warriors,20,128,10:30 pm,Sacramento Kings,108
Mon Dec 22 2014,1,Houston Rockets,15,110,8:00 pm,Portland Trail Blazers,95
Mon Dec 22 2014,0,Memphis Grizzlies,-6,91,8:00 pm,Utah Jazz,97
Mon Dec 22 2014,1,San Antonio Spurs,7,125,8:30 pm,Los Angeles Clippers,118
Tue Dec 23 2014,1,Atlanta Hawks,3,107,7:30 pm,Los Angeles Clippers,104
Tue Dec 23 2014,1,Brooklyn Nets,6,102,7:30 pm,Denver Nuggets,96
Tue Dec 23 2014,1,Cleveland Cavaliers,21,125,7:00 pm,Minnesota Timberwolves,104
Tue Dec 23 2014,1,Indiana Pacers,12,96,7:00 pm,New Orleans Pelicans,84
Tue Dec 23 2014,1,Los Angeles Lakers,10,115,10:30 pm,Golden State Warriors,105
Tue Dec 23 2014,0,Miami Heat,-4,87,7:30 pm,Philadelphia 76ers,91
Tue Dec 23 2014,0,Milwaukee Bucks,-7,101,8:00 pm,Charlotte Hornets,108
Tue Dec 23 2014,0,Oklahoma City Thunder,-4,111,8:00 pm,Portland Trail Blazers,115
Tue Dec 23 2014,1,Orlando Magic,5,100,7:00 pm,Boston Celtics,95
Tue Dec 23 2014,1,Phoenix Suns,9,124,9:00 pm,Dallas Mavericks,115
Tue Dec 23 2014,0,Washington Wizards,-8,91,7:00 pm,Chicago Bulls,99
Thu Dec 25 2014,1,Chicago Bulls,20,113,8:00 pm,Los Angeles Lakers,93
Thu Dec 25 2014,1,Los Angeles Clippers,14,100,10:30 pm,Golden State Warriors,86
Thu Dec 25 2014,1,Miami Heat,10,101,5:00 pm,Cleveland Cavaliers,91
Thu Dec 25 2014,0,New York Knicks,-11,91,12:00 pm,Washington Wizards,102
Thu Dec 25 2014,0,San Antonio Spurs,-8,106,2:30 pm,Oklahoma City Thunder,114
Fri Dec 26 2014,0,Atlanta Hawks,-30,77,7:30 pm,Milwaukee Bucks,107
Fri Dec 26 2014,0,Boston Celtics,-2,107,1:00 pm,Brooklyn Nets,109
Fri Dec 26 2014,1,Dallas Mavericks,4,102,8:30 pm,Los Angeles Lakers,98
Fri Dec 26 2014,1,Denver Nuggets,4,106,9:00 pm,Minnesota Timberwolves,102
Fri Dec 26 2014,1,Detroit Pistons,10,119,7:30 pm,Indiana Pacers,109
Fri Dec 26 2014,0,Memphis Grizzlies,-6,111,8:00 pm,Houston Rockets,117
Fri Dec 26 2014,1,New Orleans Pelicans,7,97,8:00 pm,San Antonio Spurs,90
Fri Dec 26 2014,1,Oklahoma City Thunder,23,98,8:00 pm,Charlotte Hornets,75
Fri Dec 26 2014,0,Orlando Magic,-9,89,7:00 pm,Cleveland Cavaliers,98
Fri Dec 26 2014,1,Portland Trail Blazers,21,114,10:00 pm,Philadelphia 76ers,93
Fri Dec 26 2014,0,Sacramento Kings,-9,106,10:00 pm,Phoenix Suns,115
Sat Dec 27 2014,0,Brooklyn Nets,-25,85,8:00 pm,Indiana Pacers,110
Sat Dec 27 2014,1,Chicago Bulls,7,107,8:00 pm,New Orleans Pelicans,100
Sat Dec 27 2014,0,Charlotte Hornets,-8,94,7:00 pm,Orlando Magic,102
Sat Dec 27 2014,1,Golden State Warriors,13,110,10:30 pm,Minnesota Timberwolves,97
Sat Dec 27 2014,0,Los Angeles Clippers,-12,98,3:30 pm,Toronto Raptors,110
Sat Dec 27 2014,0,Miami Heat,-8,95,7:30 pm,Memphis Grizzlies,103
Sat Dec 27 2014,0,Milwaukee Bucks,-5,85,8:30 pm,Atlanta Hawks,90
Sat Dec 27 2014,1,Sacramento Kings,6,135,10:00 pm,New York Knicks,129
Sat Dec 27 2014,1,Utah Jazz,17,88,9:00 pm,Philadelphia 76ers,71
Sat Dec 27 2014,1,Washington Wizards,13,101,7:00 pm,Boston Celtics,88
Sun Dec 28 2014,0,Cleveland Cavaliers,-23,80,4:30 pm,Detroit Pistons,103
Sun Dec 28 2014,1,Dallas Mavericks,5,112,7:30 pm,Oklahoma City Thunder,107
Sun Dec 28 2014,0,Denver Nuggets,-14,102,9:00 pm,Toronto Raptors,116
Sun Dec 28 2014,0,Los Angeles Lakers,-9,107,9:30 pm,Phoenix Suns,116
Sun Dec 28 2014,1,Portland Trail Blazers,22,101,9:00 pm,New York Knicks,79
Sun Dec 28 2014,1,San Antonio Spurs,4,110,7:00 pm,Houston Rockets,106
Mon Dec 29 2014,1,Brooklyn Nets,8,107,7:30 pm,Sacramento Kings,99
Mon Dec 29 2014,0,Charlotte Hornets,-10,94,7:00 pm,Milwaukee Bucks,104
Mon Dec 29 2014,0,Houston Rockets,-1,103,8:00 pm,Washington Wizards,104
Mon Dec 29 2014,0,Indiana Pacers,-2,90,7:00 pm,Chicago Bulls,92
Mon Dec 29 2014,1,Los Angeles Clippers,4,101,10:30 pm,Utah Jazz,97
Mon Dec 29 2014,0,Miami Heat,-1,101,7:30 pm,Orlando Magic,102
Tue Dec 30 2014,1,Atlanta Hawks,8,109,7:30 pm,Cleveland Cavaliers,101
Tue Dec 30 2014,0,Chicago Bulls,-14,82,8:00 pm,Brooklyn Nets,96
Tue Dec 30 2014,1,Dallas Mavericks,27,114,8:30 pm,Washington Wizards,87
Tue Dec 30 2014,0,Denver Nuggets,-8,103,9:00 pm,Los Angeles Lakers,111
Tue Dec 30 2014,1,Golden State Warriors,40,126,10:30 pm,Philadelphia 76ers,86
Tue Dec 30 2014,1,Memphis Grizzlies,8,95,8:00 pm,San Antonio Spurs,87
Tue Dec 30 2014,1,New Orleans Pelicans,4,110,8:00 pm,Phoenix Suns,106
Tue Dec 30 2014,0,Orlando Magic,-23,86,7:00 pm,Detroit Pistons,109
Tue Dec 30 2014,1,Portland Trail Blazers,5,102,10:00 pm,Toronto Raptors,97
Tue Dec 30 2014,1,Utah Jazz,6,100,9:00 pm,Minnesota Timberwolves,94
Wed Dec 31 2014,1,Boston Celtics,22,106,1:00 pm,Sacramento Kings,84
Wed Dec 31 2014,0,Cleveland Cavaliers,-16,80,7:00 pm,Milwaukee Bucks,96
Wed Dec 31 2014,1,Houston Rockets,19,102,7:00 pm,Charlotte Hornets,83
Wed Dec 31 2014,1,Indiana Pacers,11,106,3:00 pm,Miami Heat,95
Wed Dec 31 2014,1,Los Angeles Clippers,21,99,6:00 pm,New York Knicks,78
Wed Dec 31 2014,1,Oklahoma City Thunder,3,137,8:00 pm,Phoenix Suns,134
Wed Dec 31 2014,1,San Antonio Spurs,2,95,7:00 pm,New Orleans Pelicans,93
Thu Jan 1 2015,1,Chicago Bulls,5,106,8:00 pm,Denver Nuggets,101
Thu Jan 1 2015,0,Minnesota Timberwolves,-3,107,8:00 pm,Sacramento Kings,110
Fri Jan 2 2015,0,Boston Celtics,-18,101,7:30 pm,Dallas Mavericks,119
Fri Jan 2 2015,0,Charlotte Hornets,-4,87,7:00 pm,Cleveland Cavaliers,91
Fri Jan 2 2015,1,Golden State Warriors,21,126,10:30 pm,Toronto Raptors,105
Fri Jan 2 2015,0,Los Angeles Lakers,-3,106,10:30 pm,Memphis Grizzlies,109
Fri Jan 2 2015,0,Milwaukee Bucks,-3,91,8:30 pm,Indiana Pacers,94
Fri Jan 2 2015,1,New Orleans Pelicans,28,111,8:00 pm,Houston Rockets,83
Fri Jan 2 2015,0,New York Knicks,-16,81,7:30 pm,Detroit Pistons,97
Fri Jan 2 2015,1,Oklahoma City Thunder,7,109,8:00 pm,Washington Wizards,102
Fri Jan 2 2015,0,Orlando Magic,-2,98,7:00 pm,Brooklyn Nets,100
Fri Jan 2 2015,1,Phoenix Suns,16,112,9:00 pm,Philadelphia 76ers,96
Fri Jan 2 2015,0,Utah Jazz,-6,92,9:00 pm,Atlanta Hawks,98
Sat Jan 3 2015,1,Chicago Bulls,5,109,8:00 pm,Boston Celtics,104
Sat Jan 3 2015,1,Denver Nuggets,29,114,9:00 pm,Memphis Grizzlies,85
Sat Jan 3 2015,1,Houston Rockets,36,115,8:00 pm,Miami Heat,79
Sat Jan 3 2015,1,Los Angeles Clippers,36,127,10:30 pm,Philadelphia 76ers,91
Sat Jan 3 2015,0,Minnesota Timberwolves,-12,89,8:00 pm,Utah Jazz,101
Sat Jan 3 2015,0,Orlando Magic,-8,90,7:00 pm,Charlotte Hornets,98
Sat Jan 3 2015,0,Portland Trail Blazers,-8,107,10:00 pm,Atlanta Hawks,115
Sat Jan 3 2015,1,San Antonio Spurs,9,101,8:30 pm,Washington Wizards,92
Sun Jan 4 2015,0,Cleveland Cavaliers,-19,90,1:00 pm,Dallas Mavericks,109
Sun Jan 4 2015,1,Detroit Pistons,19,114,6:00 pm,Sacramento Kings,95
Sun Jan 4 2015,1,Los Angeles Lakers,1,88,9:30 pm,Indiana Pacers,87
Sun Jan 4 2015,1,Miami Heat,4,88,6:00 pm,Brooklyn Nets,84
Sun Jan 4 2015,0,New York Knicks,-13,82,7:30 pm,Milwaukee Bucks,95
Sun Jan 4 2015,1,Phoenix Suns,16,125,8:00 pm,Toronto Raptors,109
Mon Jan 5 2015,0,Boston Celtics,-9,95,7:30 pm,Charlotte Hornets,104
Mon Jan 5 2015,0,Brooklyn Nets,-8,88,7:30 pm,Dallas Mavericks,96
Mon Jan 5 2015,1,Chicago Bulls,9,114,8:00 pm,Houston Rockets,105
Mon Jan 5 2015,1,Golden State Warriors,26,117,10:30 pm,Oklahoma City Thunder,91
Mon Jan 5 2015,0,Los Angeles Clippers,-9,98,10:30 pm,Atlanta Hawks,107
Mon Jan 5 2015,1,Memphis Grizzlies,22,105,8:00 pm,New York Knicks,83
Mon Jan 5 2015,0,Minnesota Timberwolves,-9,101,8:00 pm,Denver Nuggets,110
Mon Jan 5 2015,0,New Orleans Pelicans,-7,85,8:00 pm,Washington Wizards,92
Mon Jan 5 2015,1,Philadelphia 76ers,3,95,7:00 pm,Cleveland Cavaliers,92
Mon Jan 5 2015,1,Portland Trail Blazers,4,98,10:00 pm,Los Angeles Lakers,94
Mon Jan 5 2015,0,Utah Jazz,-4,101,9:00 pm,Indiana Pacers,105
Tue Jan 6 2015,0,Milwaukee Bucks,-6,96,8:00 pm,Phoenix Suns,102
Tue Jan 6 2015,0,San Antonio Spurs,-1,104,8:30 pm,Detroit Pistons,105
Wed Jan 7 2015,1,Atlanta Hawks,10,96,7:30 pm,Memphis Grizzlies,86
Wed Jan 7 2015,0,Brooklyn Nets,-8,81,7:30 pm,Boston Celtics,89
Wed Jan 7 2015,0,Chicago Bulls,-20,77,8:00 pm,Utah Jazz,97
Wed Jan 7 2015,1,Charlotte Hornets,4,98,7:00 pm,New Orleans Pelicans,94
Wed Jan 7 2015,0,Cleveland Cavaliers,-12,93,7:00 pm,Houston Rockets,105
Wed Jan 7 2015,0,Dallas Mavericks,-13,95,8:30 pm,Detroit Pistons,108
Wed Jan 7 2015,1,Denver Nuggets,3,93,9:00 pm,Orlando Magic,90
Wed Jan 7 2015,1,Golden State Warriors,15,117,10:30 pm,Indiana Pacers,102
Wed Jan 7 2015,1,Los Angeles Clippers,25,114,10:30 pm,Los Angeles Lakers,89
Wed Jan 7 2015,0,Minnesota Timberwolves,-2,111,9:30 pm,Phoenix Suns,113
Wed Jan 7 2015,0,Philadelphia 76ers,-20,77,7:00 pm,Milwaukee Bucks,97
Wed Jan 7 2015,1,Sacramento Kings,21,104,10:00 pm,Oklahoma City Thunder,83
Wed Jan 7 2015,1,Washington Wizards,10,101,7:00 pm,New York Knicks,91
Thu Jan 8 2015,0,New York Knicks,-24,96,8:00 pm,Houston Rockets,120
Thu Jan 8 2015,1,Portland Trail Blazers,16,99,10:30 pm,Miami Heat,83
Thu Jan 8 2015,0,Toronto Raptors,-8,95,7:30 pm,Charlotte Hornets,103
Fri Jan 9 2015,0,Brooklyn Nets,-2,88,7:30 pm,Philadelphia 76ers,90
Fri Jan 9 2015,0,Detroit Pistons,-3,103,7:30 pm,Atlanta Hawks,106
Fri Jan 9 2015,1,Golden State Warriors,18,112,10:30 pm,Cleveland Cavaliers,94
Fri Jan 9 2015,1,Indiana Pacers,4,107,7:00 pm,Boston Celtics,103
Fri Jan 9 2015,1,Los Angeles Lakers,17,101,10:30 pm,Orlando Magic,84
Fri Jan 9 2015,1,Milwaukee Bucks,14,98,8:30 pm,Minnesota Timberwolves,84
Fri Jan 9 2015,1,New Orleans Pelicans,11,106,8:00 pm,Memphis Grizzlies,95
Fri Jan 9 2015,1,Oklahoma City Thunder,5,99,8:00 pm,Utah Jazz,94
Fri Jan 9 2015,0,Sacramento Kings,-10,108,10:00 pm,Denver Nuggets,118
Fri Jan 9 2015,1,San Antonio Spurs,5,100,8:30 pm,Phoenix Suns,95
Fri Jan 9 2015,1,Washington Wizards,16,102,8:00 pm,Chicago Bulls,86
Sat Jan 10 2015,1,Chicago Bulls,8,95,8:00 pm,Milwaukee Bucks,87
Sat Jan 10 2015,1,Detroit Pistons,5,98,7:30 pm,Brooklyn Nets,93
Sat Jan 10 2015,1,Houston Rockets,15,97,8:00 pm,Utah Jazz,82
Sat Jan 10 2015,1,Los Angeles Clippers,20,120,3:30 pm,Dallas Mavericks,100
Sat Jan 10 2015,0,Minnesota Timberwolves,-15,93,8:00 pm,San Antonio Spurs,108
Sat Jan 10 2015,0,New York Knicks,-28,82,1:00 pm,Charlotte Hornets,110
Sat Jan 10 2015,1,Philadelphia 76ers,1,93,7:30 pm,Indiana Pacers,92
Sat Jan 10 2015,1,Portland Trail Blazers,11,103,10:00 pm,Orlando Magic,92
Sat Jan 10 2015,1,Toronto Raptors,13,109,7:30 pm,Boston Celtics,96
Sun Jan 11 2015,1,Atlanta Hawks,31,120,3:00 pm,Washington Wizards,89
Sun Jan 11 2015,0,Los Angeles Clippers,-14,90,3:30 pm,Miami Heat,104
Sun Jan 11 2015,0,Los Angeles Lakers,-12,94,9:30 pm,Portland Trail Blazers,106
Sun Jan 11 2015,1,Memphis Grizzlies,12,122,6:00 pm,Phoenix Suns,110
Sun Jan 11 2015,1,Sacramento Kings,19,103,9:00 pm,Cleveland Cavaliers,84
Mon Jan 12 2015,1,Boston Celtics,8,108,7:30 pm,New Orleans Pelicans,100
Mon Jan 12 2015,0,Brooklyn Nets,-14,99,7:30 pm,Houston Rockets,113
Mon Jan 12 2015,0,Chicago Bulls,-7,114,8:00 pm,Orlando Magic,121
Mon Jan 12 2015,0,Toronto Raptors,-3,111,7:30 pm,Detroit Pistons,114
Tue Jan 13 2015,0,Indiana Pacers,-9,101,7:00 pm,Minnesota Timberwolves,110
Tue Jan 13 2015,0,Los Angeles Lakers,-3,75,10:30 pm,Miami Heat,78
Tue Jan 13 2015,0,Philadelphia 76ers,-18,87,7:00 pm,Atlanta Hawks,105
Tue Jan 13 2015,1,Phoenix Suns,7,107,9:00 pm,Cleveland Cavaliers,100
Tue Jan 13 2015,0,Sacramento Kings,-4,104,10:00 pm,Dallas Mavericks,108
Tue Jan 13 2015,0,Utah Jazz,-11,105,9:00 pm,Golden State Warriors,116
Tue Jan 13 2015,1,Washington Wizards,8,101,7:00 pm,San Antonio Spurs,93
Wed Jan 14 2015,0,Boston Celtics,-14,91,8:00 pm,Atlanta Hawks,105
Wed Jan 14 2015,0,Brooklyn Nets,-11,92,7:30 pm,Memphis Grizzlies,103
Wed Jan 14 2015,0,Chicago Bulls,-6,99,8:00 pm,Washington Wizards,105
Wed Jan 14 2015,0,Charlotte Hornets,-5,93,7:00 pm,San Antonio Spurs,98
Wed Jan 14 2015,1,Denver Nuggets,7,114,9:00 pm,Dallas Mavericks,107
Wed Jan 14 2015,0,Detroit Pistons,-11,94,7:30 pm,New Orleans Pelicans,105
Wed Jan 14 2015,1,Golden State Warriors,15,104,10:30 pm,Miami Heat,89
Wed Jan 14 2015,1,Orlando Magic,7,120,7:00 pm,Houston Rockets,113
Wed Jan 14 2015,0,Portland Trail Blazers,-6,94,10:30 pm,Los Angeles Clippers,100
Wed Jan 14 2015,1,Toronto Raptors,16,100,7:30 pm,Philadelphia 76ers,84
Thu Jan 15 2015,1,Houston Rockets,11,112,8:00 pm,Oklahoma City Thunder,101
Thu Jan 15 2015,0,Los Angeles Lakers,-7,102,10:30 pm,Cleveland Cavaliers,109
Thu Jan 15 2015,1,Milwaukee Bucks,16,95,3:00 pm,New York Knicks,79
Fri Jan 16 2015,0,Boston Celtics,-16,103,7:30 pm,Chicago Bulls,119
Fri Jan 16 2015,1,Dallas Mavericks,8,97,8:30 pm,Denver Nuggets,89
Fri Jan 16 2015,0,Indiana Pacers,-2,96,7:00 pm,Detroit Pistons,98
Fri Jan 16 2015,0,Los Angeles Clippers,-5,121,10:30 pm,Cleveland Cavaliers,126
Fri Jan 16 2015,1,Oklahoma City Thunder,12,127,8:00 pm,Golden State Warriors,115
Fri Jan 16 2015,0,Orlando Magic,-10,96,7:00 pm,Memphis Grizzlies,106
Fri Jan 16 2015,1,Philadelphia 76ers,15,96,7:00 pm,New Orleans Pelicans,81
Fri Jan 16 2015,1,Phoenix Suns,11,110,9:00 pm,Minnesota Timberwolves,99
Fri Jan 16 2015,0,Sacramento Kings,-12,83,10:00 pm,Miami Heat,95
Fri Jan 16 2015,1,San Antonio Spurs,14,110,8:30 pm,Portland Trail Blazers,96
Fri Jan 16 2015,0,Toronto Raptors,-21,89,7:30 pm,Atlanta Hawks,110
Fri Jan 16 2015,1,Utah Jazz,9,94,9:00 pm,Los Angeles Lakers,85
Fri Jan 16 2015,0,Washington Wizards,-22,80,7:00 pm,Brooklyn Nets,102
Sat Jan 17 2015,0,Brooklyn Nets,-9,90,8:00 pm,Washington Wizards,99
Sat Jan 17 2015,0,Chicago Bulls,-8,99,8:00 pm,Atlanta Hawks,107
Sat Jan 17 2015,1,Charlotte Hornets,9,80,7:00 pm,Indiana Pacers,71
Sat Jan 17 2015,0,Denver Nuggets,-8,105,9:00 pm,Minnesota Timberwolves,113
Sat Jan 17 2015,1,Detroit Pistons,18,107,7:30 pm,Philadelphia 76ers,89
Sat Jan 17 2015,0,Houston Rockets,-25,106,8:00 pm,Golden State Warriors,131
Sat Jan 17 2015,1,Memphis Grizzlies,4,102,9:00 pm,Portland Trail Blazers,98
Sat Jan 17 2015,0,Sacramento Kings,-9,108,10:00 pm,Los Angeles Clippers,117
Sun Jan 18 2015,0,Orlando Magic,-28,99,6:00 pm,Oklahoma City Thunder,127
Sun Jan 18 2015,1,San Antonio Spurs,20,89,7:00 pm,Utah Jazz,69
Sun Jan 18 2015,0,Toronto Raptors,-2,93,3:30 pm,New Orleans Pelicans,95
Mon Jan 19 2015,1,Atlanta Hawks,11,93,2:30 pm,Detroit Pistons,82
Mon Jan 19 2015,1,Charlotte Hornets,25,105,2:00 pm,Minnesota Timberwolves,80
Mon Jan 19 2015,1,Cleveland Cavaliers,14,108,7:30 pm,Chicago Bulls,94
Mon Jan 19 2015,1,Golden State Warriors,43,122,4:00 pm,Denver Nuggets,79
Mon Jan 19 2015,1,Houston Rockets,12,110,5:30 pm,Indiana Pacers,98
Mon Jan 19 2015,1,Los Angeles Clippers,9,102,3:30 pm,Boston Celtics,93
Mon Jan 19 2015,0,Memphis Grizzlies,-8,95,5:00 pm,Dallas Mavericks,103
Mon Jan 19 2015,0,Milwaukee Bucks,-3,89,8:00 pm,Toronto Raptors,92
Mon Jan 19 2015,1,New York Knicks,7,99,5:30 pm,New Orleans Pelicans,92
Mon Jan 19 2015,1,Phoenix Suns,15,115,10:00 pm,Los Angeles Lakers,100
Mon Jan 19 2015,1,Portland Trail Blazers,4,98,10:00 pm,Sacramento Kings,94
Mon Jan 19 2015,1,Washington Wizards,35,111,2:00 pm,Philadelphia 76ers,76
Tue Jan 20 2015,0,Denver Nuggets,-10,99,9:00 pm,San Antonio Spurs,109
Tue Jan 20 2015,0,Miami Heat,-8,86,7:30 pm,Oklahoma City Thunder,94
Wed Jan 21 2015,1,Atlanta Hawks,19,110,7:30 pm,Indiana Pacers,91
Wed Jan 21 2015,1,Charlotte Hornets,2,78,7:00 pm,Miami Heat,76
Wed Jan 21 2015,1,Cleveland Cavaliers,14,106,7:00 pm,Utah Jazz,92
Wed Jan 21 2015,1,Detroit Pistons,10,128,7:30 pm,Orlando Magic,118
Wed Jan 21 2015,1,Golden State Warriors,13,126,10:30 pm,Houston Rockets,113
Wed Jan 21 2015,1,Memphis Grizzlies,6,92,8:00 pm,Toronto Raptors,86
Wed Jan 21 2015,0,Minnesota Timberwolves,-23,75,8:00 pm,Dallas Mavericks,98
Wed Jan 21 2015,1,New Orleans Pelicans,16,96,8:00 pm,Los Angeles Lakers,80
Wed Jan 21 2015,0,Philadelphia 76ers,-7,91,7:00 pm,New York Knicks,98
Wed Jan 21 2015,1,Phoenix Suns,5,118,9:00 pm,Portland Trail Blazers,113
Wed Jan 21 2015,0,Sacramento Kings,-3,100,10:00 pm,Brooklyn Nets,103
Wed Jan 21 2015,0,Washington Wizards,-2,103,8:00 pm,Oklahoma City Thunder,105
Thu Jan 22 2015,1,Chicago Bulls,23,104,8:00 pm,San Antonio Spurs,81
Thu Jan 22 2015,1,Los Angeles Clippers,39,123,10:30 pm,Brooklyn Nets,84
Thu Jan 22 2015,0,Milwaukee Bucks,-2,99,8:00 pm,Utah Jazz,101
Thu Jan 22 2015,0,Portland Trail Blazers,-1,89,10:00 pm,Boston Celtics,90
Fri Jan 23 2015,1,Atlanta Hawks,10,103,7:30 pm,Oklahoma City Thunder,93
Fri Jan 23 2015,1,Cleveland Cavaliers,39,129,7:30 pm,Charlotte Hornets,90
Fri Jan 23 2015,0,Dallas Mavericks,-4,98,8:00 pm,Chicago Bulls,102
Fri Jan 23 2015,0,Denver Nuggets,-1,99,9:00 pm,Boston Celtics,100
Fri Jan 23 2015,1,Golden State Warriors,25,126,10:30 pm,Sacramento Kings,101
Fri Jan 23 2015,1,Miami Heat,2,89,7:30 pm,Indiana Pacers,87
Fri Jan 23 2015,0,Minnesota Timberwolves,-8,84,8:00 pm,New Orleans Pelicans,92
Fri Jan 23 2015,1,New York Knicks,7,113,7:30 pm,Orlando Magic,106
Fri Jan 23 2015,0,Philadelphia 76ers,-5,86,7:00 pm,Toronto Raptors,91
Fri Jan 23 2015,0,Phoenix Suns,-2,111,9:00 pm,Houston Rockets,113
Fri Jan 23 2015,1,San Antonio Spurs,14,99,8:30 pm,Los Angeles Lakers,85
Sat Jan 24 2015,1,Charlotte Hornets,5,76,7:00 pm,New York Knicks,71
Sat Jan 24 2015,1,Memphis Grizzlies,18,101,8:00 pm,Philadelphia 76ers,83
Sat Jan 24 2015,1,Milwaukee Bucks,15,101,7:30 pm,Detroit Pistons,86
Sat Jan 24 2015,1,Portland Trail Blazers,7,103,10:00 pm,Washington Wizards,96
Sat Jan 24 2015,1,Utah Jazz,35,108,9:00 pm,Brooklyn Nets,73
Sun Jan 25 2015,1,Atlanta Hawks,12,112,6:00 pm,Minnesota Timberwolves,100
Sun Jan 25 2015,0,Chicago Bulls,-12,84,1:00 pm,Miami Heat,96
Sun Jan 25 2015,1,Cleveland Cavaliers,10,108,3:30 pm,Oklahoma City Thunder,98
Sun Jan 25 2015,0,Denver Nuggets,-2,115,8:00 pm,Washington Wizards,117
Sun Jan 25 2015,1,Golden State Warriors,3,114,8:00 pm,Boston Celtics,111
Sun Jan 25 2015,0,Los Angeles Lakers,-12,87,9:30 pm,Houston Rockets,99
Sun Jan 25 2015,1,New Orleans Pelicans,3,109,6:00 pm,Dallas Mavericks,106
Sun Jan 25 2015,0,Orlando Magic,-7,99,6:00 pm,Indiana Pacers,106
Sun Jan 25 2015,0,Phoenix Suns,-20,100,6:00 pm,Los Angeles Clippers,120
Sun Jan 25 2015,1,San Antonio Spurs,6,101,7:00 pm,Milwaukee Bucks,95
Sun Jan 25 2015,1,Toronto Raptors,4,114,7:00 pm,Detroit Pistons,110
Mon Jan 26 2015,1,Los Angeles Clippers,4,102,10:30 pm,Denver Nuggets,98
Mon Jan 26 2015,1,Memphis Grizzlies,9,103,8:00 pm,Orlando Magic,94
Mon Jan 26 2015,1,New Orleans Pelicans,25,99,8:00 pm,Philadelphia 76ers,74
Mon Jan 26 2015,1,Oklahoma City Thunder,8,92,8:00 pm,Minnesota Timberwolves,84
Mon Jan 26 2015,0,Utah Jazz,-9,90,9:00 pm,Boston Celtics,99
Tue Jan 27 2015,0,Dallas Mavericks,-19,90,8:30 pm,Memphis Grizzlies,109
Tue Jan 27 2015,0,Detroit Pistons,-8,95,7:30 pm,Cleveland Cavaliers,103
Tue Jan 27 2015,0,Golden State Warriors,-2,111,10:30 pm,Chicago Bulls,113
Tue Jan 27 2015,0,Indiana Pacers,-13,91,7:00 pm,Toronto Raptors,104
Tue Jan 27 2015,0,Los Angeles Lakers,-6,92,10:30 pm,Washington Wizards,98
Tue Jan 27 2015,0,Miami Heat,-7,102,7:30 pm,Milwaukee Bucks,109
Wed Jan 28 2015,1,Atlanta Hawks,11,113,8:00 pm,Brooklyn Nets,102
Wed Jan 28 2015,1,Cleveland Cavaliers,5,99,7:00 pm,Portland Trail Blazers,94
Wed Jan 28 2015,1,Houston Rockets,5,99,8:00 pm,Dallas Mavericks,94
Wed Jan 28 2015,1,Minnesota Timberwolves,12,110,8:00 pm,Boston Celtics,98
Wed Jan 28 2015,0,New Orleans Pelicans,-8,85,8:00 pm,Denver Nuggets,93
Wed Jan 28 2015,1,New York Knicks,8,100,8:00 pm,Oklahoma City Thunder,92
Wed Jan 28 2015,1,Philadelphia 76ers,20,89,7:00 pm,Detroit Pistons,69
Wed Jan 28 2015,1,Phoenix Suns,8,106,10:30 pm,Washington Wizards,98
Wed Jan 28 2015,1,San Antonio Spurs,9,95,8:30 pm,Charlotte Hornets,86
Wed Jan 28 2015,1,Toronto Raptors,17,119,7:30 pm,Sacramento Kings,102
Wed Jan 28 2015,0,Utah Jazz,-5,89,9:00 pm,Los Angeles Clippers,94
Thu Jan 29 2015,1,Indiana Pacers,21,103,7:00 pm,New York Knicks,82
Thu Jan 29 2015,1,Los Angeles Lakers,5,123,10:30 pm,Chicago Bulls,118
Thu Jan 29 2015,1,Memphis Grizzlies,30,99,8:00 pm,Denver Nuggets,69
Thu Jan 29 2015,0,Orlando Magic,-15,100,7:00 pm,Milwaukee Bucks,115
Fri Jan 30 2015,1,Atlanta Hawks,6,105,7:30 pm,Portland Trail Blazers,99
Fri Jan 30 2015,0,Boston Celtics,-6,87,7:30 pm,Houston Rockets,93
Fri Jan 30 2015,0,Brooklyn Nets,-5,122,7:30 pm,Toronto Raptors,127
Fri Jan 30 2015,1,Cleveland Cavaliers,11,101,7:30 pm,Sacramento Kings,90
Fri Jan 30 2015,0,Miami Heat,-21,72,8:00 pm,Dallas Mavericks,93
Fri Jan 30 2015,1,New Orleans Pelicans,5,108,8:00 pm,Los Angeles Clippers,103
Fri Jan 30 2015,1,Philadelphia 76ers,9,103,7:00 pm,Minnesota Timberwolves,94
Fri Jan 30 2015,1,Phoenix Suns,6,99,10:30 pm,Chicago Bulls,93
Fri Jan 30 2015,1,Utah Jazz,10,110,9:00 pm,Golden State Warriors,100
Sat Jan 31 2015,1,Atlanta Hawks,6,91,7:30 pm,Philadelphia 76ers,85
Sat Jan 31 2015,0,Denver Nuggets,-18,86,9:00 pm,Charlotte Hornets,104
Sat Jan 31 2015,1,Detroit Pistons,13,114,7:30 pm,Houston Rockets,101
Sat Jan 31 2015,1,Golden State Warriors,19,106,10:30 pm,Phoenix Suns,87
Sat Jan 31 2015,0,Indiana Pacers,-5,94,7:00 pm,Sacramento Kings,99
Sat Jan 31 2015,1,Memphis Grizzlies,11,85,8:00 pm,Oklahoma City Thunder,74
Sat Jan 31 2015,1,Milwaukee Bucks,7,95,8:30 pm,Portland Trail Blazers,88
Sat Jan 31 2015,0,Minnesota Timberwolves,-16,90,8:00 pm,Cleveland Cavaliers,106
Sat Jan 31 2015,0,Orlando Magic,-15,93,7:00 pm,Dallas Mavericks,108
Sat Jan 31 2015,0,San Antonio Spurs,-20,85,9:00 pm,Los Angeles Clippers,105
Sat Jan 31 2015,0,Washington Wizards,-4,116,7:00 pm,Toronto Raptors,120
Sun Feb 1 2015,0,Boston Celtics,-8,75,1:00 pm,Miami Heat,83
Sun Feb 1 2015,1,New York Knicks,12,92,2:00 pm,Los Angeles Lakers,80
Mon Feb 2 2015,1,Brooklyn Nets,2,102,7:30 pm,Los Angeles Clippers,100
Mon Feb 2 2015,1,Cleveland Cavaliers,13,97,7:00 pm,Philadelphia 76ers,84
Mon Feb 2 2015,1,Dallas Mavericks,6,100,8:30 pm,Minnesota Timberwolves,94
Mon Feb 2 2015,1,New Orleans Pelicans,15,115,8:00 pm,Atlanta Hawks,100
Mon Feb 2 2015,1,Oklahoma City Thunder,7,104,8:00 pm,Orlando Magic,97
Mon Feb 2 2015,0,Phoenix Suns,-1,101,9:00 pm,Memphis Grizzlies,102
Mon Feb 2 2015,0,Toronto Raptors,-7,75,7:30 pm,Milwaukee Bucks,82
Mon Feb 2 2015,0,Washington Wizards,-4,88,7:00 pm,Charlotte Hornets,92
Tue Feb 3 2015,1,Detroit Pistons,17,108,7:30 pm,Miami Heat,91
Tue Feb 3 2015,0,New York Knicks,-11,97,7:30 pm,Boston Celtics,108
Tue Feb 3 2015,1,Philadelphia 76ers,7,105,7:00 pm,Denver Nuggets,98
Tue Feb 3 2015,1,Portland Trail Blazers,1,103,10:00 pm,Utah Jazz,102
Tue Feb 3 2015,0,Sacramento Kings,-25,96,10:00 pm,Golden State Warriors,121
Wed Feb 4 2015,1,Atlanta Hawks,9,105,7:30 pm,Washington Wizards,96
Wed Feb 4 2015,1,Boston Celtics,4,104,7:30 pm,Denver Nuggets,100
Wed Feb 4 2015,1,Golden State Warriors,14,128,10:30 pm,Dallas Mavericks,114
Wed Feb 4 2015,1,Houston Rockets,11,101,8:00 pm,Chicago Bulls,90
Wed Feb 4 2015,1,Indiana Pacers,5,114,7:00 pm,Detroit Pistons,109
Wed Feb 4 2015,1,Milwaukee Bucks,8,113,8:00 pm,Los Angeles Lakers,105
Wed Feb 4 2015,1,Minnesota Timberwolves,1,102,8:00 pm,Miami Heat,101
Wed Feb 4 2015,0,New Orleans Pelicans,-11,91,8:00 pm,Oklahoma City Thunder,102
Wed Feb 4 2015,1,San Antonio Spurs,7,110,8:30 pm,Orlando Magic,103
Wed Feb 4 2015,0,Toronto Raptors,-16,93,7:30 pm,Brooklyn Nets,109
Wed Feb 4 2015,0,Utah Jazz,-10,90,9:00 pm,Memphis Grizzlies,100
Thu Feb 5 2015,1,Charlotte Hornets,7,94,7:00 pm,Washington Wizards,87
Thu Feb 5 2015,1,Cleveland Cavaliers,11,105,8:00 pm,Los Angeles Clippers,94
Thu Feb 5 2015,1,Portland Trail Blazers,21,108,10:30 pm,Phoenix Suns,87
Thu Feb 5 2015,0,Sacramento Kings,-23,78,10:00 pm,Dallas Mavericks,101
Fri Feb 6 2015,1,Atlanta Hawks,8,124,7:30 pm,Golden State Warriors,116
Fri Feb 6 2015,1,Boston Celtics,11,107,7:30 pm,Philadelphia 76ers,96
Fri Feb 6 2015,1,Brooklyn Nets,4,92,7:00 pm,New York Knicks,88
Fri Feb 6 2015,1,Detroit Pistons,10,98,7:30 pm,Denver Nuggets,88
Fri Feb 6 2015,1,Houston Rockets,6,117,8:00 pm,Milwaukee Bucks,111
Fri Feb 6 2015,1,Indiana Pacers,4,103,7:00 pm,Cleveland Cavaliers,99
Fri Feb 6 2015,1,Minnesota Timberwolves,1,90,8:00 pm,Memphis Grizzlies,89
Fri Feb 6 2015,0,Oklahoma City Thunder,-3,113,8:00 pm,New Orleans Pelicans,116
Fri Feb 6 2015,1,Orlando Magic,6,103,7:00 pm,Los Angeles Lakers,97
Fri Feb 6 2015,1,Phoenix Suns,7,100,9:00 pm,Utah Jazz,93
Fri Feb 6 2015,1,San Antonio Spurs,13,98,9:30 pm,Miami Heat,85
Fri Feb 6 2015,1,Toronto Raptors,16,123,7:00 pm,Los Angeles Clippers,107
Sat Feb 7 2015,1,Dallas Mavericks,10,111,8:30 pm,Portland Trail Blazers,101
Sat Feb 7 2015,1,Milwaukee Bucks,3,96,8:30 pm,Boston Celtics,93
Sat Feb 7 2015,0,New Orleans Pelicans,-35,72,7:00 pm,Chicago Bulls,107
Sat Feb 7 2015,0,New York Knicks,-14,92,7:30 pm,Golden State Warriors,106
Sat Feb 7 2015,1,Philadelphia 76ers,8,89,7:30 pm,Charlotte Hornets,81
Sat Feb 7 2015,1,Utah Jazz,12,102,9:00 pm,Sacramento Kings,90
Sat Feb 7 2015,1,Washington Wizards,37,114,7:00 pm,Brooklyn Nets,77
Sun Feb 8 2015,0,Charlotte Hornets,-1,102,6:00 pm,Indiana Pacers,103
Sun Feb 8 2015,1,Cleveland Cavaliers,15,120,3:30 pm,Los Angeles Lakers,105
Sun Feb 8 2015,0,Detroit Pistons,-11,101,6:00 pm,Minnesota Timberwolves,112
Sun Feb 8 2015,0,Houston Rockets,-11,98,7:00 pm,Portland Trail Blazers,109
Sun Feb 8 2015,1,Memphis Grizzlies,6,94,6:00 pm,Atlanta Hawks,88
Sun Feb 8 2015,1,Oklahoma City Thunder,23,131,1:00 pm,Los Angeles Clippers,108
Sun Feb 8 2015,0,Orlando Magic,-1,97,6:00 pm,Chicago Bulls,98
Sun Feb 8 2015,1,Sacramento Kings,2,85,9:00 pm,Phoenix Suns,83
Sun Feb 8 2015,1,Toronto Raptors,5,87,7:00 pm,San Antonio Spurs,82
Mon Feb 9 2015,0,Dallas Mavericks,-17,98,8:30 pm,Los Angeles Clippers,115
Mon Feb 9 2015,0,Denver Nuggets,-10,114,9:00 pm,Oklahoma City Thunder,124
Mon Feb 9 2015,0,Indiana Pacers,-2,93,7:00 pm,San Antonio Spurs,95
Mon Feb 9 2015,1,Miami Heat,14,109,7:30 pm,New York Knicks,95
Mon Feb 9 2015,1,Milwaukee Bucks,6,103,8:00 pm,Brooklyn Nets,97
Mon Feb 9 2015,0,Minnesota Timberwolves,-12,105,8:00 pm,Atlanta Hawks,117
Mon Feb 9 2015,0,New Orleans Pelicans,-4,96,8:00 pm,Utah Jazz,100
Mon Feb 9 2015,0,Philadelphia 76ers,-5,84,7:00 pm,Golden State Warriors,89
Mon Feb 9 2015,1,Washington Wizards,16,96,7:00 pm,Orlando Magic,80
Tue Feb 10 2015,1,Chicago Bulls,18,104,8:00 pm,Sacramento Kings,86
Tue Feb 10 2015,0,Charlotte Hornets,-28,78,7:00 pm,Detroit Pistons,106
Tue Feb 10 2015,0,Los Angeles Lakers,-10,96,10:30 pm,Denver Nuggets,106
Tue Feb 10 2015,1,Memphis Grizzlies,9,95,8:00 pm,Brooklyn Nets,86
Tue Feb 10 2015,0,Phoenix Suns,-9,118,8:00 pm,Houston Rockets,127
Wed Feb 11 2015,1,Boston Celtics,1,89,7:30 pm,Atlanta Hawks,88
Wed Feb 11 2015,1,Cleveland Cavaliers,20,113,8:00 pm,Miami Heat,93
Wed Feb 11 2015,1,Dallas Mavericks,5,87,8:30 pm,Utah Jazz,82
Wed Feb 11 2015,0,Detroit Pistons,-17,87,7:30 pm,San Antonio Spurs,104
Wed Feb 11 2015,1,Los Angeles Clippers,15,110,10:30 pm,Houston Rockets,95
Wed Feb 11 2015,1,Milwaukee Bucks,8,111,8:00 pm,Sacramento Kings,103
Wed Feb 11 2015,0,Minnesota Timberwolves,-3,91,8:00 pm,Golden State Warriors,94
Wed Feb 11 2015,0,New Orleans Pelicans,-13,93,8:00 pm,Indiana Pacers,106
Wed Feb 11 2015,1,Oklahoma City Thunder,16,105,8:00 pm,Memphis Grizzlies,89
Wed Feb 11 2015,1,Orlando Magic,6,89,7:00 pm,New York Knicks,83
Wed Feb 11 2015,1,Portland Trail Blazers,16,102,10:00 pm,Los Angeles Lakers,86
Wed Feb 11 2015,1,Toronto Raptors,2,95,7:30 pm,Washington Wizards,93
Thu Feb 12 2015,1,Chicago Bulls,15,113,8:00 pm,Cleveland Cavaliers,98
Thu Feb 19 2015,1,Los Angeles Clippers,4,119,10:30 pm,San Antonio Spurs,115
Thu Feb 19 2015,1,Oklahoma City Thunder,15,104,8:00 pm,Dallas Mavericks,89
Fri Feb 20 2015,0,Atlanta Hawks,-25,80,7:30 pm,Toronto Raptors,105
Fri Feb 20 2015,1,Dallas Mavericks,11,111,8:30 pm,Houston Rockets,100
Fri Feb 20 2015,1,Detroit Pistons,9,100,7:30 pm,Chicago Bulls,91
Fri Feb 20 2015,1,Golden State Warriors,11,110,10:30 pm,San Antonio Spurs,99
Fri Feb 20 2015,0,Los Angeles Lakers,-9,105,10:30 pm,Brooklyn Nets,114
Fri Feb 20 2015,1,Milwaukee Bucks,8,89,8:30 pm,Denver Nuggets,81
Fri Feb 20 2015,1,Minnesota Timberwolves,2,111,8:00 pm,Phoenix Suns,109
Fri Feb 20 2015,0,New York Knicks,-24,87,7:30 pm,Miami Heat,111
Fri Feb 20 2015,1,Orlando Magic,11,95,7:00 pm,New Orleans Pelicans,84
Fri Feb 20 2015,0,Philadelphia 76ers,-11,95,7:00 pm,Indiana Pacers,106
Fri Feb 20 2015,1,Sacramento Kings,8,109,10:00 pm,Boston Celtics,101
Fri Feb 20 2015,1,Utah Jazz,16,92,9:00 pm,Portland Trail Blazers,76
Fri Feb 20 2015,0,Washington Wizards,-38,89,8:00 pm,Cleveland Cavaliers,127
Sat Feb 21 2015,1,Chicago Bulls,5,112,8:00 pm,Phoenix Suns,107
Sat Feb 21 2015,0,Charlotte Hornets,-7,103,7:00 pm,Oklahoma City Thunder,110
Sat Feb 21 2015,1,Houston Rockets,22,98,8:00 pm,Toronto Raptors,76
Sat Feb 21 2015,1,Los Angeles Clippers,27,126,10:00 pm,Sacramento Kings,99
Sat Feb 21 2015,0,Miami Heat,-14,91,7:30 pm,New Orleans Pelicans,105
Sun Feb 22 2015,1,Dallas Mavericks,11,92,7:30 pm,Charlotte Hornets,81
Sun Feb 22 2015,1,Detroit Pistons,17,106,3:30 pm,Washington Wizards,89
Sun Feb 22 2015,1,Indiana Pacers,6,104,6:00 pm,Golden State Warriors,98
Sun Feb 22 2015,1,Los Angeles Lakers,7,118,9:30 pm,Boston Celtics,111
Sun Feb 22 2015,0,Milwaukee Bucks,-11,86,3:30 pm,Atlanta Hawks,97
Sun Feb 22 2015,0,New York Knicks,-18,83,1:00 pm,Cleveland Cavaliers,101
Sun Feb 22 2015,1,Oklahoma City Thunder,25,119,7:00 pm,Denver Nuggets,94
Sun Feb 22 2015,1,Orlando Magic,5,103,6:00 pm,Philadelphia 76ers,98
Sun Feb 22 2015,0,Portland Trail Blazers,-6,92,9:00 pm,Memphis Grizzlies,98
Mon Feb 23 2015,1,Chicago Bulls,16,87,8:00 pm,Milwaukee Bucks,71
Mon Feb 23 2015,0,Denver Nuggets,-28,82,9:00 pm,Brooklyn Nets,110
Mon Feb 23 2015,1,Houston Rockets,11,113,8:00 pm,Minnesota Timberwolves,102
Mon Feb 23 2015,0,Los Angeles Clippers,-3,87,10:30 pm,Memphis Grizzlies,90
Mon Feb 23 2015,1,Miami Heat,11,119,7:30 pm,Philadelphia 76ers,108
Mon Feb 23 2015,1,New Orleans Pelicans,3,100,8:00 pm,Toronto Raptors,97
Mon Feb 23 2015,0,Phoenix Suns,-5,110,9:00 pm,Boston Celtics,115
Mon Feb 23 2015,1,Utah Jazz,9,90,9:00 pm,San Antonio Spurs,81
Tue Feb 24 2015,1,Dallas Mavericks,7,99,8:30 pm,Toronto Raptors,92
Tue Feb 24 2015,0,Detroit Pistons,-9,93,7:30 pm,Cleveland Cavaliers,102
Tue Feb 24 2015,1,Oklahoma City Thunder,13,105,8:00 pm,Indiana Pacers,92
Tue Feb 24 2015,0,Washington Wizards,-7,107,7:00 pm,Golden State Warriors,114
Wed Feb 25 2015,1,Atlanta Hawks,17,104,7:30 pm,Dallas Mavericks,87
Wed Feb 25 2015,1,Boston Celtics,21,115,7:30 pm,New York Knicks,94
Wed Feb 25 2015,0,Chicago Bulls,-12,86,8:00 pm,Charlotte Hornets,98
Wed Feb 25 2015,0,Denver Nuggets,-14,96,9:00 pm,Phoenix Suns,110
Wed Feb 25 2015,1,Houston Rockets,5,110,8:00 pm,Los Angeles Clippers,105
Wed Feb 25 2015,1,Milwaukee Bucks,16,104,8:00 pm,Philadelphia 76ers,88
Wed Feb 25 2015,1,Minnesota Timberwolves,20,97,8:00 pm,Washington Wizards,77
Wed Feb 25 2015,1,New Orleans Pelicans,6,102,8:00 pm,Brooklyn Nets,96
Wed Feb 25 2015,0,Orlando Magic,-3,90,7:00 pm,Miami Heat,93
Wed Feb 25 2015,1,Portland Trail Blazers,16,111,10:30 pm,San Antonio Spurs,95
Wed Feb 25 2015,1,Sacramento Kings,12,102,10:00 pm,Memphis Grizzlies,90
Wed Feb 25 2015,0,Utah Jazz,-3,97,9:00 pm,Los Angeles Lakers,100
Thu Feb 26 2015,1,Cleveland Cavaliers,11,110,8:00 pm,Golden State Warriors,99
Thu Feb 26 2015,1,Phoenix Suns,4,117,10:30 pm,Oklahoma City Thunder,113
Fri Feb 27 2015,1,Atlanta Hawks,7,95,7:30 pm,Orlando Magic,88
Fri Feb 27 2015,1,Boston Celtics,8,106,7:30 pm,Charlotte Hornets,98
Fri Feb 27 2015,1,Chicago Bulls,7,96,8:00 pm,Minnesota Timberwolves,89
Fri Feb 27 2015,0,Denver Nuggets,-22,82,9:00 pm,Utah Jazz,104
Fri Feb 27 2015,0,Detroit Pistons,-6,115,7:30 pm,New York Knicks,121
Fri Feb 27 2015,1,Houston Rockets,4,102,8:00 pm,Brooklyn Nets,98
Fri Feb 27 2015,1,Indiana Pacers,7,93,7:00 pm,Cleveland Cavaliers,86
Fri Feb 27 2015,1,Los Angeles Lakers,8,101,10:30 pm,Milwaukee Bucks,93
Fri Feb 27 2015,0,Memphis Grizzlies,-18,79,8:00 pm,Los Angeles Clippers,97
Fri Feb 27 2015,1,New Orleans Pelicans,2,104,8:00 pm,Miami Heat,102
Fri Feb 27 2015,1,Philadelphia 76ers,8,89,7:00 pm,Washington Wizards,81
Fri Feb 27 2015,1,Portland Trail Blazers,3,115,10:30 pm,Oklahoma City Thunder,112
Fri Feb 27 2015,0,Sacramento Kings,-11,96,10:00 pm,San Antonio Spurs,107
Fri Feb 27 2015,0,Toronto Raptors,-24,89,7:30 pm,Golden State Warriors,113
Sat Feb 28 2015,0,Dallas Mavericks,-10,94,8:30 pm,Brooklyn Nets,104
Sat Feb 28 2015,0,Miami Heat,-2,91,7:30 pm,Atlanta Hawks,93
Sat Feb 28 2015,0,Minnesota Timberwolves,-4,97,8:00 pm,Memphis Grizzlies,101
Sat Feb 28 2015,1,New York Knicks,5,103,7:30 pm,Toronto Raptors,98
Sat Feb 28 2015,0,Phoenix Suns,-27,74,9:00 pm,San Antonio Spurs,101
Sat Feb 28 2015,1,Utah Jazz,7,82,9:00 pm,Milwaukee Bucks,75
Sat Feb 28 2015,1,Washington Wizards,4,99,7:00 pm,Detroit Pistons,95
Sun Mar 1 2015,0,Boston Celtics,-5,101,6:00 pm,Golden State Warriors,106
Sun Mar 1 2015,0,Chicago Bulls,-10,86,1:00 pm,Los Angeles Clippers,96
Sun Mar 1 2015,0,Denver Nuggets,-7,92,8:00 pm,New Orleans Pelicans,99
Sun Mar 1 2015,1,Houston Rockets,2,105,3:30 pm,Cleveland Cavaliers,103
Sun Mar 1 2015,1,Indiana Pacers,20,94,6:00 pm,Philadelphia 76ers,74
Sun Mar 1 2015,0,Los Angeles Lakers,-7,101,6:30 pm,Oklahoma City Thunder,108
Sun Mar 1 2015,0,Orlando Magic,-15,83,6:00 pm,Charlotte Hornets,98
Sun Mar 1 2015,0,Sacramento Kings,-11,99,6:00 pm,Portland Trail Blazers,110
Mon Mar 2 2015,1,Brooklyn Nets,2,110,7:30 pm,Golden State Warriors,108
Mon Mar 2 2015,1,Dallas Mavericks,9,102,8:30 pm,New Orleans Pelicans,93
Mon Mar 2 2015,1,Miami Heat,17,115,7:30 pm,Phoenix Suns,98
Mon Mar 2 2015,0,Minnesota Timberwolves,-5,105,8:00 pm,Los Angeles Clippers,110
Mon Mar 2 2015,0,Philadelphia 76ers,-11,103,7:00 pm,Toronto Raptors,114
Tue Mar 3 2015,1,Atlanta Hawks,8,104,7:30 pm,Houston Rockets,96
Tue Mar 3 2015,1,Chicago Bulls,5,97,8:00 pm,Washington Wizards,92
Tue Mar 3 2015,1,Charlotte Hornets,1,104,7:00 pm,Los Angeles Lakers,103
Tue Mar 3 2015,1,Cleveland Cavaliers,31,110,7:00 pm,Boston Celtics,79
Tue Mar 3 2015,1,Denver Nuggets,11,106,9:00 pm,Milwaukee Bucks,95
Tue Mar 3 2015,0,Memphis Grizzlies,-11,82,8:00 pm,Utah Jazz,93
Tue Mar 3 2015,0,New York Knicks,-38,86,7:00 pm,Sacramento Kings,124
Wed Mar 4 2015,1,Boston Celtics,1,85,7:30 pm,Utah Jazz,84
Wed Mar 4 2015,0,Brooklyn Nets,-24,91,7:30 pm,Charlotte Hornets,115
Wed Mar 4 2015,1,Golden State Warriors,9,102,10:30 pm,Milwaukee Bucks,93
Wed Mar 4 2015,0,Houston Rockets,-2,100,8:00 pm,Memphis Grizzlies,102
Wed Mar 4 2015,1,Indiana Pacers,23,105,7:00 pm,New York Knicks,82
Wed Mar 4 2015,0,Los Angeles Clippers,-5,93,10:30 pm,Portland Trail Blazers,98
Wed Mar 4 2015,1,Miami Heat,6,100,8:00 pm,Los Angeles Lakers,94
Wed Mar 4 2015,0,Minnesota Timberwolves,-15,85,8:00 pm,Denver Nuggets,100
Wed Mar 4 2015,1,New Orleans Pelicans,3,88,8:00 pm,Detroit Pistons,85
Wed Mar 4 2015,1,Oklahoma City Thunder,5,123,8:00 pm,Philadelphia 76ers,118
Wed Mar 4 2015,0,Orlando Magic,-5,100,7:00 pm,Phoenix Suns,105
Wed Mar 4 2015,1,San Antonio Spurs,27,112,8:30 pm,Sacramento Kings,85
Wed Mar 4 2015,0,Toronto Raptors,-8,112,7:30 pm,Cleveland Cavaliers,120
Thu Mar 5 2015,1,Chicago Bulls,3,108,8:00 pm,Oklahoma City Thunder,105
Thu Mar 5 2015,1,Portland Trail Blazers,19,94,10:30 pm,Dallas Mavericks,75
Fri Mar 6 2015,1,Atlanta Hawks,9,106,7:30 pm,Cleveland Cavaliers,97
Fri Mar 6 2015,0,Brooklyn Nets,-8,100,8:00 pm,Phoenix Suns,108
Fri Mar 6 2015,1,Charlotte Hornets,9,103,7:00 pm,Toronto Raptors,94
Fri Mar 6 2015,1,Golden State Warriors,15,104,10:30 pm,Dallas Mavericks,89
Fri Mar 6 2015,1,Houston Rockets,10,103,8:00 pm,Detroit Pistons,93
Fri Mar 6 2015,1,Indiana Pacers,14,98,7:00 pm,Chicago Bulls,84
Fri Mar 6 2015,1,Memphis Grizzlies,7,97,8:00 pm,Los Angeles Lakers,90
Fri Mar 6 2015,0,New Orleans Pelicans,-6,98,8:00 pm,Boston Celtics,104
Fri Mar 6 2015,1,Orlando Magic,5,119,7:00 pm,Sacramento Kings,114
Fri Mar 6 2015,0,Philadelphia 76ers,-6,83,7:00 pm,Utah Jazz,89
Fri Mar 6 2015,1,San Antonio Spurs,9,120,8:30 pm,Denver Nuggets,111
Fri Mar 6 2015,1,Washington Wizards,2,99,7:00 pm,Miami Heat,97
Sat Mar 7 2015,1,Cleveland Cavaliers,10,89,7:30 pm,Phoenix Suns,79
Sat Mar 7 2015,0,Denver Nuggets,-14,100,9:00 pm,Houston Rockets,114
Sat Mar 7 2015,1,Miami Heat,5,114,7:30 pm,Sacramento Kings,109
Sat Mar 7 2015,1,Milwaukee Bucks,6,91,8:30 pm,Washington Wizards,85
Sat Mar 7 2015,1,Minnesota Timberwolves,8,121,8:00 pm,Portland Trail Blazers,113
Sat Mar 7 2015,1,New Orleans Pelicans,6,95,7:00 pm,Memphis Grizzlies,89
Sat Mar 7 2015,0,New York Knicks,-6,86,7:30 pm,Indiana Pacers,92
Sat Mar 7 2015,1,Philadelphia 76ers,8,92,7:30 pm,Atlanta Hawks,84
Sun Mar 8 2015,0,Brooklyn Nets,-7,88,6:00 pm,Utah Jazz,95
Sun Mar 8 2015,0,Detroit Pistons,-7,101,6:00 pm,Charlotte Hornets,108
Sun Mar 8 2015,1,Golden State Warriors,8,106,3:30 pm,Los Angeles Clippers,98
Sun Mar 8 2015,0,Los Angeles Lakers,-7,93,9:30 pm,Dallas Mavericks,100
Sun Mar 8 2015,1,Oklahoma City Thunder,4,108,7:00 pm,Toronto Raptors,104
Sun Mar 8 2015,1,Orlando Magic,5,103,6:00 pm,Boston Celtics,98
Sun Mar 8 2015,1,San Antonio Spurs,11,116,1:00 pm,Chicago Bulls,105
Mon Mar 9 2015,1,Atlanta Hawks,25,130,7:30 pm,Sacramento Kings,105
Mon Mar 9 2015,0,Chicago Bulls,-10,91,8:00 pm,Memphis Grizzlies,101
Mon Mar 9 2015,0,Charlotte Hornets,-26,69,7:00 pm,Washington Wizards,95
Mon Mar 9 2015,1,Denver Nuggets,28,106,9:00 pm,New York Knicks,78
Mon Mar 9 2015,1,Los Angeles Clippers,13,89,10:30 pm,Minnesota Timberwolves,76
Mon Mar 9 2015,0,Miami Heat,-10,90,7:30 pm,Boston Celtics,100
Mon Mar 9 2015,0,Milwaukee Bucks,-11,103,8:00 pm,New Orleans Pelicans,114
Mon Mar 9 2015,0,Phoenix Suns,-18,80,10:00 pm,Golden State Warriors,98
Tue Mar 10 2015,0,Brooklyn Nets,-20,91,7:30 pm,New Orleans Pelicans,111
Tue Mar 10 2015,0,Dallas Mavericks,-33,94,8:30 pm,Cleveland Cavaliers,127
Tue Mar 10 2015,1,Indiana Pacers,32,118,7:00 pm,Orlando Magic,86
Tue Mar 10 2015,1,Los Angeles Lakers,8,93,10:30 pm,Detroit Pistons,85
Tue Mar 10 2015,1,San Antonio Spurs,10,117,8:30 pm,Toronto Raptors,107
Tue Mar 10 2015,1,Utah Jazz,5,87,9:00 pm,New York Knicks,82
Wed Mar 11 2015,1,Boston Celtics,3,95,7:30 pm,Memphis Grizzlies,92
Wed Mar 11 2015,0,Charlotte Hornets,-7,106,7:00 pm,Sacramento Kings,113
Wed Mar 11 2015,1,Denver Nuggets,13,115,9:00 pm,Atlanta Hawks,102
Wed Mar 11 2015,1,Golden State Warriors,7,105,10:30 pm,Detroit Pistons,98
Wed Mar 11 2015,1,Miami Heat,6,104,7:30 pm,Brooklyn Nets,98
Wed Mar 11 2015,1,Milwaukee Bucks,6,97,8:00 pm,Orlando Magic,91
Wed Mar 11 2015,0,Oklahoma City Thunder,-12,108,8:00 pm,Los Angeles Clippers,120
Wed Mar 11 2015,0,Philadelphia 76ers,-9,95,7:00 pm,Chicago Bulls,104
Wed Mar 11 2015,1,Phoenix Suns,9,106,10:00 pm,Minnesota Timberwolves,97
Wed Mar 11 2015,1,Portland Trail Blazers,5,105,10:30 pm,Houston Rockets,100
Thu Mar 12 2015,1,Indiana Pacers,6,109,7:00 pm,Milwaukee Bucks,103
Thu Mar 12 2015,0,Los Angeles Lakers,-7,94,10:30 pm,New York Knicks,101
Thu Mar 12 2015,0,San Antonio Spurs,-3,125,9:30 pm,Cleveland Cavaliers,128
Thu Mar 12 2015,1,Utah Jazz,18,109,9:00 pm,Houston Rockets,91
Thu Mar 12 2015,1,Washington Wizards,20,107,7:00 pm,Memphis Grizzlies,87
Fri Mar 13 2015,1,Boston Celtics,7,95,7:30 pm,Orlando Magic,88
Fri Mar 13 2015,1,Charlotte Hornets,10,101,7:00 pm,Chicago Bulls,91
Fri Mar 13 2015,1,Dallas Mavericks,30,129,8:30 pm,Los Angeles Clippers,99
Fri Mar 13 2015,1,Denver Nuggets,11,114,9:00 pm,Golden State Warriors,103
Fri Mar 13 2015,1,Oklahoma City Thunder,14,113,8:00 pm,Minnesota Timberwolves,99
Fri Mar 13 2015,1,Philadelphia 76ers,7,114,7:00 pm,Sacramento Kings,107
Fri Mar 13 2015,0,Phoenix Suns,-9,87,10:00 pm,Atlanta Hawks,96
Fri Mar 13 2015,1,Portland Trail Blazers,19,118,10:00 pm,Detroit Pistons,99
Fri Mar 13 2015,1,Toronto Raptors,10,102,7:30 pm,Miami Heat,92
Sat Mar 14 2015,1,Golden State Warriors,31,125,10:30 pm,New York Knicks,94
Sat Mar 14 2015,0,Indiana Pacers,-4,89,7:00 pm,Boston Celtics,93
Sat Mar 14 2015,1,Memphis Grizzlies,13,96,8:00 pm,Milwaukee Bucks,83
Sat Mar 14 2015,0,Philadelphia 76ers,-7,87,7:30 pm,Brooklyn Nets,94
Sat Mar 14 2015,1,Utah Jazz,3,88,9:00 pm,Detroit Pistons,85
Sat Mar 14 2015,1,Washington Wizards,16,113,7:00 pm,Sacramento Kings,97
Sun Mar 15 2015,0,Los Angeles Clippers,-2,98,3:30 pm,Houston Rockets,100
Sun Mar 15 2015,0,Los Angeles Lakers,-5,86,9:30 pm,Atlanta Hawks,91
Sun Mar 15 2015,0,New Orleans Pelicans,-7,111,6:00 pm,Denver Nuggets,118
Sun Mar 15 2015,1,Oklahoma City Thunder,9,109,1:00 pm,Chicago Bulls,100
Sun Mar 15 2015,0,Orlando Magic,-15,108,6:00 pm,Cleveland Cavaliers,123
Sun Mar 15 2015,1,Phoenix Suns,13,102,9:00 pm,New York Knicks,89
Sun Mar 15 2015,1,San Antonio Spurs,26,123,7:00 pm,Minnesota Timberwolves,97
Sun Mar 15 2015,0,Toronto Raptors,-16,97,7:00 pm,Portland Trail Blazers,113
Mon Mar 16 2015,1,Boston Celtics,19,108,7:30 pm,Philadelphia 76ers,89
Mon Mar 16 2015,1,Dallas Mavericks,4,119,8:30 pm,Oklahoma City Thunder,115
Mon Mar 16 2015,1,Golden State Warriors,3,108,10:30 pm,Los Angeles Lakers,105
Mon Mar 16 2015,0,Indiana Pacers,-19,98,7:00 pm,Toronto Raptors,117
Mon Mar 16 2015,1,Memphis Grizzlies,11,92,8:00 pm,Denver Nuggets,81
Mon Mar 16 2015,1,Miami Heat,14,106,8:00 pm,Cleveland Cavaliers,92
Mon Mar 16 2015,0,Minnesota Timberwolves,-16,106,8:00 pm,Brooklyn Nets,122
Mon Mar 16 2015,0,Sacramento Kings,-7,103,10:00 pm,Atlanta Hawks,110
Mon Mar 16 2015,1,Utah Jazz,28,94,9:00 pm,Charlotte Hornets,66
Mon Mar 16 2015,1,Washington Wizards,8,105,7:00 pm,Portland Trail Blazers,97
Tue Mar 17 2015,1,Detroit Pistons,10,105,7:30 pm,Memphis Grizzlies,95
Tue Mar 17 2015,1,Houston Rockets,13,107,8:00 pm,Orlando Magic,94
Tue Mar 17 2015,1,Los Angeles Clippers,7,99,10:30 pm,Charlotte Hornets,92
Tue Mar 17 2015,1,New Orleans Pelicans,1,85,8:00 pm,Milwaukee Bucks,84
Tue Mar 17 2015,1,New York Knicks,4,104,7:30 pm,San Antonio Spurs,100
Wed Mar 18 2015,1,Chicago Bulls,17,103,8:00 pm,Indiana Pacers,86
Wed Mar 18 2015,1,Cleveland Cavaliers,25,117,7:00 pm,Brooklyn Nets,92
Wed Mar 18 2015,1,Dallas Mavericks,5,107,8:00 pm,Orlando Magic,102
Wed Mar 18 2015,1,Golden State Warriors,19,114,10:30 pm,Atlanta Hawks,95
Wed Mar 18 2015,1,Miami Heat,4,108,7:30 pm,Portland Trail Blazers,104
Wed Mar 18 2015,0,Milwaukee Bucks,-11,103,8:00 pm,San Antonio Spurs,114
Wed Mar 18 2015,1,Oklahoma City Thunder,4,122,8:00 pm,Boston Celtics,118
Wed Mar 18 2015,1,Philadelphia 76ers,11,94,7:00 pm,Detroit Pistons,83
Wed Mar 18 2015,0,Sacramento Kings,-11,105,10:00 pm,Los Angeles Clippers,116
Wed Mar 18 2015,1,Toronto Raptors,5,105,7:30 pm,Minnesota Timberwolves,100
Wed Mar 18 2015,0,Utah Jazz,-4,84,10:30 pm,Washington Wizards,88
Thu Mar 19 2015,1,Houston Rockets,10,118,8:00 pm,Denver Nuggets,108
Thu Mar 19 2015,0,Los Angeles Lakers,-7,73,10:30 pm,Utah Jazz,80
Thu Mar 19 2015,0,New York Knicks,-3,92,7:30 pm,Minnesota Timberwolves,95
Thu Mar 19 2015,1,Phoenix Suns,2,74,10:00 pm,New Orleans Pelicans,72
Fri Mar 20 2015,1,Brooklyn Nets,2,129,7:30 pm,Milwaukee Bucks,127
Fri Mar 20 2015,1,Chicago Bulls,16,108,8:00 pm,Toronto Raptors,92
Fri Mar 20 2015,1,Cleveland Cavaliers,3,95,7:30 pm,Indiana Pacers,92
Fri Mar 20 2015,0,Dallas Mavericks,-11,101,8:30 pm,Memphis Grizzlies,112
Fri Mar 20 2015,1,Golden State Warriors,16,112,10:30 pm,New Orleans Pelicans,96
Fri Mar 20 2015,1,Los Angeles Clippers,14,113,10:30 pm,Washington Wizards,99
Fri Mar 20 2015,1,Miami Heat,17,108,7:30 pm,Denver Nuggets,91
Fri Mar 20 2015,1,Oklahoma City Thunder,8,123,8:00 pm,Atlanta Hawks,115
Fri Mar 20 2015,1,Orlando Magic,7,111,7:00 pm,Portland Trail Blazers,104
Fri Mar 20 2015,1,Philadelphia 76ers,16,97,7:00 pm,New York Knicks,81
Fri Mar 20 2015,1,Sacramento Kings,10,101,10:00 pm,Charlotte Hornets,91
Fri Mar 20 2015,1,San Antonio Spurs,12,101,8:30 pm,Boston Celtics,89
Sat Mar 21 2015,1,Detroit Pistons,16,107,7:30 pm,Chicago Bulls,91
Sat Mar 21 2015,1,Golden State Warriors,15,106,10:30 pm,Utah Jazz,91
Sat Mar 21 2015,0,Houston Rockets,-15,102,8:00 pm,Phoenix Suns,117
Sat Mar 21 2015,0,Indiana Pacers,-12,111,7:00 pm,Brooklyn Nets,123
Sat Mar 21 2015,1,Memphis Grizzlies,11,97,8:00 pm,Portland Trail Blazers,86
Sun Mar 22 2015,0,Atlanta Hawks,-19,95,3:00 pm,San Antonio Spurs,114
Sun Mar 22 2015,0,Boston Celtics,-8,97,6:00 pm,Detroit Pistons,105
Sun Mar 22 2015,1,Los Angeles Clippers,7,107,3:30 pm,New Orleans Pelicans,100
Sun Mar 22 2015,1,Los Angeles Lakers,14,101,9:30 pm,Philadelphia 76ers,87
Sun Mar 22 2015,0,Milwaukee Bucks,-18,90,3:00 pm,Cleveland Cavaliers,108
Sun Mar 22 2015,0,Minnesota Timberwolves,-11,98,7:00 pm,Charlotte Hornets,109
Sun Mar 22 2015,1,Oklahoma City Thunder,18,93,3:00 pm,Miami Heat,75
Sun Mar 22 2015,0,Orlando Magic,-19,100,6:00 pm,Denver Nuggets,119
Sun Mar 22 2015,1,Phoenix Suns,6,98,9:00 pm,Dallas Mavericks,92
Sun Mar 22 2015,1,Sacramento Kings,23,109,6:00 pm,Washington Wizards,86
Sun Mar 22 2015,1,Toronto Raptors,17,106,4:00 pm,New York Knicks,89
Mon Mar 23 2015,0,Brooklyn Nets,-19,91,7:30 pm,Boston Celtics,110
Mon Mar 23 2015,1,Chicago Bulls,12,98,8:00 pm,Charlotte Hornets,86
Mon Mar 23 2015,1,Golden State Warriors,31,107,10:30 pm,Washington Wizards,76
Mon Mar 23 2015,0,Indiana Pacers,-10,100,7:00 pm,Houston Rockets,110
Mon Mar 23 2015,0,New York Knicks,-21,82,7:30 pm,Memphis Grizzlies,103
Mon Mar 23 2015,0,Utah Jazz,-2,104,9:00 pm,Minnesota Timberwolves,106
Tue Mar 24 2015,1,Dallas Mavericks,7,101,8:00 pm,San Antonio Spurs,94
Tue Mar 24 2015,1,Detroit Pistons,4,108,7:30 pm,Toronto Raptors,104
Tue Mar 24 2015,1,Milwaukee Bucks,1,89,8:00 pm,Miami Heat,88
Tue Mar 24 2015,1,Oklahoma City Thunder,10,127,8:00 pm,Los Angeles Lakers,117
Tue Mar 24 2015,0,Portland Trail Blazers,-14,108,10:30 pm,Golden State Warriors,122
Tue Mar 24 2015,1,Sacramento Kings,1,107,10:00 pm,Philadelphia 76ers,106
Wed Mar 25 2015,0,Boston Celtics,-7,86,7:30 pm,Miami Heat,93
Wed Mar 25 2015,0,Charlotte Hornets,-3,88,7:00 pm,Brooklyn Nets,91
Wed Mar 25 2015,0,Denver Nuggets,-14,85,9:00 pm,Philadelphia 76ers,99
Wed Mar 25 2015,0,Memphis Grizzlies,-22,89,8:00 pm,Cleveland Cavaliers,111
Wed Mar 25 2015,0,Minnesota Timberwolves,-2,99,8:00 pm,Los Angeles Lakers,101
Wed Mar 25 2015,0,New Orleans Pelicans,-2,93,8:00 pm,Houston Rockets,95
Wed Mar 25 2015,0,New York Knicks,-31,80,7:00 pm,Los Angeles Clippers,111
Wed Mar 25 2015,0,Orlando Magic,-12,83,7:00 pm,Atlanta Hawks,95
Wed Mar 25 2015,0,Phoenix Suns,-9,99,10:00 pm,Sacramento Kings,108
Wed Mar 25 2015,1,San Antonio Spurs,39,130,9:30 pm,Oklahoma City Thunder,91
Wed Mar 25 2015,0,Toronto Raptors,-13,103,7:00 pm,Chicago Bulls,116
Wed Mar 25 2015,0,Utah Jazz,-3,89,9:00 pm,Portland Trail Blazers,92
Wed Mar 25 2015,0,Washington Wizards,-2,101,7:00 pm,Indiana Pacers,103
Thu Mar 26 2015,1,Milwaukee Bucks,4,111,8:00 pm,Indiana Pacers,107
Fri Mar 27 2015,1,Atlanta Hawks,13,99,7:30 pm,Miami Heat,86
Fri Mar 27 2015,1,Brooklyn Nets,8,106,7:30 pm,Cleveland Cavaliers,98
Fri Mar 27 2015,1,Denver Nuggets,16,107,9:00 pm,Utah Jazz,91
Fri Mar 27 2015,1,Houston Rockets,10,120,8:00 pm,Minnesota Timberwolves,110
Fri Mar 27 2015,0,Memphis Grizzlies,-23,84,8:00 pm,Golden State Warriors,107
Fri Mar 27 2015,1,New Orleans Pelicans,14,102,8:00 pm,Sacramento Kings,88
Fri Mar 27 2015,0,New York Knicks,-4,92,7:30 pm,Boston Celtics,96
Fri Mar 27 2015,0,Orlando Magic,-14,97,7:00 pm,Detroit Pistons,111
Fri Mar 27 2015,0,Philadelphia 76ers,-21,98,7:00 pm,Los Angeles Clippers,119
Fri Mar 27 2015,0,Phoenix Suns,-6,81,10:00 pm,Portland Trail Blazers,87
Fri Mar 27 2015,1,San Antonio Spurs,18,94,8:30 pm,Dallas Mavericks,76
Fri Mar 27 2015,1,Toronto Raptors,11,94,7:30 pm,Los Angeles Lakers,83
Fri Mar 27 2015,1,Washington Wizards,3,110,7:00 pm,Charlotte Hornets,107
Sat Mar 28 2015,1,Chicago Bulls,31,111,8:00 pm,New York Knicks,80
Sat Mar 28 2015,1,Charlotte Hornets,15,115,7:00 pm,Atlanta Hawks,100
Sat Mar 28 2015,0,Milwaukee Bucks,-13,95,8:30 pm,Golden State Warriors,108
Sat Mar 28 2015,1,Portland Trail Blazers,6,120,10:00 pm,Denver Nuggets,114
Sat Mar 28 2015,1,Utah Jazz,5,94,9:00 pm,Oklahoma City Thunder,89
Sun Mar 29 2015,0,Boston Celtics,-13,106,6:00 pm,Los Angeles Clippers,119
Sun Mar 29 2015,1,Brooklyn Nets,8,107,3:30 pm,Los Angeles Lakers,99
Sun Mar 29 2015,1,Cleveland Cavaliers,1,87,4:30 pm,Philadelphia 76ers,86
Sun Mar 29 2015,1,Indiana Pacers,5,104,7:00 pm,Dallas Mavericks,99
Sun Mar 29 2015,1,Miami Heat,7,109,6:00 pm,Detroit Pistons,102
Sun Mar 29 2015,1,New Orleans Pelicans,22,110,4:00 pm,Minnesota Timberwolves,88
Sun Mar 29 2015,0,Phoenix Suns,-12,97,9:00 pm,Oklahoma City Thunder,109
Sun Mar 29 2015,1,San Antonio Spurs,14,103,7:00 pm,Memphis Grizzlies,89
Sun Mar 29 2015,0,Washington Wizards,-8,91,12:30 pm,Houston Rockets,99
Mon Mar 30 2015,1,Atlanta Hawks,13,101,7:30 pm,Milwaukee Bucks,88
Mon Mar 30 2015,0,Charlotte Hornets,-12,104,7:00 pm,Boston Celtics,116
Mon Mar 30 2015,1,Memphis Grizzlies,14,97,8:00 pm,Sacramento Kings,83
Mon Mar 30 2015,0,Minnesota Timberwolves,-20,84,8:00 pm,Utah Jazz,104
Mon Mar 30 2015,0,Philadelphia 76ers,-2,111,7:00 pm,Los Angeles Lakers,113
Mon Mar 30 2015,1,Portland Trail Blazers,23,109,10:00 pm,Phoenix Suns,86
Mon Mar 30 2015,1,Toronto Raptors,3,99,7:30 pm,Houston Rockets,96
Tue Mar 31 2015,1,Brooklyn Nets,5,111,7:30 pm,Indiana Pacers,106
Tue Mar 31 2015,1,Detroit Pistons,10,105,7:30 pm,Atlanta Hawks,95
Tue Mar 31 2015,0,Los Angeles Clippers,-4,106,10:30 pm,Golden State Warriors,110
Tue Mar 31 2015,0,Miami Heat,-14,81,8:00 pm,San Antonio Spurs,95
Tue Oct 29 2013,1,Indiana Pacers,10,97,7:00 pm,Orlando Magic,87
Tue Oct 29 2013,1,Los Angeles Lakers,13,116,10:30 pm,Los Angeles Clippers,103
Tue Oct 29 2013,1,Miami Heat,12,107,8:00 pm,Chicago Bulls,95
Wed Oct 30 2013,1,Cleveland Cavaliers,4,98,7:00 pm,Brooklyn Nets,94
Wed Oct 30 2013,1,Dallas Mavericks,9,118,8:30 pm,Atlanta Hawks,109
Wed Oct 30 2013,1,Detroit Pistons,11,113,7:30 pm,Washington Wizards,102
Wed Oct 30 2013,1,Golden State Warriors,31,125,10:30 pm,Los Angeles Lakers,94
Wed Oct 30 2013,1,Houston Rockets,13,96,8:00 pm,Charlotte Bobcats,83
Wed Oct 30 2013,1,Minnesota Timberwolves,5,120,8:00 pm,Orlando Magic,115
Wed Oct 30 2013,0,New Orleans Pelicans,-5,90,8:00 pm,Indiana Pacers,95
Wed Oct 30 2013,1,New York Knicks,7,90,7:30 pm,Milwaukee Bucks,83
Wed Oct 30 2013,1,Philadelphia 76ers,4,114,7:00 pm,Miami Heat,110
Wed Oct 30 2013,1,Phoenix Suns,13,104,10:00 pm,Portland Trail Blazers,91
Wed Oct 30 2013,1,Sacramento Kings,2,90,10:00 pm,Denver Nuggets,88
Wed Oct 30 2013,1,San Antonio Spurs,7,101,8:30 pm,Memphis Grizzlies,94
Wed Oct 30 2013,1,Toronto Raptors,6,93,7:00 pm,Boston Celtics,87
Wed Oct 30 2013,0,Utah Jazz,-3,98,9:00 pm,Oklahoma City Thunder,101
Thu Oct 31 2013,1,Chicago Bulls,1,82,8:00 pm,New York Knicks,81
Thu Oct 31 2013,1,Los Angeles Clippers,11,126,10:30 pm,Golden State Warriors,115
Fri Nov 1 2013,1,Atlanta Hawks,7,102,7:30 pm,Toronto Raptors,95
Fri Nov 1 2013,0,Boston Celtics,-7,98,7:30 pm,Milwaukee Bucks,105
Fri Nov 1 2013,1,Brooklyn Nets,1,101,8:00 pm,Miami Heat,100
Fri Nov 1 2013,1,Charlotte Bobcats,6,90,7:00 pm,Cleveland Cavaliers,84
Fri Nov 1 2013,0,Denver Nuggets,-15,98,9:00 pm,Portland Trail Blazers,113
Fri Nov 1 2013,1,Houston Rockets,8,113,8:00 pm,Dallas Mavericks,105
Fri Nov 1 2013,0,Los Angeles Lakers,-6,85,10:30 pm,San Antonio Spurs,91
Fri Nov 1 2013,1,Memphis Grizzlies,3,111,8:00 pm,Detroit Pistons,108
Fri Nov 1 2013,1,Minnesota Timberwolves,19,100,8:00 pm,Oklahoma City Thunder,81
Fri Nov 1 2013,1,Orlando Magic,20,110,7:00 pm,New Orleans Pelicans,90
Fri Nov 1 2013,1,Phoenix Suns,3,87,10:00 pm,Utah Jazz,84
Fri Nov 1 2013,0,Sacramento Kings,-9,101,10:00 pm,Los Angeles Clippers,110
Fri Nov 1 2013,0,Washington Wizards,-7,102,7:00 pm,Philadelphia 76ers,109
Sat Nov 2 2013,1,Dallas Mavericks,12,111,8:30 pm,Memphis Grizzlies,99
Sat Nov 2 2013,1,Golden State Warriors,11,98,10:30 pm,Sacramento Kings,87
Sat Nov 2 2013,1,Indiana Pacers,15,89,7:00 pm,Cleveland Cavaliers,74
Sat Nov 2 2013,0,Milwaukee Bucks,-7,90,8:30 pm,Toronto Raptors,97
Sat Nov 2 2013,1,New Orleans Pelicans,21,105,8:00 pm,Charlotte Bobcats,84
Sat Nov 2 2013,1,Philadelphia 76ers,3,107,7:30 pm,Chicago Bulls,104
Sat Nov 2 2013,1,Portland Trail Blazers,10,115,10:00 pm,San Antonio Spurs,105
Sat Nov 2 2013,0,Utah Jazz,-11,93,9:00 pm,Houston Rockets,104
Sun Nov 3 2013,1,Detroit Pistons,10,87,6:00 pm,Boston Celtics,77
Sun Nov 3 2013,1,Los Angeles Lakers,2,105,9:30 pm,Atlanta Hawks,103
Sun Nov 3 2013,1,Miami Heat,10,103,6:00 pm,Washington Wizards,93
Sun Nov 3 2013,0,New York Knicks,-9,100,7:30 pm,Minnesota Timberwolves,109
Sun Nov 3 2013,1,Oklahoma City Thunder,7,103,7:00 pm,Phoenix Suns,96
Sun Nov 3 2013,1,Orlando Magic,21,107,6:00 pm,Brooklyn Nets,86
Mon Nov 4 2013,1,Cleveland Cavaliers,1,93,7:00 pm,Minnesota Timberwolves,92
Mon Nov 4 2013,1,Los Angeles Clippers,19,137,10:30 pm,Houston Rockets,118
Mon Nov 4 2013,1,Memphis Grizzlies,7,95,8:00 pm,Boston Celtics,88
Mon Nov 4 2013,0,Philadelphia 76ers,-20,90,7:00 pm,Golden State Warriors,110
Tue Nov 5 2013,1,Brooklyn Nets,16,104,7:30 pm,Utah Jazz,88
Tue Nov 5 2013,1,Dallas Mavericks,19,123,8:30 pm,Los Angeles Lakers,104
Tue Nov 5 2013,0,Denver Nuggets,-8,94,9:00 pm,San Antonio Spurs,102
Tue Nov 5 2013,0,Detroit Pistons,-8,91,7:30 pm,Indiana Pacers,99
Tue Nov 5 2013,0,New Orleans Pelicans,-6,98,8:00 pm,Phoenix Suns,104
Tue Nov 5 2013,0,New York Knicks,-5,97,7:30 pm,Charlotte Bobcats,102
Tue Nov 5 2013,0,Portland Trail Blazers,-15,101,10:00 pm,Houston Rockets,116
Tue Nov 5 2013,0,Sacramento Kings,-5,100,10:00 pm,Atlanta Hawks,105
Tue Nov 5 2013,0,Toronto Raptors,-9,95,7:00 pm,Miami Heat,104
Wed Nov 6 2013,1,Boston Celtics,10,97,7:30 pm,Utah Jazz,87
Wed Nov 6 2013,1,Charlotte Bobcats,2,92,7:00 pm,Toronto Raptors,90
Wed Nov 6 2013,1,Indiana Pacers,17,97,7:00 pm,Chicago Bulls,80
Wed Nov 6 2013,0,Memphis Grizzlies,-15,84,8:00 pm,New Orleans Pelicans,99
Wed Nov 6 2013,1,Milwaukee Bucks,5,109,8:00 pm,Cleveland Cavaliers,104
Wed Nov 6 2013,0,Minnesota Timberwolves,-13,93,8:00 pm,Golden State Warriors,106
Wed Nov 6 2013,1,Oklahoma City Thunder,14,107,9:30 pm,Dallas Mavericks,93
Wed Nov 6 2013,1,Orlando Magic,8,98,7:00 pm,Los Angeles Clippers,90
Wed Nov 6 2013,0,Philadelphia 76ers,-14,102,7:00 pm,Washington Wizards,116
Wed Nov 6 2013,1,San Antonio Spurs,3,99,8:30 pm,Phoenix Suns,96
Thu Nov 7 2013,1,Denver Nuggets,2,109,9:00 pm,Atlanta Hawks,107
Thu Nov 7 2013,0,Houston Rockets,-1,98,9:30 pm,Los Angeles Lakers,99
Thu Nov 7 2013,1,Miami Heat,5,102,7:00 pm,Los Angeles Clippers,97
Fri Nov 8 2013,0,Charlotte Bobcats,-10,91,7:00 pm,New York Knicks,101
Fri Nov 8 2013,1,Chicago Bulls,24,97,8:00 pm,Utah Jazz,73
Fri Nov 8 2013,0,Detroit Pistons,-9,110,7:30 pm,Oklahoma City Thunder,119
Fri Nov 8 2013,1,Indiana Pacers,7,91,7:00 pm,Toronto Raptors,84
Fri Nov 8 2013,1,Minnesota Timberwolves,8,116,8:00 pm,Dallas Mavericks,108
Fri Nov 8 2013,1,New Orleans Pelicans,11,96,8:00 pm,Los Angeles Lakers,85
Fri Nov 8 2013,0,Orlando Magic,-2,89,7:00 pm,Boston Celtics,91
Fri Nov 8 2013,1,Philadelphia 76ers,15,94,7:00 pm,Cleveland Cavaliers,79
Fri Nov 8 2013,1,Phoenix Suns,11,114,9:00 pm,Denver Nuggets,103
Fri Nov 8 2013,1,Portland Trail Blazers,13,104,10:00 pm,Sacramento Kings,91
Fri Nov 8 2013,1,San Antonio Spurs,2,76,8:30 pm,Golden State Warriors,74
Fri Nov 8 2013,1,Washington Wizards,4,112,7:00 pm,Brooklyn Nets,108
Sat Nov 9 2013,1,Atlanta Hawks,10,104,7:30 pm,Orlando Magic,94
Sat Nov 9 2013,0,Brooklyn Nets,-5,91,7:30 pm,Indiana Pacers,96
Sat Nov 9 2013,1,Cleveland Cavaliers,2,127,7:30 pm,Philadelphia 76ers,125
Sat Nov 9 2013,0,Houston Rockets,-13,94,8:00 pm,Los Angeles Clippers,107
Sat Nov 9 2013,1,Memphis Grizzlies,18,108,8:00 pm,Golden State Warriors,90
Sat Nov 9 2013,0,Miami Heat,-1,110,7:30 pm,Boston Celtics,111
Sat Nov 9 2013,0,Milwaukee Bucks,-8,83,8:30 pm,Dallas Mavericks,91
Sat Nov 9 2013,0,Sacramento Kings,-11,85,10:00 pm,Portland Trail Blazers,96
Sat Nov 9 2013,1,Toronto Raptors,24,115,7:00 pm,Utah Jazz,91
Sun Nov 10 2013,0,Los Angeles Lakers,-23,90,9:30 pm,Minnesota Timberwolves,113
Sun Nov 10 2013,0,New York Knicks,-31,89,12:00 am,San Antonio Spurs,120
Sun Nov 10 2013,1,Oklahoma City Thunder,1,106,7:00 pm,Washington Wizards,105
Sun Nov 10 2013,1,Phoenix Suns,7,101,8:00 pm,New Orleans Pelicans,94
Mon Nov 11 2013,1,Boston Celtics,15,120,7:30 pm,Orlando Magic,105
Mon Nov 11 2013,0,Charlotte Bobcats,-9,94,7:00 pm,Atlanta Hawks,103
Mon Nov 11 2013,1,Chicago Bulls,15,96,8:00 pm,Cleveland Cavaliers,81
Mon Nov 11 2013,1,Houston Rockets,6,110,8:00 pm,Toronto Raptors,104
Mon Nov 11 2013,1,Indiana Pacers,16,95,7:00 pm,Memphis Grizzlies,79
Mon Nov 11 2013,1,Los Angeles Clippers,2,109,10:30 pm,Minnesota Timberwolves,107
Mon Nov 11 2013,0,Philadelphia 76ers,-24,85,7:00 pm,San Antonio Spurs,109
Mon Nov 11 2013,1,Portland Trail Blazers,6,109,10:00 pm,Detroit Pistons,103
Mon Nov 11 2013,0,Utah Jazz,-19,81,9:00 pm,Denver Nuggets,100
Tue Nov 12 2013,1,Dallas Mavericks,10,105,8:30 pm,Washington Wizards,95
Tue Nov 12 2013,1,Golden State Warriors,18,113,10:30 pm,Detroit Pistons,95
Tue Nov 12 2013,1,Los Angeles Lakers,21,116,10:30 pm,New Orleans Pelicans,95
Tue Nov 12 2013,1,Miami Heat,23,118,7:30 pm,Milwaukee Bucks,95
Wed Nov 13 2013,0,Atlanta Hawks,-4,91,8:00 pm,New York Knicks,95
Wed Nov 13 2013,0,Boston Celtics,-6,83,7:30 pm,Charlotte Bobcats,89
Wed Nov 13 2013,1,Denver Nuggets,12,111,9:00 pm,Los Angeles Lakers,99
Wed Nov 13 2013,1,Los Angeles Clippers,8,111,10:30 pm,Oklahoma City Thunder,103
Wed Nov 13 2013,0,Memphis Grizzlies,-16,87,8:00 pm,Toronto Raptors,103
Wed Nov 13 2013,1,Minnesota Timberwolves,29,124,8:00 pm,Cleveland Cavaliers,95
Wed Nov 13 2013,1,Orlando Magic,3,94,7:00 pm,Milwaukee Bucks,91
Wed Nov 13 2013,1,Philadelphia 76ers,6,123,7:00 pm,Houston Rockets,117
Wed Nov 13 2013,1,Portland Trail Blazers,1,90,10:00 pm,Phoenix Suns,89
Wed Nov 13 2013,1,Sacramento Kings,21,107,10:00 pm,Brooklyn Nets,86
Wed Nov 13 2013,1,San Antonio Spurs,13,92,8:30 pm,Washington Wizards,79
Wed Nov 13 2013,1,Utah Jazz,6,111,9:00 pm,New Orleans Pelicans,105
Thu Nov 14 2013,1,Golden State Warriors,1,116,10:30 pm,Oklahoma City Thunder,115
Thu Nov 14 2013,0,New York Knicks,-3,106,8:00 pm,Houston Rockets,109
Fri Nov 15 2013,1,Atlanta Hawks,10,113,7:30 pm,Philadelphia 76ers,103
Fri Nov 15 2013,0,Boston Celtics,-13,96,7:30 pm,Portland Trail Blazers,109
Fri Nov 15 2013,0,Cleveland Cavaliers,-6,80,7:30 pm,Charlotte Bobcats,86
Fri Nov 15 2013,1,Denver Nuggets,4,117,8:00 pm,Minnesota Timberwolves,113
Fri Nov 15 2013,1,Indiana Pacers,27,104,7:00 pm,Milwaukee Bucks,77
Fri Nov 15 2013,0,Los Angeles Lakers,-3,86,10:30 pm,Memphis Grizzlies,89
Fri Nov 15 2013,1,Miami Heat,6,110,7:30 pm,Dallas Mavericks,104
Fri Nov 15 2013,0,Phoenix Suns,-2,98,9:00 pm,Brooklyn Nets,100
Fri Nov 15 2013,0,Sacramento Kings,-7,90,10:30 pm,Detroit Pistons,97
Fri Nov 15 2013,0,Toronto Raptors,-16,80,7:00 pm,Chicago Bulls,96
Fri Nov 15 2013,0,Utah Jazz,-9,82,9:00 pm,San Antonio Spurs,91
Sat Nov 16 2013,0,Charlotte Bobcats,-16,81,7:00 pm,Miami Heat,97
Sat Nov 16 2013,1,Chicago Bulls,16,110,8:00 pm,Indiana Pacers,94
Sat Nov 16 2013,1,Golden State Warriors,14,102,10:30 pm,Utah Jazz,88
Sat Nov 16 2013,1,Houston Rockets,11,122,8:00 pm,Denver Nuggets,111
Sat Nov 16 2013,1,Los Angeles Clippers,7,110,10:30 pm,Brooklyn Nets,103
Sat Nov 16 2013,0,Milwaukee Bucks,-13,79,8:30 pm,Oklahoma City Thunder,92
Sat Nov 16 2013,1,Minnesota Timberwolves,18,106,8:00 pm,Boston Celtics,88
Sat Nov 16 2013,1,New Orleans Pelicans,37,135,8:00 pm,Philadelphia 76ers,98
Sat Nov 16 2013,0,New York Knicks,-20,90,7:30 pm,Atlanta Hawks,110
Sat Nov 16 2013,0,Orlando Magic,-8,100,7:00 pm,Dallas Mavericks,108
Sat Nov 16 2013,0,Washington Wizards,-7,96,7:00 pm,Cleveland Cavaliers,103
Sun Nov 17 2013,1,Los Angeles Lakers,15,114,9:30 pm,Detroit Pistons,99
Sun Nov 17 2013,0,Sacramento Kings,-11,86,6:00 pm,Memphis Grizzlies,97
Sun Nov 17 2013,0,Toronto Raptors,-8,110,1:00 pm,Portland Trail Blazers,118
Mon Nov 18 2013,0,Brooklyn Nets,-10,98,7:30 pm,Portland Trail Blazers,108
Mon Nov 18 2013,1,Chicago Bulls,5,86,8:00 pm,Charlotte Bobcats,81
Mon Nov 18 2013,1,Dallas Mavericks,3,97,8:30 pm,Philadelphia 76ers,94
Mon Nov 18 2013,0,Los Angeles Clippers,-4,102,10:30 pm,Memphis Grizzlies,106
Mon Nov 18 2013,1,Oklahoma City Thunder,2,115,8:00 pm,Denver Nuggets,113
Mon Nov 18 2013,0,Utah Jazz,-11,87,9:00 pm,Golden State Warriors,98
Tue Nov 19 2013,1,Detroit Pistons,6,92,7:30 pm,New York Knicks,86
Tue Nov 19 2013,1,Houston Rockets,24,109,8:00 pm,Boston Celtics,85
Tue Nov 19 2013,1,Miami Heat,16,104,7:30 pm,Atlanta Hawks,88
Tue Nov 19 2013,1,Sacramento Kings,3,107,10:00 pm,Phoenix Suns,104
Tue Nov 19 2013,1,Washington Wizards,4,104,7:00 pm,Minnesota Timberwolves,100
Wed Nov 20 2013,1,Atlanta Hawks,8,93,7:30 pm,Detroit Pistons,85
Wed Nov 20 2013,1,Charlotte Bobcats,4,95,7:00 pm,Brooklyn Nets,91
Wed Nov 20 2013,0,Cleveland Cavaliers,-7,91,7:00 pm,Washington Wizards,98
Wed Nov 20 2013,1,Dallas Mavericks,3,123,9:30 pm,Houston Rockets,120
Wed Nov 20 2013,0,Golden State Warriors,-7,81,10:30 pm,Memphis Grizzlies,88
Wed Nov 20 2013,0,Milwaukee Bucks,-9,82,8:00 pm,Portland Trail Blazers,91
Wed Nov 20 2013,0,Minnesota Timberwolves,-4,98,8:00 pm,Los Angeles Clippers,102
Wed Nov 20 2013,1,New Orleans Pelicans,7,105,8:00 pm,Utah Jazz,98
Wed Nov 20 2013,0,New York Knicks,-7,96,7:00 pm,Indiana Pacers,103
Wed Nov 20 2013,0,Orlando Magic,-28,92,7:00 pm,Miami Heat,120
Wed Nov 20 2013,0,Philadelphia 76ers,-10,98,7:00 pm,Toronto Raptors,108
Wed Nov 20 2013,0,Phoenix Suns,-7,106,9:00 pm,Sacramento Kings,113
Wed Nov 20 2013,1,San Antonio Spurs,11,104,8:30 pm,Boston Celtics,93
Thu Nov 21 2013,1,Denver Nuggets,10,97,10:30 pm,Chicago Bulls,87
Thu Nov 21 2013,1,Oklahoma City Thunder,14,105,8:00 pm,Los Angeles Clippers,91
Fri Nov 22 2013,0,Boston Celtics,-15,82,7:30 pm,Indiana Pacers,97
Fri Nov 22 2013,0,Charlotte Bobcats,-7,91,7:00 pm,Phoenix Suns,98
Fri Nov 22 2013,1,Dallas Mavericks,10,103,8:30 pm,Utah Jazz,93
Fri Nov 22 2013,0,Detroit Pistons,-7,89,7:30 pm,Atlanta Hawks,96
Fri Nov 22 2013,1,Los Angeles Lakers,7,102,10:30 pm,Golden State Warriors,95
Fri Nov 22 2013,0,Memphis Grizzlies,-16,86,8:00 pm,San Antonio Spurs,102
Fri Nov 22 2013,1,Minnesota Timberwolves,30,111,8:00 pm,Brooklyn Nets,81
Fri Nov 22 2013,1,New Orleans Pelicans,4,104,8:00 pm,Cleveland Cavaliers,100
Fri Nov 22 2013,1,Philadelphia 76ers,8,115,7:00 pm,Milwaukee Bucks,107
Fri Nov 22 2013,1,Portland Trail Blazers,3,98,10:00 pm,Chicago Bulls,95
Fri Nov 22 2013,1,Toronto Raptors,8,96,7:00 pm,Washington Wizards,88
Sat Nov 23 2013,0,Atlanta Hawks,-7,87,7:30 pm,Boston Celtics,94
Sat Nov 23 2013,1,Denver Nuggets,2,102,9:00 pm,Dallas Mavericks,100
Sat Nov 23 2013,0,Golden State Warriors,-12,101,10:30 pm,Portland Trail Blazers,113
Sat Nov 23 2013,1,Houston Rockets,11,112,8:00 pm,Minnesota Timberwolves,101
Sat Nov 23 2013,1,Indiana Pacers,8,106,7:00 pm,Philadelphia 76ers,98
Sat Nov 23 2013,1,Los Angeles Clippers,1,103,3:30 pm,Sacramento Kings,102
Sat Nov 23 2013,1,Miami Heat,2,101,7:30 pm,Orlando Magic,99
Sat Nov 23 2013,0,Milwaukee Bucks,-24,72,8:30 pm,Charlotte Bobcats,96
Sat Nov 23 2013,1,San Antonio Spurs,30,126,8:30 pm,Cleveland Cavaliers,96
Sat Nov 23 2013,1,Washington Wizards,9,98,7:00 pm,New York Knicks,89
Sun Nov 24 2013,0,Brooklyn Nets,-12,97,2:00 pm,Detroit Pistons,109
Sun Nov 24 2013,1,Los Angeles Clippers,39,121,3:30 pm,Chicago Bulls,82
Sun Nov 24 2013,1,Los Angeles Lakers,14,100,9:30 pm,Sacramento Kings,86
Sun Nov 24 2013,1,Oklahoma City Thunder,22,95,7:00 pm,Utah Jazz,73
Sun Nov 24 2013,0,Orlando Magic,-8,96,6:00 pm,Phoenix Suns,104
Mon Nov 25 2013,0,Charlotte Bobcats,-10,86,7:00 pm,Boston Celtics,96
Mon Nov 25 2013,0,Dallas Mavericks,-14,96,8:30 pm,Denver Nuggets,110
Mon Nov 25 2013,1,Detroit Pistons,19,113,7:30 pm,Milwaukee Bucks,94
Mon Nov 25 2013,1,Indiana Pacers,14,98,7:00 pm,Minnesota Timberwolves,84
Mon Nov 25 2013,0,Memphis Grizzlies,-7,86,8:00 pm,Houston Rockets,93
Mon Nov 25 2013,1,Miami Heat,15,107,7:30 pm,Phoenix Suns,92
Mon Nov 25 2013,1,Portland Trail Blazers,11,102,10:00 pm,New York Knicks,91
Mon Nov 25 2013,1,San Antonio Spurs,19,112,8:30 pm,New Orleans Pelicans,93
Mon Nov 25 2013,1,Utah Jazz,6,89,9:00 pm,Chicago Bulls,83
Tue Nov 26 2013,0,Atlanta Hawks,-17,92,7:30 pm,Orlando Magic,109
Tue Nov 26 2013,0,New Orleans Pelicans,-1,101,8:00 pm,Golden State Warriors,102
Tue Nov 26 2013,0,Toronto Raptors,-2,100,7:00 pm,Brooklyn Nets,102
Tue Nov 26 2013,1,Washington Wizards,5,116,7:00 pm,Los Angeles Lakers,111
Wed Nov 27 2013,0,Boston Celtics,-7,93,7:30 pm,Memphis Grizzlies,100
Wed Nov 27 2013,0,Brooklyn Nets,-5,94,7:30 pm,Los Angeles Lakers,99
Wed Nov 27 2013,0,Charlotte Bobcats,-25,74,7:00 pm,Indiana Pacers,99
Wed Nov 27 2013,0,Cleveland Cavaliers,-11,84,7:30 pm,Miami Heat,95
Wed Nov 27 2013,1,Dallas Mavericks,4,103,8:30 pm,Golden State Warriors,99
Wed Nov 27 2013,0,Detroit Pistons,-20,79,7:30 pm,Chicago Bulls,99
Wed Nov 27 2013,1,Houston Rockets,29,113,8:00 pm,Atlanta Hawks,84
Wed Nov 27 2013,1,Los Angeles Clippers,13,93,10:30 pm,New York Knicks,80
Wed Nov 27 2013,0,Milwaukee Bucks,-8,92,8:00 pm,Washington Wizards,100
Wed Nov 27 2013,0,Minnesota Timberwolves,-7,110,8:00 pm,Denver Nuggets,117
Wed Nov 27 2013,1,Oklahoma City Thunder,6,94,8:00 pm,San Antonio Spurs,88
Wed Nov 27 2013,1,Orlando Magic,11,105,7:00 pm,Philadelphia 76ers,94
Wed Nov 27 2013,1,Phoenix Suns,14,120,9:00 pm,Portland Trail Blazers,106
Fri Nov 29 2013,1,Atlanta Hawks,1,88,7:30 pm,Dallas Mavericks,87
Fri Nov 29 2013,1,Boston Celtics,17,103,7:30 pm,Cleveland Cavaliers,86
Fri Nov 29 2013,1,Charlotte Bobcats,16,92,7:00 pm,Milwaukee Bucks,76
Fri Nov 29 2013,1,Denver Nuggets,2,97,9:00 pm,New York Knicks,95
Fri Nov 29 2013,0,Detroit Pistons,-4,102,7:30 pm,Los Angeles Lakers,106
Fri Nov 29 2013,1,Houston Rockets,19,114,8:00 pm,Brooklyn Nets,95
Fri Nov 29 2013,1,Indiana Pacers,20,93,8:00 pm,Washington Wizards,73
Fri Nov 29 2013,1,Oklahoma City Thunder,1,113,8:00 pm,Golden State Warriors,112
Fri Nov 29 2013,0,Orlando Magic,-18,91,7:00 pm,San Antonio Spurs,109
Fri Nov 29 2013,0,Philadelphia 76ers,-16,105,8:00 pm,New Orleans Pelicans,121
Fri Nov 29 2013,0,Sacramento Kings,-6,98,10:00 pm,Los Angeles Clippers,104
Fri Nov 29 2013,0,Toronto Raptors,-7,83,7:00 pm,Miami Heat,90
Fri Nov 29 2013,0,Utah Jazz,-11,101,9:00 pm,Phoenix Suns,112
Sat Nov 30 2013,1,Cleveland Cavaliers,4,97,7:30 pm,Chicago Bulls,93
Sat Nov 30 2013,0,Dallas Mavericks,-6,106,8:30 pm,Minnesota Timberwolves,112
Sat Nov 30 2013,0,Memphis Grizzlies,-9,88,8:00 pm,Brooklyn Nets,97
Sat Nov 30 2013,1,Milwaukee Bucks,7,92,9:00 pm,Boston Celtics,85
Sat Nov 30 2013,0,Phoenix Suns,-8,104,9:00 pm,Utah Jazz,112
Sat Nov 30 2013,0,San Antonio Spurs,-6,106,8:30 pm,Houston Rockets,112
Sat Nov 30 2013,1,Washington Wizards,7,108,7:00 pm,Atlanta Hawks,101
Sun Dec 1 2013,1,Detroit Pistons,15,115,3:30 pm,Philadelphia 76ers,100
Sun Dec 1 2013,0,Los Angeles Clippers,-5,100,3:30 pm,Indiana Pacers,105
Sun Dec 1 2013,0,Los Angeles Lakers,-6,108,9:30 pm,Portland Trail Blazers,114
Sun Dec 1 2013,1,Miami Heat,1,99,6:00 pm,Charlotte Bobcats,98
Sun Dec 1 2013,0,New York Knicks,-4,99,7:30 pm,New Orleans Pelicans,103
Sun Dec 1 2013,1,Oklahoma City Thunder,10,113,7:00 pm,Minnesota Timberwolves,103
Sun Dec 1 2013,0,Sacramento Kings,-2,113,6:00 pm,Golden State Warriors,115
Sun Dec 1 2013,0,Toronto Raptors,-14,98,1:00 pm,Denver Nuggets,112
Mon Dec 2 2013,0,Chicago Bulls,-3,128,8:00 pm,New Orleans Pelicans,131
Mon Dec 2 2013,1,Portland Trail Blazers,4,106,10:00 pm,Indiana Pacers,102
Mon Dec 2 2013,1,San Antonio Spurs,2,102,8:30 pm,Atlanta Hawks,100
Mon Dec 2 2013,1,Utah Jazz,6,109,9:00 pm,Houston Rockets,103
Mon Dec 2 2013,1,Washington Wizards,18,98,7:00 pm,Orlando Magic,80
Tue Dec 3 2013,1,Boston Celtics,8,108,7:30 pm,Milwaukee Bucks,100
Tue Dec 3 2013,0,Brooklyn Nets,-24,87,7:30 pm,Denver Nuggets,111
Tue Dec 3 2013,1,Dallas Mavericks,7,89,8:30 pm,Charlotte Bobcats,82
Tue Dec 3 2013,1,Golden State Warriors,9,112,10:30 pm,Toronto Raptors,103
Tue Dec 3 2013,1,Memphis Grizzlies,19,110,8:00 pm,Phoenix Suns,91
Tue Dec 3 2013,0,Miami Heat,-10,97,7:30 pm,Detroit Pistons,107
Tue Dec 3 2013,1,Philadelphia 76ers,1,126,7:00 pm,Orlando Magic,125
Tue Dec 3 2013,0,Sacramento Kings,-2,95,10:00 pm,Oklahoma City Thunder,97
Wed Dec 4 2013,1,Atlanta Hawks,10,107,7:30 pm,Los Angeles Clippers,97
Wed Dec 4 2013,1,Cleveland Cavaliers,10,98,7:00 pm,Denver Nuggets,88
Wed Dec 4 2013,0,Houston Rockets,-9,88,8:00 pm,Phoenix Suns,97
Wed Dec 4 2013,0,Milwaukee Bucks,-7,98,8:00 pm,Detroit Pistons,105
Wed Dec 4 2013,0,New Orleans Pelicans,-3,97,8:00 pm,Dallas Mavericks,100
Wed Dec 4 2013,1,Portland Trail Blazers,7,111,10:00 pm,Oklahoma City Thunder,104
Wed Dec 4 2013,0,Utah Jazz,-9,86,9:00 pm,Indiana Pacers,95
Thu Dec 5 2013,0,Brooklyn Nets,-30,83,7:00 pm,New York Knicks,113
Thu Dec 5 2013,1,Chicago Bulls,20,107,9:30 pm,Miami Heat,87
Thu Dec 5 2013,0,Memphis Grizzlies,-20,81,8:00 pm,Los Angeles Clippers,101
Fri Dec 6 2013,1,Atlanta Hawks,19,108,7:30 pm,Cleveland Cavaliers,89
Fri Dec 6 2013,1,Boston Celtics,8,106,7:30 pm,Denver Nuggets,98
Fri Dec 6 2013,1,Charlotte Bobcats,17,105,7:00 pm,Philadelphia 76ers,88
Fri Dec 6 2013,1,Houston Rockets,22,105,8:00 pm,Golden State Warriors,83
Fri Dec 6 2013,0,New Orleans Pelicans,-14,95,8:00 pm,Oklahoma City Thunder,109
Fri Dec 6 2013,1,New York Knicks,38,121,7:30 pm,Orlando Magic,83
Fri Dec 6 2013,1,Phoenix Suns,9,106,9:00 pm,Toronto Raptors,97
Fri Dec 6 2013,1,Portland Trail Blazers,32,130,10:00 pm,Utah Jazz,98
Fri Dec 6 2013,0,Sacramento Kings,-6,100,10:00 pm,Los Angeles Lakers,106
Fri Dec 6 2013,0,Washington Wizards,-4,105,7:00 pm,Milwaukee Bucks,109
Sat Dec 7 2013,0,Chicago Bulls,-17,75,8:00 pm,Detroit Pistons,92
Sat Dec 7 2013,1,Cleveland Cavaliers,6,88,7:30 pm,Los Angeles Clippers,82
Sat Dec 7 2013,0,Memphis Grizzlies,-26,82,8:00 pm,Golden State Warriors,108
Sat Dec 7 2013,0,Milwaukee Bucks,-8,82,8:30 pm,Brooklyn Nets,90
Sat Dec 7 2013,0,Minnesota Timberwolves,-21,82,8:00 pm,Miami Heat,103
Sat Dec 7 2013,0,Philadelphia 76ers,-11,92,7:00 pm,Denver Nuggets,103
Sat Dec 7 2013,0,Portland Trail Blazers,-2,106,10:00 pm,Dallas Mavericks,108
Sat Dec 7 2013,0,San Antonio Spurs,-11,100,8:30 pm,Indiana Pacers,111
Sat Dec 7 2013,0,Utah Jazz,-10,102,9:00 pm,Sacramento Kings,112
Sun Dec 8 2013,0,Detroit Pistons,-15,95,6:00 pm,Miami Heat,110
Sun Dec 8 2013,1,Houston Rockets,10,98,7:00 pm,Orlando Magic,88
Sun Dec 8 2013,0,Los Angeles Lakers,-12,94,9:30 pm,Toronto Raptors,106
Sun Dec 8 2013,0,New York Knicks,-41,73,12:00 am,Boston Celtics,114
Sun Dec 8 2013,1,Oklahoma City Thunder,24,118,7:00 pm,Indiana Pacers,94
Mon Dec 9 2013,1,Charlotte Bobcats,4,115,7:00 pm,Golden State Warriors,111
Mon Dec 9 2013,1,Memphis Grizzlies,9,94,8:00 pm,Orlando Magic,85
Mon Dec 9 2013,0,Philadelphia 76ers,-11,83,7:00 pm,Los Angeles Clippers,94
Mon Dec 9 2013,1,Sacramento Kings,15,112,10:00 pm,Dallas Mavericks,97
Mon Dec 9 2013,0,Utah Jazz,-11,94,9:00 pm,Portland Trail Blazers,105
Mon Dec 9 2013,0,Washington Wizards,-1,74,7:00 pm,Denver Nuggets,75
Tue Dec 10 2013,0,Atlanta Hawks,-9,92,7:30 pm,Oklahoma City Thunder,101
Tue Dec 10 2013,1,Brooklyn Nets,8,104,7:30 pm,Boston Celtics,96
Tue Dec 10 2013,0,Chicago Bulls,-4,74,8:00 pm,Milwaukee Bucks,78
Tue Dec 10 2013,1,Cleveland Cavaliers,15,109,7:00 pm,New York Knicks,94
Tue Dec 10 2013,0,Detroit Pistons,-27,94,7:30 pm,Minnesota Timberwolves,121
Tue Dec 10 2013,1,Indiana Pacers,6,90,7:00 pm,Miami Heat,84
Tue Dec 10 2013,0,Los Angeles Lakers,-6,108,10:30 pm,Phoenix Suns,114
Tue Dec 10 2013,0,Toronto Raptors,-13,103,7:00 pm,San Antonio Spurs,116
Wed Dec 11 2013,0,Boston Celtics,-8,88,7:30 pm,Los Angeles Clippers,96
Wed Dec 11 2013,0,Charlotte Bobcats,-9,83,7:00 pm,Orlando Magic,92
Wed Dec 11 2013,1,Golden State Warriors,2,95,10:30 pm,Dallas Mavericks,93
Wed Dec 11 2013,0,Memphis Grizzlies,-16,100,8:00 pm,Oklahoma City Thunder,116
Wed Dec 11 2013,0,Milwaukee Bucks,-32,77,8:00 pm,San Antonio Spurs,109
Wed Dec 11 2013,1,Minnesota Timberwolves,7,106,8:00 pm,Philadelphia 76ers,99
Wed Dec 11 2013,1,New Orleans Pelicans,5,111,8:00 pm,Detroit Pistons,106
Wed Dec 11 2013,1,New York Knicks,5,83,8:00 pm,Chicago Bulls,78
Wed Dec 11 2013,0,Sacramento Kings,-21,101,10:00 pm,Utah Jazz,122
Thu Dec 12 2013,1,Brooklyn Nets,9,102,8:00 pm,Los Angeles Clippers,93
Thu Dec 12 2013,1,Portland Trail Blazers,7,111,10:30 pm,Houston Rockets,104
Fri Dec 13 2013,1,Atlanta Hawks,2,101,7:30 pm,Washington Wizards,99
Fri Dec 13 2013,1,Boston Celtics,4,90,7:30 pm,New York Knicks,86
Fri Dec 13 2013,0,Denver Nuggets,-10,93,9:00 pm,Utah Jazz,103
Fri Dec 13 2013,1,Detroit Pistons,4,103,7:30 pm,Brooklyn Nets,99
Fri Dec 13 2013,0,Golden State Warriors,-4,112,10:30 pm,Houston Rockets,116
Fri Dec 13 2013,1,Indiana Pacers,5,99,7:00 pm,Charlotte Bobcats,94
Fri Dec 13 2013,0,Milwaukee Bucks,-1,90,8:30 pm,Chicago Bulls,91
Fri Dec 13 2013,1,New Orleans Pelicans,6,104,8:00 pm,Memphis Grizzlies,98
Fri Dec 13 2013,1,Oklahoma City Thunder,25,122,8:00 pm,Los Angeles Lakers,97
Fri Dec 13 2013,0,Orlando Magic,-9,100,7:00 pm,Cleveland Cavaliers,109
Fri Dec 13 2013,1,Phoenix Suns,9,116,9:00 pm,Sacramento Kings,107
Fri Dec 13 2013,1,San Antonio Spurs,7,117,8:30 pm,Minnesota Timberwolves,110
Fri Dec 13 2013,1,Toronto Raptors,8,108,7:00 pm,Philadelphia 76ers,100
Sat Dec 14 2013,0,Charlotte Bobcats,-3,85,7:00 pm,Los Angeles Lakers,88
Sat Dec 14 2013,0,Chicago Bulls,-22,77,8:00 pm,Toronto Raptors,99
Sat Dec 14 2013,1,Dallas Mavericks,13,106,8:30 pm,Milwaukee Bucks,93
Sat Dec 14 2013,1,Miami Heat,7,114,7:30 pm,Cleveland Cavaliers,107
Sat Dec 14 2013,1,New York Knicks,5,111,7:30 pm,Atlanta Hawks,106
Sat Dec 14 2013,0,Philadelphia 76ers,-34,105,8:00 pm,Portland Trail Blazers,139
Sat Dec 14 2013,0,Utah Jazz,-16,84,9:00 pm,San Antonio Spurs,100
Sat Dec 14 2013,0,Washington Wizards,-16,97,7:00 pm,Los Angeles Clippers,113
Sun Dec 15 2013,1,Denver Nuggets,9,102,8:00 pm,New Orleans Pelicans,93
Sun Dec 15 2013,0,Detroit Pistons,-2,109,6:00 pm,Portland Trail Blazers,111
Sun Dec 15 2013,0,Memphis Grizzlies,-8,93,6:00 pm,Minnesota Timberwolves,101
Sun Dec 15 2013,1,Oklahoma City Thunder,3,101,7:00 pm,Orlando Magic,98
Sun Dec 15 2013,1,Phoenix Suns,4,106,8:00 pm,Golden State Warriors,102
Sun Dec 15 2013,1,Sacramento Kings,15,106,6:00 pm,Houston Rockets,91
Mon Dec 16 2013,1,Atlanta Hawks,14,114,7:30 pm,Los Angeles Lakers,100
Mon Dec 16 2013,1,Boston Celtics,4,101,7:30 pm,Minnesota Timberwolves,97
Mon Dec 16 2013,1,Brooklyn Nets,36,130,7:30 pm,Philadelphia 76ers,94
Mon Dec 16 2013,0,Chicago Bulls,-1,82,8:00 pm,Orlando Magic,83
Mon Dec 16 2013,0,Indiana Pacers,-5,96,7:00 pm,Detroit Pistons,101
Mon Dec 16 2013,1,Los Angeles Clippers,23,115,10:30 pm,San Antonio Spurs,92
Mon Dec 16 2013,1,Miami Heat,23,117,7:30 pm,Utah Jazz,94
Mon Dec 16 2013,0,New York Knicks,-1,101,7:30 pm,Washington Wizards,102
Tue Dec 17 2013,1,Charlotte Bobcats,8,95,7:00 pm,Sacramento Kings,87
Tue Dec 17 2013,0,Cleveland Cavaliers,-3,116,7:00 pm,Portland Trail Blazers,119
Tue Dec 17 2013,0,Denver Nuggets,-12,93,9:00 pm,Oklahoma City Thunder,105
Tue Dec 17 2013,1,Golden State Warriors,11,104,10:30 pm,New Orleans Pelicans,93
Tue Dec 17 2013,0,Memphis Grizzlies,-4,92,8:00 pm,Los Angeles Lakers,96
Wed Dec 18 2013,1,Atlanta Hawks,17,124,7:30 pm,Sacramento Kings,107
Wed Dec 18 2013,0,Boston Celtics,-1,106,7:30 pm,Detroit Pistons,107
Wed Dec 18 2013,0,Brooklyn Nets,-6,107,7:30 pm,Washington Wizards,113
Wed Dec 18 2013,1,Dallas Mavericks,14,105,8:30 pm,Memphis Grizzlies,91
Wed Dec 18 2013,1,Houston Rockets,15,109,9:30 pm,Chicago Bulls,94
Wed Dec 18 2013,1,Los Angeles Clippers,13,108,10:30 pm,New Orleans Pelicans,95
Wed Dec 18 2013,1,Miami Heat,3,97,7:00 pm,Indiana Pacers,94
Wed Dec 18 2013,0,Milwaukee Bucks,-6,101,8:00 pm,New York Knicks,107
Wed Dec 18 2013,1,Minnesota Timberwolves,11,120,8:00 pm,Portland Trail Blazers,109
Wed Dec 18 2013,0,Orlando Magic,-4,82,7:00 pm,Utah Jazz,86
Wed Dec 18 2013,0,Phoenix Suns,-7,101,9:00 pm,San Antonio Spurs,108
Wed Dec 18 2013,0,Toronto Raptors,-2,102,7:00 pm,Charlotte Bobcats,104
Thu Dec 19 2013,0,Golden State Warriors,-2,102,10:30 pm,San Antonio Spurs,104
Thu Dec 19 2013,1,Oklahoma City Thunder,12,107,8:00 pm,Chicago Bulls,95
Fri Dec 20 2013,1,Atlanta Hawks,33,118,7:30 pm,Utah Jazz,85
Fri Dec 20 2013,1,Cleveland Cavaliers,3,114,7:30 pm,Milwaukee Bucks,111
Fri Dec 20 2013,0,Dallas Mavericks,-1,108,8:30 pm,Toronto Raptors,109
Fri Dec 20 2013,0,Denver Nuggets,-4,99,9:00 pm,Phoenix Suns,103
Fri Dec 20 2013,0,Detroit Pistons,-10,106,7:30 pm,Charlotte Bobcats,116
Fri Dec 20 2013,1,Indiana Pacers,33,114,8:00 pm,Houston Rockets,81
Fri Dec 20 2013,1,Los Angeles Lakers,13,104,10:30 pm,Minnesota Timberwolves,91
Fri Dec 20 2013,1,Miami Heat,19,122,7:30 pm,Sacramento Kings,103
Fri Dec 20 2013,1,Philadelphia 76ers,1,121,7:00 pm,Brooklyn Nets,120
Sat Dec 21 2013,0,Boston Celtics,-7,99,1:00 pm,Washington Wizards,106
Sat Dec 21 2013,0,Charlotte Bobcats,-3,85,7:30 pm,Utah Jazz,88
Sat Dec 21 2013,1,Chicago Bulls,16,100,8:00 pm,Cleveland Cavaliers,84
Sat Dec 21 2013,0,Detroit Pistons,-17,97,7:30 pm,Houston Rockets,114
Sat Dec 21 2013,1,Golden State Warriors,19,102,10:30 pm,Los Angeles Lakers,83
Sat Dec 21 2013,1,Los Angeles Clippers,21,112,10:30 pm,Denver Nuggets,91
Sat Dec 21 2013,1,Milwaukee Bucks,10,116,8:30 pm,Philadelphia 76ers,106
Sat Dec 21 2013,0,New York Knicks,-8,87,12:00 am,Memphis Grizzlies,95
Sat Dec 21 2013,0,Orlando Magic,-5,100,7:00 pm,Sacramento Kings,105
Sat Dec 21 2013,1,Phoenix Suns,15,123,9:00 pm,Dallas Mavericks,108
Sat Dec 21 2013,1,Portland Trail Blazers,3,110,10:00 pm,New Orleans Pelicans,107
Sat Dec 21 2013,0,San Antonio Spurs,-13,100,8:30 pm,Oklahoma City Thunder,113
Sun Dec 22 2013,1,Indiana Pacers,27,106,6:00 pm,Boston Celtics,79
Sun Dec 22 2013,1,Los Angeles Clippers,4,120,9:30 pm,Minnesota Timberwolves,116
Sun Dec 22 2013,0,Oklahoma City Thunder,-6,98,7:00 pm,Toronto Raptors,104
Mon Dec 23 2013,0,Brooklyn Nets,-17,86,7:30 pm,Indiana Pacers,103
Mon Dec 23 2013,1,Charlotte Bobcats,1,111,7:00 pm,Milwaukee Bucks,110
Mon Dec 23 2013,0,Cleveland Cavaliers,-23,92,7:00 pm,Detroit Pistons,115
Mon Dec 23 2013,0,Denver Nuggets,-8,81,9:00 pm,Golden State Warriors,89
Mon Dec 23 2013,0,Houston Rockets,-7,104,8:00 pm,Dallas Mavericks,111
Mon Dec 23 2013,1,Memphis Grizzlies,10,104,8:00 pm,Utah Jazz,94
Mon Dec 23 2013,1,Miami Heat,2,121,7:30 pm,Atlanta Hawks,119
Mon Dec 23 2013,0,Orlando Magic,-5,98,7:00 pm,New York Knicks,103
Mon Dec 23 2013,1,Phoenix Suns,27,117,9:00 pm,Los Angeles Lakers,90
Mon Dec 23 2013,0,Sacramento Kings,-13,100,10:00 pm,New Orleans Pelicans,113
Mon Dec 23 2013,1,San Antonio Spurs,13,112,8:30 pm,Toronto Raptors,99
Wed Dec 25 2013,0,Brooklyn Nets,-17,78,12:00 am,Chicago Bulls,95
Wed Dec 25 2013,1,Golden State Warriors,2,105,10:30 pm,Los Angeles Clippers,103
Wed Dec 25 2013,0,Los Angeles Lakers,-6,95,5:00 pm,Miami Heat,101
Wed Dec 25 2013,0,New York Knicks,-29,94,2:30 pm,Oklahoma City Thunder,123
Wed Dec 25 2013,0,San Antonio Spurs,-13,98,8:00 pm,Houston Rockets,111
Thu Dec 26 2013,0,Cleveland Cavaliers,-2,125,7:00 pm,Atlanta Hawks,127
Thu Dec 26 2013,0,Dallas Mavericks,-9,107,8:30 pm,San Antonio Spurs,116
Thu Dec 26 2013,1,Houston Rockets,8,100,8:00 pm,Memphis Grizzlies,92
Thu Dec 26 2013,1,Portland Trail Blazers,4,116,10:30 pm,Los Angeles Clippers,112
Fri Dec 27 2013,1,Brooklyn Nets,11,104,7:30 pm,Milwaukee Bucks,93
Fri Dec 27 2013,0,Charlotte Bobcats,-4,85,7:00 pm,Oklahoma City Thunder,89
Fri Dec 27 2013,1,Golden State Warriors,29,115,10:30 pm,Phoenix Suns,86
Fri Dec 27 2013,1,Minnesota Timberwolves,22,120,8:00 pm,Washington Wizards,98
Fri Dec 27 2013,1,New Orleans Pelicans,16,105,8:00 pm,Denver Nuggets,89
Fri Dec 27 2013,0,New York Knicks,-12,83,7:30 pm,Toronto Raptors,95
Fri Dec 27 2013,1,Orlando Magic,17,109,7:00 pm,Detroit Pistons,92
Fri Dec 27 2013,1,Sacramento Kings,5,108,10:00 pm,Miami Heat,103
Fri Dec 27 2013,1,Utah Jazz,2,105,9:00 pm,Los Angeles Lakers,103
Sat Dec 28 2013,1,Atlanta Hawks,2,118,7:30 pm,Charlotte Bobcats,116
Sat Dec 28 2013,1,Boston Celtics,3,103,1:00 pm,Cleveland Cavaliers,100
Sat Dec 28 2013,0,Chicago Bulls,-22,83,8:00 pm,Dallas Mavericks,105
Sat Dec 28 2013,1,Houston Rockets,9,107,8:00 pm,New Orleans Pelicans,98
Sat Dec 28 2013,1,Indiana Pacers,14,105,7:00 pm,Brooklyn Nets,91
Sat Dec 28 2013,1,Los Angeles Clippers,8,98,10:30 pm,Utah Jazz,90
Sat Dec 28 2013,1,Memphis Grizzlies,21,120,8:00 pm,Denver Nuggets,99
Sat Dec 28 2013,0,Milwaukee Bucks,-22,95,8:30 pm,Minnesota Timberwolves,117
Sat Dec 28 2013,1,Phoenix Suns,14,115,9:00 pm,Philadelphia 76ers,101
Sat Dec 28 2013,0,Portland Trail Blazers,-1,107,10:00 pm,Miami Heat,108
Sat Dec 28 2013,1,Toronto Raptors,15,115,7:00 pm,New York Knicks,100
Sat Dec 28 2013,1,Washington Wizards,24,106,7:00 pm,Detroit Pistons,82
Sun Dec 29 2013,0,Cleveland Cavaliers,-4,104,6:00 pm,Golden State Warriors,108
Sun Dec 29 2013,0,Los Angeles Lakers,-7,104,9:30 pm,Philadelphia 76ers,111
Sun Dec 29 2013,1,Oklahoma City Thunder,31,117,7:00 pm,Houston Rockets,86
Sun Dec 29 2013,1,Orlando Magic,7,109,6:00 pm,Atlanta Hawks,102
Sun Dec 29 2013,1,San Antonio Spurs,8,112,7:00 pm,Sacramento Kings,104
Mon Dec 30 2013,0,Denver Nuggets,-3,94,9:00 pm,Miami Heat,97
Mon Dec 30 2013,0,Detroit Pistons,-7,99,7:30 pm,Washington Wizards,106
Mon Dec 30 2013,0,Los Angeles Clippers,-19,88,10:30 pm,Phoenix Suns,107
Mon Dec 30 2013,0,Memphis Grizzlies,-4,91,8:00 pm,Chicago Bulls,95
Mon Dec 30 2013,0,Minnesota Timberwolves,-2,98,8:00 pm,Dallas Mavericks,100
Mon Dec 30 2013,1,New Orleans Pelicans,2,110,8:00 pm,Portland Trail Blazers,108
Mon Dec 30 2013,1,Utah Jazz,3,83,9:00 pm,Charlotte Bobcats,80
Tue Dec 31 2013,0,Boston Celtics,-1,91,1:00 pm,Atlanta Hawks,92
Tue Dec 31 2013,0,Chicago Bulls,-6,79,8:00 pm,Toronto Raptors,85
Tue Dec 31 2013,0,Houston Rockets,-4,106,7:00 pm,Sacramento Kings,110
Tue Dec 31 2013,1,Indiana Pacers,15,91,3:00 pm,Cleveland Cavaliers,76
Tue Dec 31 2013,0,Los Angeles Lakers,-15,79,10:30 pm,Milwaukee Bucks,94
Tue Dec 31 2013,0,Oklahoma City Thunder,-4,94,8:00 pm,Portland Trail Blazers,98
Tue Dec 31 2013,0,Orlando Magic,-13,81,5:00 pm,Golden State Warriors,94
Tue Dec 31 2013,1,San Antonio Spurs,21,113,7:00 pm,Brooklyn Nets,92
Wed Jan 1 2014,0,Denver Nuggets,-12,102,9:00 pm,Philadelphia 76ers,114
Wed Jan 1 2014,1,Los Angeles Clippers,27,112,9:30 pm,Charlotte Bobcats,85
Wed Jan 1 2014,1,Minnesota Timberwolves,12,124,8:00 pm,New Orleans Pelicans,112
Wed Jan 1 2014,1,Toronto Raptors,13,95,7:00 pm,Indiana Pacers,82
Wed Jan 1 2014,0,Washington Wizards,-9,78,6:00 pm,Dallas Mavericks,87
Thu Jan 2 2014,1,Chicago Bulls,12,94,8:00 pm,Boston Celtics,82
Thu Jan 2 2014,1,Cleveland Cavaliers,6,87,7:00 pm,Orlando Magic,81
Thu Jan 2 2014,0,Miami Heat,-9,114,7:30 pm,Golden State Warriors,123
Thu Jan 2 2014,0,Oklahoma City Thunder,-2,93,8:00 pm,Brooklyn Nets,95
Thu Jan 2 2014,0,Phoenix Suns,-8,91,9:00 pm,Memphis Grizzlies,99
Thu Jan 2 2014,1,Portland Trail Blazers,30,134,10:00 pm,Charlotte Bobcats,104
Thu Jan 2 2014,0,Sacramento Kings,-9,104,10:00 pm,Philadelphia 76ers,113
Thu Jan 2 2014,0,San Antonio Spurs,-4,101,8:30 pm,New York Knicks,105
Thu Jan 2 2014,1,Utah Jazz,9,96,9:00 pm,Milwaukee Bucks,87
Fri Jan 3 2014,0,Atlanta Hawks,-1,100,7:30 pm,Golden State Warriors,101
Fri Jan 3 2014,0,Boston Celtics,-3,92,7:30 pm,New Orleans Pelicans,95
Fri Jan 3 2014,0,Dallas Mavericks,-7,112,8:30 pm,Los Angeles Clippers,119
Fri Jan 3 2014,1,Denver Nuggets,3,111,9:00 pm,Memphis Grizzlies,108
Fri Jan 3 2014,1,Houston Rockets,2,102,8:00 pm,New York Knicks,100
Fri Jan 3 2014,1,Los Angeles Lakers,11,110,10:30 pm,Utah Jazz,99
Fri Jan 3 2014,0,Washington Wizards,-13,88,7:00 pm,Toronto Raptors,101
Sat Jan 4 2014,1,Brooklyn Nets,7,89,7:30 pm,Cleveland Cavaliers,82
Sat Jan 4 2014,1,Chicago Bulls,7,91,8:00 pm,Atlanta Hawks,84
Sat Jan 4 2014,1,Indiana Pacers,17,99,7:00 pm,New Orleans Pelicans,82
Sat Jan 4 2014,0,Minnesota Timberwolves,-4,111,8:00 pm,Oklahoma City Thunder,115
Sat Jan 4 2014,0,Orlando Magic,-16,94,7:00 pm,Miami Heat,110
Sat Jan 4 2014,1,Phoenix Suns,16,116,9:00 pm,Milwaukee Bucks,100
Sat Jan 4 2014,0,Portland Trail Blazers,-2,99,10:00 pm,Philadelphia 76ers,101
Sat Jan 4 2014,0,Sacramento Kings,-10,103,10:00 pm,Charlotte Bobcats,113
Sat Jan 4 2014,1,San Antonio Spurs,24,116,8:30 pm,Los Angeles Clippers,92
Sun Jan 5 2014,0,Cleveland Cavaliers,-4,78,6:00 pm,Indiana Pacers,82
Sun Jan 5 2014,0,Dallas Mavericks,-12,80,7:30 pm,New York Knicks,92
Sun Jan 5 2014,0,Detroit Pistons,-28,84,1:00 pm,Memphis Grizzlies,112
Sun Jan 5 2014,0,Los Angeles Lakers,-22,115,9:30 pm,Denver Nuggets,137
Sun Jan 5 2014,1,Miami Heat,5,102,6:00 pm,Toronto Raptors,97
Sun Jan 5 2014,1,Oklahoma City Thunder,23,119,7:00 pm,Boston Celtics,96
Sun Jan 5 2014,0,Washington Wizards,-16,96,6:00 pm,Golden State Warriors,112
Mon Jan 6 2014,1,Brooklyn Nets,5,91,7:30 pm,Atlanta Hawks,86
Mon Jan 6 2014,1,Los Angeles Clippers,20,101,10:30 pm,Orlando Magic,81
Mon Jan 6 2014,0,Philadelphia 76ers,-31,95,7:00 pm,Minnesota Timberwolves,126
Tue Jan 7 2014,0,Charlotte Bobcats,-14,83,7:00 pm,Washington Wizards,97
Tue Jan 7 2014,1,Chicago Bulls,5,92,8:00 pm,Phoenix Suns,87
Tue Jan 7 2014,1,Cleveland Cavaliers,18,111,7:00 pm,Philadelphia 76ers,93
Tue Jan 7 2014,1,Dallas Mavericks,13,110,8:30 pm,Los Angeles Lakers,97
Tue Jan 7 2014,1,Denver Nuggets,31,129,9:00 pm,Boston Celtics,98
Tue Jan 7 2014,1,Indiana Pacers,7,86,7:00 pm,Toronto Raptors,79
Tue Jan 7 2014,0,Memphis Grizzlies,-2,108,8:00 pm,San Antonio Spurs,110
Tue Jan 7 2014,1,Miami Heat,19,107,7:30 pm,New Orleans Pelicans,88
Tue Jan 7 2014,0,Milwaukee Bucks,-21,80,8:00 pm,Golden State Warriors,101
Tue Jan 7 2014,1,New York Knicks,4,89,7:30 pm,Detroit Pistons,85
Tue Jan 7 2014,1,Sacramento Kings,4,123,10:00 pm,Portland Trail Blazers,119
Tue Jan 7 2014,1,Utah Jazz,11,112,9:00 pm,Oklahoma City Thunder,101
Wed Jan 8 2014,1,Atlanta Hawks,10,97,7:30 pm,Indiana Pacers,87
Wed Jan 8 2014,1,Brooklyn Nets,4,102,7:30 pm,Golden State Warriors,98
Wed Jan 8 2014,1,Houston Rockets,14,113,8:00 pm,Los Angeles Lakers,99
Wed Jan 8 2014,1,Los Angeles Clippers,6,111,10:30 pm,Boston Celtics,105
Wed Jan 8 2014,0,Minnesota Timberwolves,-1,103,9:30 pm,Phoenix Suns,104
Wed Jan 8 2014,0,New Orleans Pelicans,-6,96,8:00 pm,Washington Wizards,102
Wed Jan 8 2014,1,Portland Trail Blazers,16,110,10:00 pm,Orlando Magic,94
Wed Jan 8 2014,1,San Antonio Spurs,22,112,7:00 pm,Dallas Mavericks,90
Wed Jan 8 2014,1,Toronto Raptors,21,112,7:00 pm,Detroit Pistons,91
Thu Jan 9 2014,1,Denver Nuggets,13,101,10:30 pm,Oklahoma City Thunder,88
Thu Jan 9 2014,1,New York Knicks,10,102,8:00 pm,Miami Heat,92
Fri Jan 10 2014,1,Atlanta Hawks,3,83,7:30 pm,Houston Rockets,80
Fri Jan 10 2014,1,Brooklyn Nets,9,104,8:00 pm,Miami Heat,95
Fri Jan 10 2014,1,Golden State Warriors,2,99,10:30 pm,Boston Celtics,97
Fri Jan 10 2014,1,Indiana Pacers,27,93,7:00 pm,Washington Wizards,66
Fri Jan 10 2014,1,Los Angeles Clippers,36,123,10:30 pm,Los Angeles Lakers,87
Fri Jan 10 2014,1,Memphis Grizzlies,5,104,8:00 pm,Phoenix Suns,99
Fri Jan 10 2014,0,Milwaukee Bucks,-9,72,8:30 pm,Chicago Bulls,81
Fri Jan 10 2014,1,Minnesota Timberwolves,27,119,8:00 pm,Charlotte Bobcats,92
Fri Jan 10 2014,0,New Orleans Pelicans,-17,90,8:00 pm,Dallas Mavericks,107
Fri Jan 10 2014,0,Philadelphia 76ers,-10,104,7:00 pm,Detroit Pistons,114
Fri Jan 10 2014,1,Sacramento Kings,20,103,10:00 pm,Orlando Magic,83
Fri Jan 10 2014,0,Utah Jazz,-11,102,9:00 pm,Cleveland Cavaliers,113
Sat Jan 11 2014,1,Chicago Bulls,6,103,8:00 pm,Charlotte Bobcats,97
Sat Jan 11 2014,1,Dallas Mavericks,3,110,8:30 pm,New Orleans Pelicans,107
Sat Jan 11 2014,1,Denver Nuggets,26,120,9:00 pm,Orlando Magic,94
Sat Jan 11 2014,1,Detroit Pistons,2,110,7:30 pm,Phoenix Suns,108
Sat Jan 11 2014,1,Oklahoma City Thunder,16,101,8:00 pm,Milwaukee Bucks,85
Sat Jan 11 2014,0,Philadelphia 76ers,-10,92,7:30 pm,New York Knicks,102
Sat Jan 11 2014,1,Portland Trail Blazers,8,112,10:00 pm,Boston Celtics,104
Sat Jan 11 2014,1,Toronto Raptors,16,96,7:00 pm,Brooklyn Nets,80
Sat Jan 11 2014,0,Washington Wizards,-7,107,7:00 pm,Houston Rockets,114
Sun Jan 12 2014,1,Memphis Grizzlies,7,108,6:00 pm,Atlanta Hawks,101
Sun Jan 12 2014,1,Sacramento Kings,44,124,6:00 pm,Cleveland Cavaliers,80
Sun Jan 12 2014,1,San Antonio Spurs,18,104,7:00 pm,Minnesota Timberwolves,86
Mon Jan 13 2014,0,Boston Celtics,-12,92,7:30 pm,Houston Rockets,104
Mon Jan 13 2014,0,Chicago Bulls,-14,88,8:00 pm,Washington Wizards,102
Mon Jan 13 2014,1,Dallas Mavericks,19,107,8:30 pm,Orlando Magic,88
Mon Jan 13 2014,0,New Orleans Pelicans,-6,95,8:00 pm,San Antonio Spurs,101
Mon Jan 13 2014,1,New York Knicks,2,98,7:30 pm,Phoenix Suns,96
Mon Jan 13 2014,1,Toronto Raptors,22,116,7:00 pm,Milwaukee Bucks,94
Mon Jan 13 2014,1,Utah Jazz,15,118,9:00 pm,Denver Nuggets,103
Tue Jan 14 2014,1,Charlotte Bobcats,10,108,7:00 pm,New York Knicks,98
Tue Jan 14 2014,1,Indiana Pacers,24,116,7:00 pm,Sacramento Kings,92
Tue Jan 14 2014,0,Los Angeles Lakers,-2,118,10:30 pm,Cleveland Cavaliers,120
Tue Jan 14 2014,1,Memphis Grizzlies,3,90,8:00 pm,Oklahoma City Thunder,87
Wed Jan 15 2014,1,Boston Celtics,5,88,7:30 pm,Toronto Raptors,83
Wed Jan 15 2014,0,Golden State Warriors,-7,116,10:30 pm,Denver Nuggets,123
Wed Jan 15 2014,1,Los Angeles Clippers,2,129,10:30 pm,Dallas Mavericks,127
Wed Jan 15 2014,0,Milwaukee Bucks,-5,77,8:00 pm,Memphis Grizzlies,82
Wed Jan 15 2014,0,Minnesota Timberwolves,-3,108,8:00 pm,Sacramento Kings,111
Wed Jan 15 2014,0,New Orleans Pelicans,-3,100,8:00 pm,Houston Rockets,103
Wed Jan 15 2014,0,Orlando Magic,-3,125,7:00 pm,Chicago Bulls,128
Wed Jan 15 2014,1,Philadelphia 76ers,3,95,7:00 pm,Charlotte Bobcats,92
Wed Jan 15 2014,1,Phoenix Suns,7,121,9:00 pm,Los Angeles Lakers,114
Wed Jan 15 2014,1,Portland Trail Blazers,12,108,10:00 pm,Cleveland Cavaliers,96
Wed Jan 15 2014,1,San Antonio Spurs,4,109,8:00 pm,Utah Jazz,105
Wed Jan 15 2014,1,Washington Wizards,17,114,7:00 pm,Miami Heat,97
Thu Jan 16 2014,0,Atlanta Hawks,-17,110,3:00 pm,Brooklyn Nets,127
Thu Jan 16 2014,0,Houston Rockets,-12,92,9:30 pm,Oklahoma City Thunder,104
Thu Jan 16 2014,1,Indiana Pacers,28,117,7:00 pm,New York Knicks,89
Fri Jan 17 2014,0,Boston Celtics,-3,104,7:30 pm,Los Angeles Lakers,107
Fri Jan 17 2014,0,Denver Nuggets,-8,109,9:00 pm,Cleveland Cavaliers,117
Fri Jan 17 2014,0,Detroit Pistons,-21,89,7:30 pm,Utah Jazz,110
Fri Jan 17 2014,1,Memphis Grizzlies,1,91,8:00 pm,Sacramento Kings,90
Fri Jan 17 2014,0,New York Knicks,-14,95,7:00 pm,Los Angeles Clippers,109
Fri Jan 17 2014,1,Oklahoma City Thunder,6,127,9:30 pm,Golden State Warriors,121
Fri Jan 17 2014,0,Orlando Magic,-10,101,7:00 pm,Charlotte Bobcats,111
Fri Jan 17 2014,0,Philadelphia 76ers,-15,86,7:00 pm,Miami Heat,101
Fri Jan 17 2014,0,Phoenix Suns,-3,107,9:00 pm,Dallas Mavericks,110
Fri Jan 17 2014,0,San Antonio Spurs,-9,100,8:30 pm,Portland Trail Blazers,109
Fri Jan 17 2014,1,Toronto Raptors,5,94,7:00 pm,Minnesota Timberwolves,89
Fri Jan 17 2014,1,Washington Wizards,3,96,7:00 pm,Chicago Bulls,93
Sat Jan 18 2014,0,Charlotte Bobcats,-8,96,7:30 pm,Miami Heat,104
Sat Jan 18 2014,1,Chicago Bulls,25,103,8:00 pm,Philadelphia 76ers,78
Sat Jan 18 2014,0,Dallas Mavericks,-16,111,8:30 pm,Portland Trail Blazers,127
Sat Jan 18 2014,1,Houston Rockets,10,114,8:00 pm,Milwaukee Bucks,104
Sat Jan 18 2014,1,Indiana Pacers,14,106,7:00 pm,Los Angeles Clippers,92
Sat Jan 18 2014,1,Minnesota Timberwolves,26,98,8:00 pm,Utah Jazz,72
Sat Jan 18 2014,0,New Orleans Pelicans,-10,87,8:00 pm,Golden State Warriors,97
Sat Jan 18 2014,0,Washington Wizards,-6,98,7:00 pm,Detroit Pistons,104
Sun Jan 19 2014,1,Oklahoma City Thunder,15,108,7:00 pm,Sacramento Kings,93
Sun Jan 19 2014,1,Orlando Magic,2,93,6:00 pm,Boston Celtics,91
Sun Jan 19 2014,1,Phoenix Suns,14,117,8:00 pm,Denver Nuggets,103
Sun Jan 19 2014,1,San Antonio Spurs,28,110,7:00 pm,Milwaukee Bucks,82
Sun Jan 19 2014,0,Toronto Raptors,-6,106,1:00 pm,Los Angeles Lakers,112
Mon Jan 20 2014,1,Atlanta Hawks,7,121,5:30 pm,Miami Heat,114
Mon Jan 20 2014,1,Charlotte Bobcats,5,100,2:00 pm,Toronto Raptors,95
Mon Jan 20 2014,1,Chicago Bulls,2,102,8:00 pm,Los Angeles Lakers,100
Mon Jan 20 2014,0,Cleveland Cavaliers,-5,97,1:00 pm,Dallas Mavericks,102
Mon Jan 20 2014,0,Detroit Pistons,-9,103,1:00 pm,Los Angeles Clippers,112
Mon Jan 20 2014,0,Golden State Warriors,-8,94,10:30 pm,Indiana Pacers,102
Mon Jan 20 2014,1,Houston Rockets,13,126,8:00 pm,Portland Trail Blazers,113
Mon Jan 20 2014,0,Memphis Grizzlies,-3,92,5:00 pm,New Orleans Pelicans,95
Mon Jan 20 2014,0,New York Knicks,-23,80,2:30 pm,Brooklyn Nets,103
Mon Jan 20 2014,1,Washington Wizards,8,107,2:00 pm,Philadelphia 76ers,99
Tue Jan 21 2014,1,Brooklyn Nets,11,101,7:30 pm,Orlando Magic,90
Tue Jan 21 2014,1,Miami Heat,7,93,7:30 pm,Boston Celtics,86
Tue Jan 21 2014,0,New Orleans Pelicans,-17,97,8:00 pm,Sacramento Kings,114
Tue Jan 21 2014,1,Oklahoma City Thunder,8,105,8:00 pm,Portland Trail Blazers,97
Tue Jan 21 2014,0,Utah Jazz,-15,97,9:00 pm,Minnesota Timberwolves,112
Wed Jan 22 2014,1,Charlotte Bobcats,4,95,7:00 pm,Los Angeles Clippers,91
Wed Jan 22 2014,0,Cleveland Cavaliers,-11,87,7:00 pm,Chicago Bulls,98
Wed Jan 22 2014,1,Houston Rockets,21,119,8:00 pm,Sacramento Kings,98
Wed Jan 22 2014,1,Milwaukee Bucks,3,104,8:00 pm,Detroit Pistons,101
Wed Jan 22 2014,0,New York Knicks,-4,106,7:30 pm,Philadelphia 76ers,110
Wed Jan 22 2014,0,Orlando Magic,-3,109,7:00 pm,Atlanta Hawks,112
Wed Jan 22 2014,1,Phoenix Suns,24,124,10:30 pm,Indiana Pacers,100
Wed Jan 22 2014,0,San Antonio Spurs,-6,105,8:00 pm,Oklahoma City Thunder,111
Wed Jan 22 2014,1,Toronto Raptors,8,93,7:00 pm,Dallas Mavericks,85
Wed Jan 22 2014,0,Washington Wizards,-2,111,7:00 pm,Boston Celtics,113
Thu Jan 23 2014,1,Miami Heat,7,109,8:00 pm,Los Angeles Lakers,102
Thu Jan 23 2014,1,Portland Trail Blazers,5,110,10:30 pm,Denver Nuggets,105
Fri Jan 24 2014,0,Atlanta Hawks,-26,79,7:30 pm,San Antonio Spurs,105
Fri Jan 24 2014,0,Boston Celtics,-18,83,7:30 pm,Oklahoma City Thunder,101
Fri Jan 24 2014,1,Brooklyn Nets,1,107,7:30 pm,Dallas Mavericks,106
Fri Jan 24 2014,0,Chicago Bulls,-17,95,8:00 pm,Los Angeles Clippers,112
Fri Jan 24 2014,1,Cleveland Cavaliers,15,93,7:30 pm,Milwaukee Bucks,78
Fri Jan 24 2014,0,Detroit Pistons,-2,101,7:30 pm,New Orleans Pelicans,103
Fri Jan 24 2014,0,Golden State Warriors,-1,120,10:30 pm,Minnesota Timberwolves,121
Fri Jan 24 2014,0,Houston Rockets,-1,87,8:00 pm,Memphis Grizzlies,88
Fri Jan 24 2014,1,New York Knicks,29,125,7:30 pm,Charlotte Bobcats,96
Fri Jan 24 2014,1,Orlando Magic,9,114,7:00 pm,Los Angeles Lakers,105
Fri Jan 24 2014,0,Philadelphia 76ers,-9,95,7:00 pm,Toronto Raptors,104
Fri Jan 24 2014,0,Phoenix Suns,-6,95,9:00 pm,Washington Wizards,101
Fri Jan 24 2014,0,Sacramento Kings,-5,111,10:00 pm,Indiana Pacers,116
Sat Jan 25 2014,0,Charlotte Bobcats,-2,87,7:00 pm,Chicago Bulls,89
Sat Jan 25 2014,1,Denver Nuggets,13,109,9:00 pm,Indiana Pacers,96
Sat Jan 25 2014,1,Memphis Grizzlies,18,99,8:00 pm,Houston Rockets,81
Sat Jan 25 2014,0,Milwaukee Bucks,-25,87,8:30 pm,Atlanta Hawks,112
Sat Jan 25 2014,0,Philadelphia 76ers,-12,91,7:30 pm,Oklahoma City Thunder,103
Sat Jan 25 2014,1,Portland Trail Blazers,11,115,10:00 pm,Minnesota Timberwolves,104
Sat Jan 25 2014,0,Toronto Raptors,-8,118,7:00 pm,Los Angeles Clippers,126
Sat Jan 25 2014,1,Utah Jazz,3,104,9:00 pm,Washington Wizards,101
Sun Jan 26 2014,0,Boston Celtics,-6,79,6:30 pm,Brooklyn Nets,85
Sun Jan 26 2014,0,Cleveland Cavaliers,-9,90,6:00 pm,Phoenix Suns,99
Sun Jan 26 2014,1,Dallas Mavericks,10,116,7:30 pm,Detroit Pistons,106
Sun Jan 26 2014,1,Golden State Warriors,15,103,9:00 pm,Portland Trail Blazers,88
Sun Jan 26 2014,1,Miami Heat,12,113,1:00 pm,San Antonio Spurs,101
Sun Jan 26 2014,1,New Orleans Pelicans,8,100,6:00 pm,Orlando Magic,92
Sun Jan 26 2014,1,New York Knicks,7,110,3:30 pm,Los Angeles Lakers,103
Sun Jan 26 2014,0,Sacramento Kings,-8,117,9:00 pm,Denver Nuggets,125
Mon Jan 27 2014,0,Brooklyn Nets,-1,103,7:30 pm,Toronto Raptors,104
Mon Jan 27 2014,0,Chicago Bulls,-9,86,8:00 pm,Minnesota Timberwolves,95
Mon Jan 27 2014,0,Milwaukee Bucks,-28,86,8:00 pm,Los Angeles Clippers,114
Mon Jan 27 2014,1,Oklahoma City Thunder,2,111,8:00 pm,Atlanta Hawks,109
Mon Jan 27 2014,0,Philadelphia 76ers,-11,113,7:00 pm,Phoenix Suns,124
Mon Jan 27 2014,1,Utah Jazz,7,106,9:00 pm,Sacramento Kings,99
Tue Jan 28 2014,0,Cleveland Cavaliers,-11,89,7:00 pm,New Orleans Pelicans,100
Tue Jan 28 2014,1,Detroit Pistons,16,103,7:30 pm,Orlando Magic,87
Tue Jan 28 2014,0,Golden State Warriors,-3,85,10:30 pm,Washington Wizards,88
Tue Jan 28 2014,1,Houston Rockets,7,97,8:00 pm,San Antonio Spurs,90
Tue Jan 28 2014,0,Los Angeles Lakers,-12,92,10:30 pm,Indiana Pacers,104
Tue Jan 28 2014,1,New York Knicks,26,114,7:30 pm,Boston Celtics,88
Tue Jan 28 2014,0,Portland Trail Blazers,-17,81,10:00 pm,Memphis Grizzlies,98
Wed Jan 29 2014,0,Boston Celtics,-1,94,7:30 pm,Philadelphia 76ers,95
Wed Jan 29 2014,0,Dallas Mavericks,-2,115,8:30 pm,Houston Rockets,117
Wed Jan 29 2014,0,Denver Nuggets,-3,98,9:00 pm,Charlotte Bobcats,101
Wed Jan 29 2014,1,Los Angeles Clippers,7,110,10:30 pm,Washington Wizards,103
Wed Jan 29 2014,0,Miami Heat,-17,95,7:00 pm,Oklahoma City Thunder,112
Wed Jan 29 2014,0,Milwaukee Bucks,-9,117,8:00 pm,Phoenix Suns,126
Wed Jan 29 2014,1,Minnesota Timberwolves,11,88,8:00 pm,New Orleans Pelicans,77
Wed Jan 29 2014,0,Sacramento Kings,-10,89,10:00 pm,Memphis Grizzlies,99
Wed Jan 29 2014,0,San Antonio Spurs,-10,86,9:30 pm,Chicago Bulls,96
Wed Jan 29 2014,1,Toronto Raptors,15,98,7:00 pm,Orlando Magic,83
Thu Jan 30 2014,1,Golden State Warriors,19,111,10:30 pm,Los Angeles Clippers,92
Thu Jan 30 2014,0,Indiana Pacers,-8,94,7:00 pm,Phoenix Suns,102
Thu Jan 30 2014,1,New York Knicks,31,117,8:00 pm,Cleveland Cavaliers,86
Fri Jan 31 2014,0,Brooklyn Nets,-25,95,8:00 pm,Oklahoma City Thunder,120
Fri Jan 31 2014,1,Dallas Mavericks,4,107,8:30 pm,Sacramento Kings,103
Fri Jan 31 2014,0,Denver Nuggets,-10,90,9:00 pm,Toronto Raptors,100
Fri Jan 31 2014,0,Los Angeles Lakers,-10,100,10:30 pm,Charlotte Bobcats,110
Fri Jan 31 2014,0,Minnesota Timberwolves,-4,90,8:00 pm,Memphis Grizzlies,94
Fri Jan 31 2014,1,Orlando Magic,11,113,7:00 pm,Milwaukee Bucks,102
Fri Jan 31 2014,0,Philadelphia 76ers,-26,99,7:30 pm,Atlanta Hawks,125
Fri Jan 31 2014,0,Utah Jazz,-5,90,10:30 pm,Golden State Warriors,95
Sat Feb 1 2014,1,Atlanta Hawks,7,120,7:30 pm,Minnesota Timberwolves,113
Sat Feb 1 2014,1,Detroit Pistons,17,113,7:30 pm,Philadelphia 76ers,96
Sat Feb 1 2014,1,Houston Rockets,14,106,8:00 pm,Cleveland Cavaliers,92
Sat Feb 1 2014,1,Indiana Pacers,1,97,7:00 pm,Brooklyn Nets,96
Sat Feb 1 2014,1,Los Angeles Clippers,15,102,10:30 pm,Utah Jazz,87
Sat Feb 1 2014,1,Memphis Grizzlies,9,99,8:00 pm,Milwaukee Bucks,90
Sat Feb 1 2014,1,New Orleans Pelicans,9,88,8:00 pm,Chicago Bulls,79
Sat Feb 1 2014,0,New York Knicks,-15,91,8:30 pm,Miami Heat,106
Sat Feb 1 2014,1,Phoenix Suns,10,105,9:00 pm,Charlotte Bobcats,95
Sat Feb 1 2014,1,Portland Trail Blazers,3,106,10:00 pm,Toronto Raptors,103
Sat Feb 1 2014,1,San Antonio Spurs,2,95,8:30 pm,Sacramento Kings,93
Sat Feb 1 2014,1,Washington Wizards,15,96,7:00 pm,Oklahoma City Thunder,81
Sun Feb 2 2014,1,Boston Celtics,7,96,1:00 pm,Orlando Magic,89
Mon Feb 3 2014,1,Brooklyn Nets,6,108,7:30 pm,Philadelphia 76ers,102
Mon Feb 3 2014,1,Dallas Mavericks,17,124,8:30 pm,Cleveland Cavaliers,107
Mon Feb 3 2014,1,Denver Nuggets,1,116,9:00 pm,Los Angeles Clippers,115
Mon Feb 3 2014,1,Indiana Pacers,19,98,7:00 pm,Orlando Magic,79
Mon Feb 3 2014,1,Miami Heat,6,102,7:30 pm,Detroit Pistons,96
Mon Feb 3 2014,1,Milwaukee Bucks,3,101,8:00 pm,New York Knicks,98
Mon Feb 3 2014,0,New Orleans Pelicans,-7,95,8:00 pm,San Antonio Spurs,102
Mon Feb 3 2014,1,Oklahoma City Thunder,9,86,8:00 pm,Memphis Grizzlies,77
Mon Feb 3 2014,1,Sacramento Kings,29,99,10:00 pm,Chicago Bulls,70
Mon Feb 3 2014,0,Utah Jazz,-15,79,9:00 pm,Toronto Raptors,94
Mon Feb 3 2014,1,Washington Wizards,10,100,7:00 pm,Portland Trail Blazers,90
Tue Feb 4 2014,0,Atlanta Hawks,-4,85,7:30 pm,Indiana Pacers,89
Tue Feb 4 2014,0,Golden State Warriors,-16,75,10:30 pm,Charlotte Bobcats,91
Tue Feb 4 2014,1,Minnesota Timberwolves,10,109,8:00 pm,Los Angeles Lakers,99
Tue Feb 4 2014,0,Phoenix Suns,-9,92,9:00 pm,Chicago Bulls,101
Wed Feb 5 2014,0,Cleveland Cavaliers,-11,108,7:00 pm,Los Angeles Lakers,119
Wed Feb 5 2014,1,Denver Nuggets,10,110,9:00 pm,Milwaukee Bucks,100
Wed Feb 5 2014,1,Houston Rockets,14,122,8:00 pm,Phoenix Suns,108
Wed Feb 5 2014,0,Los Angeles Clippers,-4,112,10:30 pm,Miami Heat,116
Wed Feb 5 2014,0,Memphis Grizzlies,-14,96,8:00 pm,Dallas Mavericks,110
Wed Feb 5 2014,1,New Orleans Pelicans,5,105,8:00 pm,Atlanta Hawks,100
Wed Feb 5 2014,0,New York Knicks,-4,90,8:00 pm,Portland Trail Blazers,94
Wed Feb 5 2014,1,Oklahoma City Thunder,9,106,8:00 pm,Minnesota Timberwolves,97
Wed Feb 5 2014,1,Orlando Magic,14,112,7:00 pm,Detroit Pistons,98
Wed Feb 5 2014,0,Philadelphia 76ers,-6,108,7:00 pm,Boston Celtics,114
Wed Feb 5 2014,1,Sacramento Kings,8,109,10:00 pm,Toronto Raptors,101
Wed Feb 5 2014,0,Washington Wizards,-7,118,7:00 pm,San Antonio Spurs,125
Thu Feb 6 2014,1,Brooklyn Nets,14,103,8:00 pm,San Antonio Spurs,89
Thu Feb 6 2014,1,Golden State Warriors,15,102,10:30 pm,Chicago Bulls,87
Fri Feb 7 2014,1,Boston Celtics,10,99,7:30 pm,Sacramento Kings,89
Fri Feb 7 2014,1,Dallas Mavericks,22,103,8:30 pm,Utah Jazz,81
Fri Feb 7 2014,1,Detroit Pistons,16,111,7:30 pm,Brooklyn Nets,95
Fri Feb 7 2014,1,Indiana Pacers,5,118,7:00 pm,Portland Trail Blazers,113
Fri Feb 7 2014,1,Los Angeles Clippers,13,118,10:30 pm,Toronto Raptors,105
Fri Feb 7 2014,1,New Orleans Pelicans,7,98,9:30 pm,Minnesota Timberwolves,91
Fri Feb 7 2014,1,New York Knicks,27,117,7:30 pm,Denver Nuggets,90
Fri Feb 7 2014,1,Orlando Magic,1,103,7:00 pm,Oklahoma City Thunder,102
Fri Feb 7 2014,0,Philadelphia 76ers,-14,98,7:00 pm,Los Angeles Lakers,112
Fri Feb 7 2014,0,Washington Wizards,-2,113,7:00 pm,Cleveland Cavaliers,115
Sat Feb 8 2014,0,Atlanta Hawks,-3,76,7:30 pm,Memphis Grizzlies,79
Sat Feb 8 2014,0,Charlotte Bobcats,-4,100,7:00 pm,San Antonio Spurs,104
Sat Feb 8 2014,1,Detroit Pistons,17,126,7:30 pm,Denver Nuggets,109
Sat Feb 8 2014,0,Milwaukee Bucks,-6,95,8:30 pm,Houston Rockets,101
Sat Feb 8 2014,0,Minnesota Timberwolves,-7,110,8:00 pm,Portland Trail Blazers,117
Sat Feb 8 2014,1,Phoenix Suns,13,122,9:00 pm,Golden State Warriors,109
Sat Feb 8 2014,1,Utah Jazz,5,94,9:00 pm,Miami Heat,89
Sun Feb 9 2014,0,Boston Celtics,-11,91,6:00 pm,Dallas Mavericks,102
Sun Feb 9 2014,1,Brooklyn Nets,12,93,6:00 pm,New Orleans Pelicans,81
Sun Feb 9 2014,1,Cleveland Cavaliers,8,91,6:00 pm,Memphis Grizzlies,83
Sun Feb 9 2014,1,Los Angeles Clippers,45,123,9:30 pm,Philadelphia 76ers,78
Sun Feb 9 2014,0,Los Angeles Lakers,-6,86,3:30 pm,Chicago Bulls,92
Sun Feb 9 2014,1,Oklahoma City Thunder,12,112,1:00 pm,New York Knicks,100
Sun Feb 9 2014,1,Orlando Magic,1,93,6:00 pm,Indiana Pacers,92
Sun Feb 9 2014,1,Washington Wizards,9,93,6:00 pm,Sacramento Kings,84
Mon Feb 10 2014,1,Detroit Pistons,9,109,7:30 pm,San Antonio Spurs,100
Mon Feb 10 2014,1,Golden State Warriors,43,123,10:30 pm,Philadelphia 76ers,80
Mon Feb 10 2014,1,Indiana Pacers,39,119,7:00 pm,Denver Nuggets,80
Mon Feb 10 2014,0,Milwaukee Bucks,-16,86,8:00 pm,Boston Celtics,102
Mon Feb 10 2014,0,Minnesota Timberwolves,-18,89,8:00 pm,Houston Rockets,107
Mon Feb 10 2014,1,Toronto Raptors,7,108,7:00 pm,New Orleans Pelicans,101
Tue Feb 11 2014,1,Charlotte Bobcats,25,114,7:00 pm,Dallas Mavericks,89
Tue Feb 11 2014,1,Chicago Bulls,15,100,8:00 pm,Atlanta Hawks,85
Tue Feb 11 2014,1,Cleveland Cavaliers,10,109,7:00 pm,Sacramento Kings,99
Tue Feb 11 2014,0,Los Angeles Lakers,-17,79,10:30 pm,Utah Jazz,96
Tue Feb 11 2014,1,Memphis Grizzlies,3,92,8:00 pm,Washington Wizards,89
Tue Feb 11 2014,0,Phoenix Suns,-6,97,9:00 pm,Miami Heat,103
Tue Feb 11 2014,0,Portland Trail Blazers,-3,95,10:00 pm,Oklahoma City Thunder,98
Wed Feb 12 2014,0,Boston Celtics,-12,92,7:30 pm,San Antonio Spurs,104
Wed Feb 12 2014,1,Brooklyn Nets,16,105,7:30 pm,Charlotte Bobcats,89
Wed Feb 12 2014,0,Detroit Pistons,-4,89,7:30 pm,Cleveland Cavaliers,93
Wed Feb 12 2014,0,Golden State Warriors,-1,110,10:30 pm,Miami Heat,111
Wed Feb 12 2014,1,Houston Rockets,1,113,8:00 pm,Washington Wizards,112
Wed Feb 12 2014,0,Indiana Pacers,-8,73,7:00 pm,Dallas Mavericks,81
Wed Feb 12 2014,1,Los Angeles Clippers,5,122,10:30 pm,Portland Trail Blazers,117
Wed Feb 12 2014,0,Milwaukee Bucks,-4,98,8:00 pm,New Orleans Pelicans,102
Wed Feb 12 2014,1,Minnesota Timberwolves,27,117,8:00 pm,Denver Nuggets,90
Wed Feb 12 2014,0,New York Knicks,-5,101,7:30 pm,Sacramento Kings,106
Wed Feb 12 2014,0,Orlando Magic,-5,81,7:00 pm,Memphis Grizzlies,86
Wed Feb 12 2014,1,Toronto Raptors,21,104,7:00 pm,Atlanta Hawks,83
Wed Feb 12 2014,1,Utah Jazz,5,105,9:00 pm,Philadelphia 76ers,100
Thu Feb 13 2014,1,Chicago Bulls,16,92,8:00 pm,Brooklyn Nets,76
Thu Feb 13 2014,0,Los Angeles Lakers,-4,103,10:30 pm,Oklahoma City Thunder,107
Tue Feb 18 2014,0,Dallas Mavericks,-11,106,8:30 pm,Miami Heat,117
Tue Feb 18 2014,0,Denver Nuggets,-5,107,9:00 pm,Phoenix Suns,112
Tue Feb 18 2014,0,Detroit Pistons,-12,96,7:30 pm,Charlotte Bobcats,108
Tue Feb 18 2014,1,Indiana Pacers,10,108,7:00 pm,Atlanta Hawks,98
Tue Feb 18 2014,0,Los Angeles Clippers,-10,103,10:30 pm,San Antonio Spurs,113
Tue Feb 18 2014,1,Memphis Grizzlies,5,98,8:00 pm,New York Knicks,93
Tue Feb 18 2014,1,Milwaukee Bucks,4,104,8:00 pm,Orlando Magic,100
Tue Feb 18 2014,0,Philadelphia 76ers,-29,85,7:00 pm,Cleveland Cavaliers,114
Tue Feb 18 2014,0,Washington Wizards,-10,93,7:00 pm,Toronto Raptors,103
Wed Feb 19 2014,0,Atlanta Hawks,-17,97,7:30 pm,Washington Wizards,114
Wed Feb 19 2014,1,Charlotte Bobcats,18,116,7:00 pm,Detroit Pistons,98
Wed Feb 19 2014,1,Cleveland Cavaliers,8,101,7:00 pm,Orlando Magic,93
Wed Feb 19 2014,0,Los Angeles Lakers,-26,108,10:30 pm,Houston Rockets,134
Wed Feb 19 2014,1,Minnesota Timberwolves,13,104,8:00 pm,Indiana Pacers,91
Wed Feb 19 2014,0,New Orleans Pelicans,-7,91,8:00 pm,New York Knicks,98
Wed Feb 19 2014,1,Phoenix Suns,6,100,9:00 pm,Boston Celtics,94
Wed Feb 19 2014,0,Portland Trail Blazers,-2,109,10:00 pm,San Antonio Spurs,111
Wed Feb 19 2014,0,Sacramento Kings,-9,92,10:00 pm,Golden State Warriors,101
Wed Feb 19 2014,0,Toronto Raptors,-2,92,7:00 pm,Chicago Bulls,94
Wed Feb 19 2014,0,Utah Jazz,-6,99,9:00 pm,Brooklyn Nets,105
Thu Feb 20 2014,1,Golden State Warriors,3,102,10:30 pm,Houston Rockets,99
Thu Feb 20 2014,0,Milwaukee Bucks,-11,90,8:00 pm,Denver Nuggets,101
Thu Feb 20 2014,0,Oklahoma City Thunder,-22,81,8:00 pm,Miami Heat,103
Fri Feb 21 2014,1,Charlotte Bobcats,3,90,7:00 pm,New Orleans Pelicans,87
Fri Feb 21 2014,1,Chicago Bulls,28,117,8:00 pm,Denver Nuggets,89
Fri Feb 21 2014,1,Detroit Pistons,8,115,7:30 pm,Atlanta Hawks,107
Fri Feb 21 2014,1,Los Angeles Lakers,9,101,10:30 pm,Boston Celtics,92
Fri Feb 21 2014,1,Memphis Grizzlies,6,102,8:00 pm,Los Angeles Clippers,96
Fri Feb 21 2014,1,Orlando Magic,8,129,7:00 pm,New York Knicks,121
Fri Feb 21 2014,0,Philadelphia 76ers,-12,112,7:00 pm,Dallas Mavericks,124
Fri Feb 21 2014,1,Phoenix Suns,21,106,9:00 pm,San Antonio Spurs,85
Fri Feb 21 2014,1,Portland Trail Blazers,8,102,10:00 pm,Utah Jazz,94
Fri Feb 21 2014,1,Toronto Raptors,7,98,7:00 pm,Cleveland Cavaliers,91
Sat Feb 22 2014,1,Atlanta Hawks,9,107,7:30 pm,New York Knicks,98
Sat Feb 22 2014,1,Charlotte Bobcats,3,92,7:00 pm,Memphis Grizzlies,89
Sat Feb 22 2014,0,Detroit Pistons,-11,102,7:30 pm,Dallas Mavericks,113
Sat Feb 22 2014,1,Golden State Warriors,7,93,10:30 pm,Brooklyn Nets,86
Sat Feb 22 2014,0,Milwaukee Bucks,-10,100,8:30 pm,Indiana Pacers,110
Sat Feb 22 2014,1,Sacramento Kings,7,105,10:00 pm,Boston Celtics,98
Sat Feb 22 2014,0,Utah Jazz,-17,104,9:00 pm,Minnesota Timberwolves,121
Sat Feb 22 2014,1,Washington Wizards,1,94,7:00 pm,New Orleans Pelicans,93
Sun Feb 23 2014,0,Cleveland Cavaliers,-13,83,6:00 pm,Washington Wizards,96
Sun Feb 23 2014,0,Denver Nuggets,-14,95,8:00 pm,Sacramento Kings,109
Sun Feb 23 2014,0,Los Angeles Lakers,-6,102,9:00 pm,Brooklyn Nets,108
Sun Feb 23 2014,1,Miami Heat,14,93,3:30 pm,Chicago Bulls,79
Sun Feb 23 2014,0,Oklahoma City Thunder,-8,117,1:00 pm,Los Angeles Clippers,125
Sun Feb 23 2014,0,Phoenix Suns,-3,112,9:00 pm,Houston Rockets,115
Sun Feb 23 2014,1,Portland Trail Blazers,11,108,9:00 pm,Minnesota Timberwolves,97
Sun Feb 23 2014,1,Toronto Raptors,15,105,6:00 pm,Orlando Magic,90
Mon Feb 24 2014,0,Detroit Pistons,-8,96,7:30 pm,Golden State Warriors,104
Mon Feb 24 2014,0,New Orleans Pelicans,-13,110,8:00 pm,Los Angeles Clippers,123
Mon Feb 24 2014,0,New York Knicks,-2,108,7:30 pm,Dallas Mavericks,110
Mon Feb 24 2014,0,Philadelphia 76ers,-20,110,7:00 pm,Milwaukee Bucks,130
Mon Feb 24 2014,1,Utah Jazz,12,110,9:00 pm,Boston Celtics,98
Tue Feb 25 2014,0,Atlanta Hawks,-4,103,7:30 pm,Chicago Bulls,107
Tue Feb 25 2014,0,Cleveland Cavaliers,-6,93,7:00 pm,Toronto Raptors,99
Tue Feb 25 2014,0,Denver Nuggets,-5,95,9:00 pm,Portland Trail Blazers,100
Tue Feb 25 2014,1,Indiana Pacers,20,118,7:00 pm,Los Angeles Lakers,98
Tue Feb 25 2014,0,Phoenix Suns,-9,101,9:00 pm,Minnesota Timberwolves,110
Tue Feb 25 2014,0,Sacramento Kings,-26,103,10:00 pm,Houston Rockets,129
Tue Feb 25 2014,1,Washington Wizards,9,115,7:00 pm,Orlando Magic,106
Wed Feb 26 2014,1,Boston Celtics,11,115,7:30 pm,Atlanta Hawks,104
Wed Feb 26 2014,1,Chicago Bulls,20,103,8:00 pm,Golden State Warriors,83
Wed Feb 26 2014,1,Dallas Mavericks,19,108,8:00 pm,New Orleans Pelicans,89
Wed Feb 26 2014,1,Los Angeles Clippers,8,101,10:30 pm,Houston Rockets,93
Wed Feb 26 2014,1,Memphis Grizzlies,5,108,8:00 pm,Los Angeles Lakers,103
Wed Feb 26 2014,0,Oklahoma City Thunder,-10,104,8:00 pm,Cleveland Cavaliers,114
Wed Feb 26 2014,0,Philadelphia 76ers,-11,90,7:00 pm,Orlando Magic,101
Wed Feb 26 2014,1,Portland Trail Blazers,44,124,10:00 pm,Brooklyn Nets,80
Wed Feb 26 2014,1,San Antonio Spurs,10,120,8:30 pm,Detroit Pistons,110
Wed Feb 26 2014,1,Utah Jazz,23,109,9:00 pm,Phoenix Suns,86
Thu Feb 27 2014,0,Denver Nuggets,-23,89,10:30 pm,Brooklyn Nets,112
Thu Feb 27 2014,1,Indiana Pacers,5,101,7:00 pm,Milwaukee Bucks,96
Thu Feb 27 2014,1,Miami Heat,26,108,8:00 pm,New York Knicks,82
Thu Feb 27 2014,0,Toronto Raptors,-5,129,7:00 pm,Washington Wizards,134
Fri Feb 28 2014,1,Cleveland Cavaliers,20,99,7:30 pm,Utah Jazz,79
Fri Feb 28 2014,0,Dallas Mavericks,-9,91,8:30 pm,Chicago Bulls,100
Fri Feb 28 2014,1,Los Angeles Lakers,4,126,10:30 pm,Sacramento Kings,122
Fri Feb 28 2014,0,New York Knicks,-23,103,8:00 pm,Golden State Warriors,126
Fri Feb 28 2014,1,Oklahoma City Thunder,6,113,8:00 pm,Memphis Grizzlies,107
Fri Feb 28 2014,1,Phoenix Suns,12,116,10:30 pm,New Orleans Pelicans,104
Fri Feb 28 2014,1,San Antonio Spurs,10,92,8:30 pm,Charlotte Bobcats,82
Sat Mar 1 2014,0,Boston Celtics,-5,97,8:00 pm,Indiana Pacers,102
Sat Mar 1 2014,1,Houston Rockets,8,118,8:00 pm,Detroit Pistons,110
Sat Mar 1 2014,1,Los Angeles Clippers,32,108,10:30 pm,New Orleans Pelicans,76
Sat Mar 1 2014,1,Memphis Grizzlies,14,110,9:00 pm,Cleveland Cavaliers,96
Sat Mar 1 2014,1,Miami Heat,14,112,7:30 pm,Orlando Magic,98
Sat Mar 1 2014,0,Milwaukee Bucks,-9,98,8:30 pm,Brooklyn Nets,107
Sat Mar 1 2014,0,Philadelphia 76ers,-19,103,7:30 pm,Washington Wizards,122
Sat Mar 1 2014,1,Portland Trail Blazers,6,102,10:00 pm,Denver Nuggets,96
Sat Mar 1 2014,0,Sacramento Kings,-11,97,10:00 pm,Minnesota Timberwolves,108
Sun Mar 2 2014,1,Chicago Bulls,19,109,1:00 pm,New York Knicks,90
Sun Mar 2 2014,1,Indiana Pacers,3,94,6:00 pm,Utah Jazz,91
Sun Mar 2 2014,1,Oklahoma City Thunder,17,116,7:00 pm,Charlotte Bobcats,99
Sun Mar 2 2014,1,Orlando Magic,11,92,6:00 pm,Philadelphia 76ers,81
Sun Mar 2 2014,1,Phoenix Suns,9,129,8:00 pm,Atlanta Hawks,120
Sun Mar 2 2014,1,San Antonio Spurs,6,112,7:00 pm,Dallas Mavericks,106
Sun Mar 2 2014,1,Toronto Raptors,6,104,4:00 pm,Golden State Warriors,98
Mon Mar 3 2014,1,Brooklyn Nets,16,96,7:30 pm,Chicago Bulls,80
Mon Mar 3 2014,0,Denver Nuggets,-4,128,9:00 pm,Minnesota Timberwolves,132
Mon Mar 3 2014,1,Detroit Pistons,11,96,7:30 pm,New York Knicks,85
Mon Mar 3 2014,1,Miami Heat,17,124,7:30 pm,Charlotte Bobcats,107
Mon Mar 3 2014,1,Milwaukee Bucks,26,114,8:00 pm,Utah Jazz,88
Mon Mar 3 2014,0,Portland Trail Blazers,-1,106,10:00 pm,Los Angeles Lakers,107
Mon Mar 3 2014,1,Sacramento Kings,7,96,10:00 pm,New Orleans Pelicans,89
Mon Mar 3 2014,0,Washington Wizards,-6,104,7:00 pm,Memphis Grizzlies,110
Tue Mar 4 2014,0,Cleveland Cavaliers,-21,101,7:00 pm,San Antonio Spurs,122
Tue Mar 4 2014,1,Houston Rockets,3,106,8:00 pm,Miami Heat,103
Tue Mar 4 2014,0,Indiana Pacers,-2,96,7:00 pm,Golden State Warriors,98
Tue Mar 4 2014,0,Los Angeles Lakers,-7,125,10:30 pm,New Orleans Pelicans,132
Tue Mar 4 2014,1,Oklahoma City Thunder,33,125,8:00 pm,Philadelphia 76ers,92
Tue Mar 4 2014,0,Phoenix Suns,-8,96,9:00 pm,Los Angeles Clippers,104
Wed Mar 5 2014,0,Boston Celtics,-20,88,7:30 pm,Golden State Warriors,108
Wed Mar 5 2014,1,Brooklyn Nets,9,103,7:30 pm,Memphis Grizzlies,94
Wed Mar 5 2014,1,Charlotte Bobcats,22,109,7:00 pm,Indiana Pacers,87
Wed Mar 5 2014,1,Denver Nuggets,5,115,8:00 pm,Dallas Mavericks,110
Wed Mar 5 2014,0,Detroit Pistons,-11,94,7:30 pm,Chicago Bulls,105
Wed Mar 5 2014,0,Milwaukee Bucks,-14,102,8:00 pm,Sacramento Kings,116
Wed Mar 5 2014,0,Minnesota Timberwolves,-12,106,8:00 pm,New York Knicks,118
Wed Mar 5 2014,0,Orlando Magic,-12,89,7:00 pm,Houston Rockets,101
Wed Mar 5 2014,1,Portland Trail Blazers,24,102,10:30 pm,Atlanta Hawks,78
Wed Mar 5 2014,1,Washington Wizards,13,104,7:00 pm,Utah Jazz,91
Thu Mar 6 2014,0,Los Angeles Lakers,-48,94,10:30 pm,Los Angeles Clippers,142
Thu Mar 6 2014,1,Phoenix Suns,6,128,9:00 pm,Oklahoma City Thunder,122
Thu Mar 6 2014,1,San Antonio Spurs,24,111,8:00 pm,Miami Heat,87
Fri Mar 7 2014,1,Boston Celtics,7,91,7:30 pm,Brooklyn Nets,84
Fri Mar 7 2014,1,Charlotte Bobcats,9,101,7:00 pm,Cleveland Cavaliers,92
Fri Mar 7 2014,0,Chicago Bulls,-8,77,7:00 pm,Memphis Grizzlies,85
Fri Mar 7 2014,1,Dallas Mavericks,5,103,8:30 pm,Portland Trail Blazers,98
Fri Mar 7 2014,1,Denver Nuggets,8,134,9:00 pm,Los Angeles Lakers,126
Fri Mar 7 2014,1,Golden State Warriors,14,111,10:30 pm,Atlanta Hawks,97
Fri Mar 7 2014,1,Houston Rockets,26,112,9:30 pm,Indiana Pacers,86
Fri Mar 7 2014,1,Minnesota Timberwolves,13,114,8:00 pm,Detroit Pistons,101
Fri Mar 7 2014,1,New Orleans Pelicans,8,112,8:00 pm,Milwaukee Bucks,104
Fri Mar 7 2014,1,New York Knicks,27,108,7:30 pm,Utah Jazz,81
Fri Mar 7 2014,1,Toronto Raptors,12,99,7:00 pm,Sacramento Kings,87
Sat Mar 8 2014,0,Cleveland Cavaliers,-10,97,7:30 pm,New York Knicks,107
Sat Mar 8 2014,1,Los Angeles Clippers,1,109,10:30 pm,Atlanta Hawks,108
Sat Mar 8 2014,1,Memphis Grizzlies,22,111,8:00 pm,Charlotte Bobcats,89
Sat Mar 8 2014,0,Milwaukee Bucks,-7,107,9:00 pm,Washington Wizards,114
Sat Mar 8 2014,0,Philadelphia 76ers,-12,92,7:30 pm,Utah Jazz,104
Sat Mar 8 2014,1,San Antonio Spurs,9,121,8:30 pm,Orlando Magic,112
Sun Mar 9 2014,1,Boston Celtics,7,118,6:00 pm,Detroit Pistons,111
Sun Mar 9 2014,1,Brooklyn Nets,15,104,6:00 pm,Sacramento Kings,89
Sun Mar 9 2014,1,Chicago Bulls,7,95,1:00 pm,Miami Heat,88
Sun Mar 9 2014,1,Dallas Mavericks,11,105,7:30 pm,Indiana Pacers,94
Sun Mar 9 2014,1,Golden State Warriors,6,113,9:00 pm,Phoenix Suns,107
Sun Mar 9 2014,1,Houston Rockets,5,118,7:00 pm,Portland Trail Blazers,113
Sun Mar 9 2014,1,Los Angeles Lakers,4,114,3:30 pm,Oklahoma City Thunder,110
Sun Mar 9 2014,0,Minnesota Timberwolves,-7,104,7:00 pm,Toronto Raptors,111
Sun Mar 9 2014,1,New Orleans Pelicans,4,111,6:00 pm,Denver Nuggets,107
Mon Mar 10 2014,1,Brooklyn Nets,4,101,7:30 pm,Toronto Raptors,97
Mon Mar 10 2014,1,Charlotte Bobcats,7,105,7:00 pm,Denver Nuggets,98
Mon Mar 10 2014,1,Los Angeles Clippers,7,112,10:30 pm,Phoenix Suns,105
Mon Mar 10 2014,1,Miami Heat,9,99,7:30 pm,Washington Wizards,90
Mon Mar 10 2014,1,Milwaukee Bucks,7,105,8:00 pm,Orlando Magic,98
Mon Mar 10 2014,1,New York Knicks,13,123,7:30 pm,Philadelphia 76ers,110
Mon Mar 10 2014,0,Utah Jazz,-2,110,9:00 pm,Atlanta Hawks,112
Tue Mar 11 2014,0,Chicago Bulls,-8,96,8:00 pm,San Antonio Spurs,104
Tue Mar 11 2014,1,Detroit Pistons,10,99,7:30 pm,Sacramento Kings,89
Tue Mar 11 2014,1,Golden State Warriors,23,108,10:30 pm,Dallas Mavericks,85
Tue Mar 11 2014,1,Indiana Pacers,11,94,7:00 pm,Boston Celtics,83
Tue Mar 11 2014,1,Memphis Grizzlies,10,109,8:00 pm,Portland Trail Blazers,99
Tue Mar 11 2014,1,Minnesota Timberwolves,11,112,8:00 pm,Milwaukee Bucks,101
Tue Mar 11 2014,1,Oklahoma City Thunder,8,106,8:00 pm,Houston Rockets,98
Wed Mar 12 2014,0,Boston Celtics,-24,92,7:30 pm,New York Knicks,116
Wed Mar 12 2014,1,Los Angeles Clippers,13,111,10:30 pm,Golden State Warriors,98
Wed Mar 12 2014,0,Miami Heat,-1,95,7:00 pm,Brooklyn Nets,96
Wed Mar 12 2014,0,New Orleans Pelicans,-2,88,8:00 pm,Memphis Grizzlies,90
Wed Mar 12 2014,0,Orlando Magic,-8,112,7:00 pm,Denver Nuggets,120
Wed Mar 12 2014,0,Philadelphia 76ers,-17,98,7:00 pm,Sacramento Kings,115
Wed Mar 12 2014,0,Phoenix Suns,-9,101,10:00 pm,Cleveland Cavaliers,110
Wed Mar 12 2014,1,San Antonio Spurs,13,103,9:30 pm,Portland Trail Blazers,90
Wed Mar 12 2014,1,Toronto Raptors,14,101,7:00 pm,Detroit Pistons,87
Wed Mar 12 2014,0,Utah Jazz,-7,101,9:00 pm,Dallas Mavericks,108
Wed Mar 12 2014,0,Washington Wizards,-13,85,7:00 pm,Charlotte Bobcats,98
Thu Mar 13 2014,1,Atlanta Hawks,5,102,7:30 pm,Milwaukee Bucks,97
Thu Mar 13 2014,1,Chicago Bulls,24,111,7:00 pm,Houston Rockets,87
Thu Mar 13 2014,1,Oklahoma City Thunder,29,131,9:30 pm,Los Angeles Lakers,102
Fri Mar 14 2014,0,Boston Celtics,-7,80,7:30 pm,Phoenix Suns,87
Fri Mar 14 2014,1,Charlotte Bobcats,12,105,7:00 pm,Minnesota Timberwolves,93
Fri Mar 14 2014,0,Golden State Warriors,-9,94,10:30 pm,Cleveland Cavaliers,103
Fri Mar 14 2014,0,Miami Heat,-4,107,7:30 pm,Denver Nuggets,111
Fri Mar 14 2014,0,New Orleans Pelicans,-8,103,8:00 pm,Portland Trail Blazers,111
Fri Mar 14 2014,0,Orlando Magic,-4,101,7:00 pm,Washington Wizards,105
Fri Mar 14 2014,0,Philadelphia 76ers,-7,94,7:00 pm,Indiana Pacers,101
Fri Mar 14 2014,1,San Antonio Spurs,34,119,8:30 pm,Los Angeles Lakers,85
Fri Mar 14 2014,1,Toronto Raptors,13,99,7:00 pm,Memphis Grizzlies,86
Fri Mar 14 2014,0,Utah Jazz,-9,87,9:00 pm,Los Angeles Clippers,96
Sat Mar 15 2014,1,Atlanta Hawks,5,97,7:30 pm,Denver Nuggets,92
Sat Mar 15 2014,1,Chicago Bulls,7,94,8:00 pm,Sacramento Kings,87
Sat Mar 15 2014,0,Detroit Pistons,-8,104,7:30 pm,Indiana Pacers,112
Sat Mar 15 2014,1,New York Knicks,21,115,12:00 am,Milwaukee Bucks,94
Sat Mar 15 2014,0,Philadelphia 76ers,-26,77,7:30 pm,Memphis Grizzlies,103
Sat Mar 15 2014,1,Washington Wizards,7,101,7:00 pm,Brooklyn Nets,94
Sun Mar 16 2014,1,Los Angeles Clippers,22,102,9:30 pm,Cleveland Cavaliers,80
Sun Mar 16 2014,1,Miami Heat,9,113,3:30 pm,Houston Rockets,104
Sun Mar 16 2014,0,Milwaukee Bucks,-9,92,1:00 pm,Charlotte Bobcats,101
Sun Mar 16 2014,1,Minnesota Timberwolves,2,104,7:00 pm,Sacramento Kings,102
Sun Mar 16 2014,1,New Orleans Pelicans,1,121,6:00 pm,Boston Celtics,120
Sun Mar 16 2014,0,Oklahoma City Thunder,-23,86,7:00 pm,Dallas Mavericks,109
Sun Mar 16 2014,0,Portland Trail Blazers,-1,112,9:00 pm,Golden State Warriors,113
Sun Mar 16 2014,1,San Antonio Spurs,18,122,7:00 pm,Utah Jazz,104
Sun Mar 16 2014,0,Toronto Raptors,-8,113,1:00 pm,Phoenix Suns,121
Mon Mar 17 2014,1,Brooklyn Nets,13,108,7:30 pm,Phoenix Suns,95
Mon Mar 17 2014,0,Charlotte Bobcats,-14,83,7:00 pm,Atlanta Hawks,97
Mon Mar 17 2014,0,Chicago Bulls,-12,85,8:00 pm,Oklahoma City Thunder,97
Mon Mar 17 2014,1,Dallas Mavericks,5,94,8:30 pm,Boston Celtics,89
Mon Mar 17 2014,1,Denver Nuggets,10,110,10:30 pm,Los Angeles Clippers,100
Mon Mar 17 2014,1,Houston Rockets,38,124,8:00 pm,Utah Jazz,86
Mon Mar 17 2014,1,Indiana Pacers,9,99,7:00 pm,Philadelphia 76ers,90
Tue Mar 18 2014,1,Atlanta Hawks,5,118,7:30 pm,Toronto Raptors,113
Tue Mar 18 2014,0,Cleveland Cavaliers,-4,96,7:00 pm,Miami Heat,100
Tue Mar 18 2014,1,Golden State Warriors,14,103,10:30 pm,Orlando Magic,89
Tue Mar 18 2014,1,Portland Trail Blazers,5,120,10:00 pm,Milwaukee Bucks,115
Tue Mar 18 2014,1,Sacramento Kings,6,117,10:00 pm,Washington Wizards,111
Wed Mar 19 2014,1,Boston Celtics,5,101,7:30 pm,Miami Heat,96
Wed Mar 19 2014,1,Brooklyn Nets,5,104,7:30 pm,Charlotte Bobcats,99
Wed Mar 19 2014,0,Dallas Mavericks,-1,122,8:30 pm,Minnesota Timberwolves,123
Wed Mar 19 2014,1,Denver Nuggets,9,118,9:00 pm,Detroit Pistons,109
Wed Mar 19 2014,0,Los Angeles Lakers,-16,109,10:30 pm,San Antonio Spurs,125
Wed Mar 19 2014,1,Memphis Grizzlies,10,96,8:00 pm,Utah Jazz,86
Wed Mar 19 2014,0,New Orleans Pelicans,-7,100,8:00 pm,Toronto Raptors,107
Wed Mar 19 2014,1,New York Knicks,6,92,8:00 pm,Indiana Pacers,86
Wed Mar 19 2014,0,Philadelphia 76ers,-8,94,7:00 pm,Chicago Bulls,102
Wed Mar 19 2014,1,Phoenix Suns,16,109,10:00 pm,Orlando Magic,93
Thu Mar 20 2014,0,Cleveland Cavaliers,-7,95,7:00 pm,Oklahoma City Thunder,102
Thu Mar 20 2014,1,Golden State Warriors,5,115,10:30 pm,Milwaukee Bucks,110
Thu Mar 20 2014,1,Houston Rockets,23,129,8:00 pm,Minnesota Timberwolves,106
Thu Mar 20 2014,1,Portland Trail Blazers,13,116,10:00 pm,Washington Wizards,103
Fri Mar 21 2014,0,Atlanta Hawks,-6,105,7:30 pm,New Orleans Pelicans,111
Fri Mar 21 2014,1,Brooklyn Nets,16,114,7:30 pm,Boston Celtics,98
Fri Mar 21 2014,1,Dallas Mavericks,16,122,8:30 pm,Denver Nuggets,106
Fri Mar 21 2014,1,Indiana Pacers,12,91,7:00 pm,Chicago Bulls,79
Fri Mar 21 2014,0,Los Angeles Lakers,-10,107,10:30 pm,Washington Wizards,117
Fri Mar 21 2014,1,Miami Heat,5,91,7:30 pm,Memphis Grizzlies,86
Fri Mar 21 2014,0,Philadelphia 76ers,-1,92,7:00 pm,New York Knicks,93
Fri Mar 21 2014,1,Phoenix Suns,6,98,10:00 pm,Detroit Pistons,92
Fri Mar 21 2014,0,Sacramento Kings,-20,79,10:00 pm,San Antonio Spurs,99
Fri Mar 21 2014,0,Toronto Raptors,-1,118,7:00 pm,Oklahoma City Thunder,119
Sat Mar 22 2014,1,Charlotte Bobcats,30,124,7:00 pm,Portland Trail Blazers,94
Sat Mar 22 2014,1,Chicago Bulls,10,91,8:00 pm,Philadelphia 76ers,81
Sat Mar 22 2014,0,Cleveland Cavaliers,-7,111,7:30 pm,Houston Rockets,118
Sat Mar 22 2014,0,Golden State Warriors,-9,90,10:30 pm,San Antonio Spurs,99
Sat Mar 22 2014,1,Los Angeles Clippers,9,112,10:30 pm,Detroit Pistons,103
Sat Mar 22 2014,1,Memphis Grizzlies,11,82,8:00 pm,Indiana Pacers,71
Sat Mar 22 2014,1,New Orleans Pelicans,10,105,8:00 pm,Miami Heat,95
Sat Mar 22 2014,1,Utah Jazz,1,89,9:00 pm,Orlando Magic,88
Sun Mar 23 2014,0,Dallas Mavericks,-3,104,7:30 pm,Brooklyn Nets,107
Sun Mar 23 2014,1,Denver Nuggets,3,105,5:00 pm,Washington Wizards,102
Sun Mar 23 2014,1,Los Angeles Lakers,9,103,9:30 pm,Orlando Magic,94
Sun Mar 23 2014,0,Minnesota Timberwolves,-7,120,3:30 pm,Phoenix Suns,127
Sun Mar 23 2014,0,New York Knicks,-6,100,7:30 pm,Cleveland Cavaliers,106
Sun Mar 23 2014,1,Sacramento Kings,17,124,6:00 pm,Milwaukee Bucks,107
Sun Mar 23 2014,1,Toronto Raptors,10,96,1:00 pm,Atlanta Hawks,86
Mon Mar 24 2014,0,Atlanta Hawks,-7,95,7:30 pm,Phoenix Suns,102
Mon Mar 24 2014,0,Charlotte Bobcats,-11,89,7:00 pm,Houston Rockets,100
Mon Mar 24 2014,1,Chicago Bulls,12,89,8:00 pm,Indiana Pacers,77
Mon Mar 24 2014,1,Los Angeles Clippers,8,106,10:30 pm,Milwaukee Bucks,98
Mon Mar 24 2014,1,Memphis Grizzlies,17,109,8:00 pm,Minnesota Timberwolves,92
Mon Mar 24 2014,1,Miami Heat,2,93,7:30 pm,Portland Trail Blazers,91
Mon Mar 24 2014,1,New Orleans Pelicans,5,109,8:00 pm,Brooklyn Nets,104
Mon Mar 24 2014,1,Oklahoma City Thunder,21,117,8:00 pm,Denver Nuggets,96
Mon Mar 24 2014,1,San Antonio Spurs,22,113,8:30 pm,Philadelphia 76ers,91
Mon Mar 24 2014,0,Utah Jazz,-20,94,9:00 pm,Detroit Pistons,114
Tue Mar 25 2014,1,Cleveland Cavaliers,2,102,7:00 pm,Toronto Raptors,100
Tue Mar 25 2014,1,Dallas Mavericks,9,128,8:00 pm,Oklahoma City Thunder,119
Tue Mar 25 2014,1,Los Angeles Lakers,31,127,10:30 pm,New York Knicks,96
Tue Mar 25 2014,1,Orlando Magic,10,95,7:00 pm,Portland Trail Blazers,85
Wed Mar 26 2014,0,Boston Celtics,-9,90,7:30 pm,Toronto Raptors,99
Wed Mar 26 2014,1,Charlotte Bobcats,5,116,7:00 pm,Brooklyn Nets,111
Wed Mar 26 2014,0,Detroit Pistons,-1,96,7:30 pm,Cleveland Cavaliers,97
Wed Mar 26 2014,1,Indiana Pacers,1,84,8:00 pm,Miami Heat,83
Wed Mar 26 2014,1,Minnesota Timberwolves,24,107,8:00 pm,Atlanta Hawks,83
Wed Mar 26 2014,1,New Orleans Pelicans,2,98,8:00 pm,Los Angeles Clippers,96
Wed Mar 26 2014,0,Sacramento Kings,-8,99,10:00 pm,New York Knicks,107
Wed Mar 26 2014,1,San Antonio Spurs,5,108,8:30 pm,Denver Nuggets,103
Wed Mar 26 2014,0,Utah Jazz,-4,87,10:30 pm,Memphis Grizzlies,91
Wed Mar 26 2014,0,Washington Wizards,-6,93,7:00 pm,Phoenix Suns,99
Thu Mar 27 2014,0,Atlanta Hawks,-15,85,7:30 pm,Portland Trail Blazers,100
Thu Mar 27 2014,0,Dallas Mavericks,-6,103,8:30 pm,Los Angeles Clippers,109
Thu Mar 27 2014,1,Houston Rockets,22,120,8:00 pm,Philadelphia 76ers,98
Thu Mar 27 2014,1,Milwaukee Bucks,3,108,8:00 pm,Los Angeles Lakers,105
Fri Mar 28 2014,1,Brooklyn Nets,11,108,7:30 pm,Cleveland Cavaliers,97
Fri Mar 28 2014,0,Chicago Bulls,-17,74,8:00 pm,Portland Trail Blazers,91
Fri Mar 28 2014,0,Denver Nuggets,-31,102,9:00 pm,San Antonio Spurs,133
Fri Mar 28 2014,0,Detroit Pistons,-32,78,7:30 pm,Miami Heat,110
Fri Mar 28 2014,1,Golden State Warriors,7,100,10:30 pm,Memphis Grizzlies,93
Fri Mar 28 2014,1,Minnesota Timberwolves,36,143,8:00 pm,Los Angeles Lakers,107
Fri Mar 28 2014,1,New Orleans Pelicans,7,102,8:00 pm,Utah Jazz,95
Fri Mar 28 2014,1,Oklahoma City Thunder,13,94,8:00 pm,Sacramento Kings,81
Fri Mar 28 2014,1,Orlando Magic,5,110,7:00 pm,Charlotte Bobcats,105
Fri Mar 28 2014,1,Phoenix Suns,24,112,10:00 pm,New York Knicks,88
Fri Mar 28 2014,1,Toronto Raptors,2,105,7:00 pm,Boston Celtics,103
Fri Mar 28 2014,1,Washington Wizards,13,91,7:00 pm,Indiana Pacers,78
Sat Mar 29 2014,1,Dallas Mavericks,3,103,8:30 pm,Sacramento Kings,100
Sat Mar 29 2014,0,Houston Rockets,-11,107,8:00 pm,Los Angeles Clippers,118
Sat Mar 29 2014,0,Milwaukee Bucks,-21,67,8:30 pm,Miami Heat,88
Sat Mar 29 2014,1,Philadelphia 76ers,25,123,7:30 pm,Detroit Pistons,98
Sat Mar 29 2014,1,San Antonio Spurs,16,96,8:30 pm,New Orleans Pelicans,80
Sat Mar 29 2014,1,Washington Wizards,4,101,8:00 pm,Atlanta Hawks,97
Sun Mar 30 2014,0,Boston Celtics,-5,102,7:00 pm,Chicago Bulls,107
Sun Mar 30 2014,1,Brooklyn Nets,15,114,6:00 pm,Minnesota Timberwolves,99
Sun Mar 30 2014,1,Cleveland Cavaliers,14,90,3:00 pm,Indiana Pacers,76
Sun Mar 30 2014,0,Golden State Warriors,-5,84,9:00 pm,New York Knicks,89
Sun Mar 30 2014,1,Los Angeles Lakers,16,115,9:30 pm,Phoenix Suns,99
Sun Mar 30 2014,1,Oklahoma City Thunder,20,116,3:00 pm,Utah Jazz,96
Sun Mar 30 2014,0,Orlando Magic,-5,93,6:00 pm,Toronto Raptors,98
Sun Mar 30 2014,1,Portland Trail Blazers,7,105,9:00 pm,Memphis Grizzlies,98
Mon Mar 31 2014,1,Atlanta Hawks,8,103,7:30 pm,Philadelphia 76ers,95
Mon Mar 31 2014,1,Charlotte Bobcats,6,100,7:00 pm,Washington Wizards,94
Mon Mar 31 2014,1,Chicago Bulls,14,94,8:00 pm,Boston Celtics,80
Mon Mar 31 2014,0,Denver Nuggets,-2,92,9:00 pm,Memphis Grizzlies,94
Mon Mar 31 2014,1,Detroit Pistons,5,116,7:30 pm,Milwaukee Bucks,111
Mon Mar 31 2014,0,Indiana Pacers,-26,77,7:00 pm,San Antonio Spurs,103
Mon Mar 31 2014,1,Miami Heat,10,93,7:30 pm,Toronto Raptors,83
Mon Mar 31 2014,0,Minnesota Timberwolves,-10,104,8:00 pm,Los Angeles Clippers,114
Mon Mar 31 2014,0,New Orleans Pelicans,-5,97,8:00 pm,Sacramento Kings,102
Mon Mar 31 2014,0,Utah Jazz,-9,83,9:00 pm,New York Knicks,92
Tue Oct 30 2012,1,Cleveland Cavaliers,10,94,7:00 pm,Washington Wizards,84
Tue Oct 30 2012,0,Los Angeles Lakers,-8,91,7:30 pm,Dallas Mavericks,99
Tue Oct 30 2012,1,Miami Heat,13,120,8:00 pm,Boston Celtics,107
Wed Oct 31 2012,1,Chicago Bulls,6,93,7:00 pm,Sacramento Kings,87
Wed Oct 31 2012,0,Detroit Pistons,-9,96,7:30 pm,Houston Rockets,105
Wed Oct 31 2012,1,Los Angeles Clippers,9,101,7:30 pm,Memphis Grizzlies,92
Wed Oct 31 2012,0,New Orleans Hornets,-4,95,7:00 pm,San Antonio Spurs,99
Wed Oct 31 2012,1,Philadelphia 76ers,9,84,7:00 pm,Denver Nuggets,75
Wed Oct 31 2012,0,Phoenix Suns,-2,85,7:00 pm,Golden State Warriors,87
Wed Oct 31 2012,1,Portland Trail Blazers,10,116,7:30 pm,Los Angeles Lakers,106
Wed Oct 31 2012,0,Toronto Raptors,-2,88,7:00 pm,Indiana Pacers,90
Wed Oct 31 2012,1,Utah Jazz,19,113,7:00 pm,Dallas Mavericks,94
Thu Nov 1 2012,1,San Antonio Spurs,2,86,8:30 pm,Oklahoma City Thunder,84
Fri Nov 2 2012,0,Atlanta Hawks,-7,102,7:30 pm,Houston Rockets,109
Fri Nov 2 2012,0,Boston Celtics,-11,88,7:30 pm,Milwaukee Bucks,99
Fri Nov 2 2012,1,Charlotte Bobcats,1,90,7:00 pm,Indiana Pacers,89
Fri Nov 2 2012,0,Cleveland Cavaliers,-29,86,7:30 pm,Chicago Bulls,115
Fri Nov 2 2012,0,Golden State Warriors,-10,94,7:30 pm,Memphis Grizzlies,104
Fri Nov 2 2012,0,Los Angeles Lakers,-10,95,7:30 pm,Los Angeles Clippers,105
Fri Nov 2 2012,1,Minnesota Timberwolves,12,92,7:00 pm,Sacramento Kings,80
Fri Nov 2 2012,1,New Orleans Hornets,2,88,7:00 pm,Utah Jazz,86
Fri Nov 2 2012,1,New York Knicks,20,104,8:00 pm,Miami Heat,84
Fri Nov 2 2012,1,Oklahoma City Thunder,14,106,7:00 pm,Portland Trail Blazers,92
Fri Nov 2 2012,1,Orlando Magic,13,102,7:00 pm,Denver Nuggets,89
Fri Nov 2 2012,1,Phoenix Suns,3,92,7:00 pm,Detroit Pistons,89
Sat Nov 3 2012,1,Brooklyn Nets,7,107,7:30 pm,Toronto Raptors,100
Sat Nov 3 2012,0,Chicago Bulls,-7,82,7:00 pm,New Orleans Hornets,89
Sat Nov 3 2012,1,Dallas Mavericks,27,126,7:30 pm,Charlotte Bobcats,99
Sat Nov 3 2012,0,Houston Rockets,-10,85,7:00 pm,Portland Trail Blazers,95
Sat Nov 3 2012,1,Indiana Pacers,8,106,7:00 pm,Sacramento Kings,98
Sat Nov 3 2012,0,Los Angeles Clippers,-4,110,7:30 pm,Golden State Warriors,114
Sat Nov 3 2012,1,Miami Heat,3,119,7:30 pm,Denver Nuggets,116
Sat Nov 3 2012,1,Milwaukee Bucks,3,105,7:30 pm,Cleveland Cavaliers,102
Sat Nov 3 2012,1,San Antonio Spurs,10,110,7:30 pm,Utah Jazz,100
Sat Nov 3 2012,0,Washington Wizards,-3,86,7:00 pm,Boston Celtics,89
Sun Nov 4 2012,1,Los Angeles Lakers,29,108,6:30 pm,Detroit Pistons,79
Sun Nov 4 2012,1,New York Knicks,16,100,12:00 pm,Philadelphia 76ers,84
Sun Nov 4 2012,0,Oklahoma City Thunder,-9,95,6:00 pm,Atlanta Hawks,104
Sun Nov 4 2012,1,Orlando Magic,21,115,6:00 pm,Phoenix Suns,94
Sun Nov 4 2012,1,Toronto Raptors,19,105,6:00 pm,Minnesota Timberwolves,86
Mon Nov 5 2012,0,Brooklyn Nets,-11,96,7:30 pm,Minnesota Timberwolves,107
Mon Nov 5 2012,1,Dallas Mavericks,23,114,7:30 pm,Portland Trail Blazers,91
Mon Nov 5 2012,0,Los Angeles Clippers,-7,101,7:30 pm,Cleveland Cavaliers,108
Mon Nov 5 2012,1,Memphis Grizzlies,9,103,7:00 pm,Utah Jazz,94
Mon Nov 5 2012,1,Miami Heat,25,124,7:30 pm,Phoenix Suns,99
Mon Nov 5 2012,0,Philadelphia 76ers,-22,88,7:00 pm,New York Knicks,110
Mon Nov 5 2012,1,Sacramento Kings,2,94,7:00 pm,Golden State Warriors,92
Mon Nov 5 2012,1,San Antonio Spurs,22,101,7:30 pm,Indiana Pacers,79
Tue Nov 6 2012,1,Chicago Bulls,6,99,7:00 pm,Orlando Magic,93
Tue Nov 6 2012,1,Denver Nuggets,12,109,7:00 pm,Detroit Pistons,97
Tue Nov 6 2012,1,Oklahoma City Thunder,20,108,7:00 pm,Toronto Raptors,88
Wed Nov 7 2012,1,Atlanta Hawks,3,89,7:30 pm,Indiana Pacers,86
Wed Nov 7 2012,1,Boston Celtics,6,100,7:30 pm,Washington Wizards,94
Wed Nov 7 2012,0,Charlotte Bobcats,-7,110,7:00 pm,Phoenix Suns,117
Wed Nov 7 2012,1,Dallas Mavericks,5,109,7:30 pm,Toronto Raptors,104
Wed Nov 7 2012,1,Golden State Warriors,10,106,7:30 pm,Cleveland Cavaliers,96
Wed Nov 7 2012,0,Houston Rockets,-6,87,7:00 pm,Denver Nuggets,93
Wed Nov 7 2012,1,Los Angeles Clippers,22,106,7:30 pm,San Antonio Spurs,84
Wed Nov 7 2012,1,Miami Heat,30,103,7:30 pm,Brooklyn Nets,73
Wed Nov 7 2012,0,Milwaukee Bucks,-18,90,7:00 pm,Memphis Grizzlies,108
Wed Nov 7 2012,1,Minnesota Timberwolves,15,90,7:00 pm,Orlando Magic,75
Wed Nov 7 2012,0,New Orleans Hornets,-15,62,7:00 pm,Philadelphia 76ers,77
Wed Nov 7 2012,1,Sacramento Kings,2,105,7:00 pm,Detroit Pistons,103
Wed Nov 7 2012,1,Utah Jazz,9,95,7:00 pm,Los Angeles Lakers,86
Thu Nov 8 2012,0,Chicago Bulls,-6,91,7:00 pm,Oklahoma City Thunder,97
Thu Nov 8 2012,0,Portland Trail Blazers,-13,90,7:30 pm,Los Angeles Clippers,103
Fri Nov 9 2012,0,Atlanta Hawks,-6,89,7:30 pm,Miami Heat,95
Fri Nov 9 2012,0,Boston Celtics,-6,100,7:30 pm,Philadelphia 76ers,106
Fri Nov 9 2012,1,Denver Nuggets,20,104,8:30 pm,Utah Jazz,84
Fri Nov 9 2012,1,Los Angeles Lakers,24,101,7:30 pm,Golden State Warriors,77
Fri Nov 9 2012,1,Memphis Grizzlies,8,93,7:00 pm,Houston Rockets,85
Fri Nov 9 2012,1,Minnesota Timberwolves,2,96,7:00 pm,Indiana Pacers,94
Fri Nov 9 2012,1,New Orleans Hornets,8,107,7:00 pm,Charlotte Bobcats,99
Fri Nov 9 2012,1,New York Knicks,10,104,7:30 pm,Dallas Mavericks,94
Fri Nov 9 2012,1,Oklahoma City Thunder,11,105,7:00 pm,Detroit Pistons,94
Fri Nov 9 2012,0,Orlando Magic,-39,68,7:00 pm,Brooklyn Nets,107
Fri Nov 9 2012,1,Phoenix Suns,2,107,7:00 pm,Cleveland Cavaliers,105
Fri Nov 9 2012,0,Sacramento Kings,-11,86,7:00 pm,San Antonio Spurs,97
Fri Nov 9 2012,0,Washington Wizards,-10,91,7:00 pm,Milwaukee Bucks,101
Sat Nov 10 2012,1,Charlotte Bobcats,4,101,7:30 pm,Dallas Mavericks,97
Sat Nov 10 2012,1,Chicago Bulls,7,87,7:00 pm,Minnesota Timberwolves,80
Sat Nov 10 2012,0,Golden State Warriors,-6,101,7:30 pm,Denver Nuggets,107
Sat Nov 10 2012,1,Houston Rockets,14,96,7:00 pm,Detroit Pistons,82
Sat Nov 10 2012,1,Indiana Pacers,4,89,7:00 pm,Washington Wizards,85
Sat Nov 10 2012,0,Milwaukee Bucks,-4,92,7:30 pm,Boston Celtics,96
Sat Nov 10 2012,0,Portland Trail Blazers,-3,109,7:00 pm,San Antonio Spurs,112
Sat Nov 10 2012,0,Toronto Raptors,-10,83,7:00 pm,Philadelphia 76ers,93
Sat Nov 10 2012,1,Utah Jazz,13,94,7:00 pm,Phoenix Suns,81
Sun Nov 11 2012,1,Brooklyn Nets,8,82,3:00 pm,Orlando Magic,74
Sun Nov 11 2012,1,Los Angeles Clippers,13,89,12:30 pm,Atlanta Hawks,76
Sun Nov 11 2012,1,Los Angeles Lakers,13,103,6:30 pm,Sacramento Kings,90
Sun Nov 11 2012,1,Memphis Grizzlies,18,104,5:00 pm,Miami Heat,86
Sun Nov 11 2012,1,Oklahoma City Thunder,15,106,6:00 pm,Cleveland Cavaliers,91
Mon Nov 12 2012,0,Chicago Bulls,-6,95,7:00 pm,Boston Celtics,101
Mon Nov 12 2012,0,Dallas Mavericks,-8,82,7:30 pm,Minnesota Timberwolves,90
Mon Nov 12 2012,0,Detroit Pistons,-2,90,7:30 pm,Oklahoma City Thunder,92
Mon Nov 12 2012,0,Houston Rockets,-3,110,7:00 pm,Miami Heat,113
Mon Nov 12 2012,0,Philadelphia 76ers,-9,96,7:00 pm,Milwaukee Bucks,105
Mon Nov 12 2012,1,Phoenix Suns,10,110,7:00 pm,Denver Nuggets,100
Mon Nov 12 2012,0,Portland Trail Blazers,-8,87,7:00 pm,Atlanta Hawks,95
Mon Nov 12 2012,0,Toronto Raptors,-7,133,7:00 pm,Utah Jazz,140
Tue Nov 13 2012,1,Brooklyn Nets,13,114,7:30 pm,Cleveland Cavaliers,101
Tue Nov 13 2012,1,Charlotte Bobcats,16,92,7:00 pm,Washington Wizards,76
Tue Nov 13 2012,0,Indiana Pacers,-2,72,7:00 pm,Toronto Raptors,74
Tue Nov 13 2012,0,Los Angeles Lakers,-2,82,7:30 pm,San Antonio Spurs,84
Tue Nov 13 2012,0,Orlando Magic,-10,89,7:00 pm,New York Knicks,99
Tue Nov 13 2012,0,Sacramento Kings,-17,86,7:00 pm,Portland Trail Blazers,103
Wed Nov 14 2012,1,Boston Celtics,5,98,7:30 pm,Utah Jazz,93
Wed Nov 14 2012,1,Dallas Mavericks,6,107,7:30 pm,Washington Wizards,101
Wed Nov 14 2012,1,Golden State Warriors,4,92,7:30 pm,Atlanta Hawks,88
Wed Nov 14 2012,1,Houston Rockets,4,100,7:00 pm,New Orleans Hornets,96
Wed Nov 14 2012,1,Los Angeles Clippers,7,107,7:30 pm,Miami Heat,100
Wed Nov 14 2012,1,Milwaukee Bucks,14,99,7:00 pm,Indiana Pacers,85
Wed Nov 14 2012,0,Minnesota Timberwolves,-2,87,7:00 pm,Charlotte Bobcats,89
Wed Nov 14 2012,0,Oklahoma City Thunder,-10,97,7:00 pm,Memphis Grizzlies,107
Wed Nov 14 2012,0,Philadelphia 76ers,-18,76,7:00 pm,Detroit Pistons,94
Wed Nov 14 2012,0,Phoenix Suns,-6,106,7:00 pm,Chicago Bulls,112
Thu Nov 15 2012,1,Brooklyn Nets,5,102,8:00 pm,Boston Celtics,97
Thu Nov 15 2012,0,Denver Nuggets,-5,93,8:30 pm,Miami Heat,98
Thu Nov 15 2012,0,San Antonio Spurs,-4,100,7:30 pm,New York Knicks,104
Fri Nov 16 2012,0,Detroit Pistons,-4,106,7:30 pm,Orlando Magic,110
Fri Nov 16 2012,1,Indiana Pacers,20,103,7:00 pm,Dallas Mavericks,83
Fri Nov 16 2012,1,Los Angeles Lakers,12,114,7:30 pm,Phoenix Suns,102
Fri Nov 16 2012,1,Memphis Grizzlies,10,105,8:30 pm,New York Knicks,95
Fri Nov 16 2012,0,Minnesota Timberwolves,-8,98,7:00 pm,Golden State Warriors,106
Fri Nov 16 2012,0,New Orleans Hornets,-15,95,7:00 pm,Oklahoma City Thunder,110
Fri Nov 16 2012,1,Philadelphia 76ers,6,99,7:00 pm,Utah Jazz,93
Fri Nov 16 2012,1,Portland Trail Blazers,2,119,7:00 pm,Houston Rockets,117
Fri Nov 16 2012,0,Sacramento Kings,-16,96,7:00 pm,Atlanta Hawks,112
Sat Nov 17 2012,1,Boston Celtics,18,107,12:30 pm,Toronto Raptors,89
Sat Nov 17 2012,0,Charlotte Bobcats,-7,87,7:30 pm,Memphis Grizzlies,94
Sat Nov 17 2012,0,Cleveland Cavaliers,-8,95,7:30 pm,Dallas Mavericks,103
Sat Nov 17 2012,1,Los Angeles Clippers,21,101,6:00 pm,Chicago Bulls,80
Sat Nov 17 2012,1,Milwaukee Bucks,4,117,7:30 pm,New Orleans Hornets,113
Sat Nov 17 2012,0,Phoenix Suns,-9,88,7:00 pm,Miami Heat,97
Sat Nov 17 2012,1,San Antonio Spurs,26,126,7:30 pm,Denver Nuggets,100
Sat Nov 17 2012,0,Washington Wizards,-7,76,7:00 pm,Utah Jazz,83
Sun Nov 18 2012,1,Detroit Pistons,20,103,7:30 pm,Boston Celtics,83
Sun Nov 18 2012,1,Los Angeles Lakers,11,119,6:30 pm,Houston Rockets,108
Sun Nov 18 2012,1,New York Knicks,12,88,12:00 pm,Indiana Pacers,76
Sun Nov 18 2012,1,Oklahoma City Thunder,10,119,6:00 pm,Golden State Warriors,109
Sun Nov 18 2012,1,Philadelphia 76ers,7,86,6:00 pm,Cleveland Cavaliers,79
Sun Nov 18 2012,1,Portland Trail Blazers,8,102,6:00 pm,Chicago Bulls,94
Sun Nov 18 2012,0,Sacramento Kings,-9,90,3:00 pm,Brooklyn Nets,99
Sun Nov 18 2012,1,Toronto Raptors,11,97,1:00 pm,Orlando Magic,86
Mon Nov 19 2012,1,Atlanta Hawks,9,81,7:30 pm,Orlando Magic,72
Mon Nov 19 2012,1,Charlotte Bobcats,4,102,7:00 pm,Milwaukee Bucks,98
Mon Nov 19 2012,0,Dallas Mavericks,-4,101,7:30 pm,Golden State Warriors,105
Mon Nov 19 2012,0,Memphis Grizzlies,-5,92,7:00 pm,Denver Nuggets,97
Mon Nov 19 2012,0,San Antonio Spurs,-5,87,7:30 pm,Los Angeles Clippers,92
Mon Nov 19 2012,1,Utah Jazz,11,102,7:00 pm,Houston Rockets,91
Mon Nov 19 2012,0,Washington Wizards,-7,89,7:00 pm,Indiana Pacers,96
Tue Nov 20 2012,1,Los Angeles Lakers,5,95,7:30 pm,Brooklyn Nets,90
Tue Nov 20 2012,0,New Orleans Hornets,-22,80,7:00 pm,New York Knicks,102
Tue Nov 20 2012,1,Philadelphia 76ers,8,106,7:00 pm,Toronto Raptors,98
Wed Nov 21 2012,1,Atlanta Hawks,1,101,7:30 pm,Washington Wizards,100
Wed Nov 21 2012,0,Boston Celtics,-12,100,7:30 pm,San Antonio Spurs,112
Wed Nov 21 2012,1,Charlotte Bobcats,1,98,7:00 pm,Toronto Raptors,97
Wed Nov 21 2012,1,Cleveland Cavaliers,9,92,7:00 pm,Philadelphia 76ers,83
Wed Nov 21 2012,1,Dallas Mavericks,3,114,7:30 pm,New York Knicks,111
Wed Nov 21 2012,1,Golden State Warriors,9,102,7:30 pm,Brooklyn Nets,93
Wed Nov 21 2012,1,Houston Rockets,4,93,7:00 pm,Chicago Bulls,89
Wed Nov 21 2012,1,Indiana Pacers,8,115,7:00 pm,New Orleans Hornets,107
Wed Nov 21 2012,1,Miami Heat,7,113,7:30 pm,Milwaukee Bucks,106
Wed Nov 21 2012,0,Minnesota Timberwolves,-7,94,7:00 pm,Denver Nuggets,101
Wed Nov 21 2012,1,Oklahoma City Thunder,6,117,6:30 pm,Los Angeles Clippers,111
Wed Nov 21 2012,1,Orlando Magic,16,90,7:00 pm,Detroit Pistons,74
Wed Nov 21 2012,1,Phoenix Suns,27,114,7:00 pm,Portland Trail Blazers,87
Wed Nov 21 2012,1,Sacramento Kings,16,113,7:00 pm,Los Angeles Lakers,97
Fri Nov 23 2012,1,Boston Celtics,8,108,7:30 pm,Oklahoma City Thunder,100
Fri Nov 23 2012,1,Brooklyn Nets,10,86,7:30 pm,Los Angeles Clippers,76
Fri Nov 23 2012,0,Charlotte Bobcats,-10,91,7:00 pm,Atlanta Hawks,101
Fri Nov 23 2012,1,Denver Nuggets,11,102,7:00 pm,Golden State Warriors,91
Fri Nov 23 2012,1,Detroit Pistons,1,91,7:30 pm,Toronto Raptors,90
Fri Nov 23 2012,1,Houston Rockets,28,131,7:00 pm,New York Knicks,103
Fri Nov 23 2012,0,Indiana Pacers,-7,97,8:00 pm,San Antonio Spurs,104
Fri Nov 23 2012,1,Memphis Grizzlies,8,106,7:00 pm,Los Angeles Lakers,98
Fri Nov 23 2012,1,Orlando Magic,4,108,7:00 pm,Cleveland Cavaliers,104
Fri Nov 23 2012,1,Phoenix Suns,3,111,7:00 pm,New Orleans Hornets,108
Fri Nov 23 2012,1,Portland Trail Blazers,8,103,7:00 pm,Minnesota Timberwolves,95
Fri Nov 23 2012,1,Utah Jazz,2,104,7:00 pm,Sacramento Kings,102
Sat Nov 24 2012,1,Atlanta Hawks,11,104,7:00 pm,Los Angeles Clippers,93
Sat Nov 24 2012,0,Dallas Mavericks,-26,89,7:30 pm,Los Angeles Lakers,115
Sat Nov 24 2012,1,Golden State Warriors,11,96,7:30 pm,Minnesota Timberwolves,85
Sat Nov 24 2012,1,Miami Heat,2,110,7:30 pm,Cleveland Cavaliers,108
Sat Nov 24 2012,0,Milwaukee Bucks,-7,86,8:00 pm,Chicago Bulls,93
Sat Nov 24 2012,0,Philadelphia 76ers,-7,109,7:00 pm,Oklahoma City Thunder,116
Sat Nov 24 2012,1,Sacramento Kings,11,108,7:00 pm,Utah Jazz,97
Sat Nov 24 2012,0,Washington Wizards,-2,106,7:00 pm,Charlotte Bobcats,108
Sun Nov 25 2012,1,Brooklyn Nets,13,98,3:00 pm,Portland Trail Blazers,85
Sun Nov 25 2012,1,Denver Nuggets,18,102,6:00 pm,New Orleans Hornets,84
Sun Nov 25 2012,1,New York Knicks,21,121,1:00 pm,Detroit Pistons,100
Sun Nov 25 2012,0,Orlando Magic,-6,110,6:00 pm,Boston Celtics,116
Sun Nov 25 2012,1,Philadelphia 76ers,3,104,6:00 pm,Phoenix Suns,101
Sun Nov 25 2012,0,Toronto Raptors,-5,106,1:00 pm,San Antonio Spurs,111
Mon Nov 26 2012,1,Brooklyn Nets,7,96,7:00 pm,New York Knicks,89
Mon Nov 26 2012,0,Chicago Bulls,-1,92,7:00 pm,Milwaukee Bucks,93
Mon Nov 26 2012,1,Detroit Pistons,7,108,7:30 pm,Portland Trail Blazers,101
Mon Nov 26 2012,0,Los Angeles Clippers,-7,98,7:30 pm,New Orleans Hornets,105
Mon Nov 26 2012,1,Memphis Grizzlies,6,84,7:00 pm,Cleveland Cavaliers,78
Mon Nov 26 2012,1,Oklahoma City Thunder,45,114,7:00 pm,Charlotte Bobcats,69
Mon Nov 26 2012,1,Utah Jazz,2,105,7:00 pm,Denver Nuggets,103
Mon Nov 26 2012,0,Washington Wizards,-26,92,7:00 pm,San Antonio Spurs,118
Tue Nov 27 2012,0,Cleveland Cavaliers,-13,78,7:00 pm,Phoenix Suns,91
Tue Nov 27 2012,1,Houston Rockets,16,117,7:00 pm,Toronto Raptors,101
Tue Nov 27 2012,0,Los Angeles Lakers,-2,77,7:30 pm,Indiana Pacers,79
Tue Nov 27 2012,1,Philadelphia 76ers,2,100,7:00 pm,Dallas Mavericks,98
Tue Nov 27 2012,0,Sacramento Kings,-8,89,7:00 pm,Minnesota Timberwolves,97
Wed Nov 28 2012,1,Atlanta Hawks,3,94,7:30 pm,Charlotte Bobcats,91
Wed Nov 28 2012,0,Boston Celtics,-12,83,7:30 pm,Brooklyn Nets,95
Wed Nov 28 2012,1,Chicago Bulls,23,101,7:00 pm,Dallas Mavericks,78
Wed Nov 28 2012,1,Detroit Pistons,40,117,7:30 pm,Phoenix Suns,77
Wed Nov 28 2012,1,Los Angeles Clippers,6,101,7:30 pm,Minnesota Timberwolves,95
Wed Nov 28 2012,1,Memphis Grizzlies,21,103,7:00 pm,Toronto Raptors,82
Wed Nov 28 2012,0,Milwaukee Bucks,-14,88,7:00 pm,New York Knicks,102
Wed Nov 28 2012,0,New Orleans Hornets,-12,84,7:00 pm,Utah Jazz,96
Wed Nov 28 2012,1,Oklahoma City Thunder,22,120,7:00 pm,Houston Rockets,98
Wed Nov 28 2012,0,Orlando Magic,-21,89,7:00 pm,San Antonio Spurs,110
Wed Nov 28 2012,1,Washington Wizards,2,84,7:00 pm,Portland Trail Blazers,82
Thu Nov 29 2012,1,Golden State Warriors,1,106,7:30 pm,Denver Nuggets,105
Thu Nov 29 2012,1,Miami Heat,5,105,8:00 pm,San Antonio Spurs,100
Fri Nov 30 2012,0,Atlanta Hawks,-2,111,7:30 pm,Cleveland Cavaliers,113
Fri Nov 30 2012,1,Boston Celtics,18,96,7:30 pm,Portland Trail Blazers,78
Fri Nov 30 2012,0,Charlotte Bobcats,-6,98,7:00 pm,Philadelphia 76ers,104
Fri Nov 30 2012,1,Los Angeles Lakers,19,122,7:30 pm,Denver Nuggets,103
Fri Nov 30 2012,1,Memphis Grizzlies,12,90,7:00 pm,Detroit Pistons,78
Fri Nov 30 2012,1,Minnesota Timberwolves,10,95,7:00 pm,Milwaukee Bucks,85
Fri Nov 30 2012,1,New York Knicks,21,108,7:30 pm,Washington Wizards,87
Fri Nov 30 2012,1,Oklahoma City Thunder,12,106,7:00 pm,Utah Jazz,94
Fri Nov 30 2012,0,Orlando Magic,-12,86,7:00 pm,Brooklyn Nets,98
Fri Nov 30 2012,0,Sacramento Kings,-5,92,7:00 pm,Indiana Pacers,97
Fri Nov 30 2012,1,Toronto Raptors,4,101,7:00 pm,Phoenix Suns,97
Sat Dec 1 2012,1,Chicago Bulls,5,93,7:00 pm,Philadelphia 76ers,88
Sat Dec 1 2012,0,Cleveland Cavaliers,-1,117,7:30 pm,Portland Trail Blazers,118
Sat Dec 1 2012,1,Dallas Mavericks,15,92,8:00 pm,Detroit Pistons,77
Sat Dec 1 2012,1,Golden State Warriors,11,103,7:30 pm,Indiana Pacers,92
Sat Dec 1 2012,1,Houston Rockets,8,124,7:00 pm,Utah Jazz,116
Sat Dec 1 2012,1,Los Angeles Clippers,35,116,7:30 pm,Sacramento Kings,81
Sat Dec 1 2012,1,Miami Heat,13,102,7:30 pm,Brooklyn Nets,89
Sat Dec 1 2012,1,Milwaukee Bucks,3,91,7:30 pm,Boston Celtics,88
Sat Dec 1 2012,0,New Orleans Hornets,-21,79,7:00 pm,Oklahoma City Thunder,100
Sat Dec 1 2012,1,San Antonio Spurs,4,99,7:30 pm,Memphis Grizzlies,95
Sun Dec 2 2012,0,Los Angeles Lakers,-10,103,6:30 pm,Orlando Magic,113
Sun Dec 2 2012,1,New York Knicks,7,106,12:00 pm,Phoenix Suns,99
Mon Dec 3 2012,0,Charlotte Bobcats,-6,112,7:00 pm,Portland Trail Blazers,118
Mon Dec 3 2012,1,Denver Nuggets,3,113,7:00 pm,Toronto Raptors,110
Mon Dec 3 2012,1,Detroit Pistons,10,89,7:30 pm,Cleveland Cavaliers,79
Mon Dec 3 2012,0,Golden State Warriors,-8,94,7:30 pm,Orlando Magic,102
Mon Dec 3 2012,1,New Orleans Hornets,21,102,7:00 pm,Milwaukee Bucks,81
Mon Dec 3 2012,0,Utah Jazz,-1,104,7:00 pm,Los Angeles Clippers,105
Tue Dec 4 2012,0,Brooklyn Nets,-6,111,7:30 pm,Oklahoma City Thunder,117
Tue Dec 4 2012,0,Chicago Bulls,-4,76,7:00 pm,Indiana Pacers,80
Tue Dec 4 2012,1,Houston Rockets,2,107,7:00 pm,Los Angeles Lakers,105
Tue Dec 4 2012,1,Memphis Grizzlies,10,108,7:00 pm,Phoenix Suns,98
Tue Dec 4 2012,0,Philadelphia 76ers,-17,88,7:00 pm,Minnesota Timberwolves,105
Tue Dec 4 2012,1,Washington Wizards,4,105,7:00 pm,Miami Heat,101
Wed Dec 5 2012,1,Atlanta Hawks,4,108,8:00 pm,Denver Nuggets,104
Wed Dec 5 2012,1,Boston Celtics,10,104,7:30 pm,Minnesota Timberwolves,94
Wed Dec 5 2012,0,Charlotte Bobcats,-2,98,7:00 pm,New York Knicks,100
Wed Dec 5 2012,0,Cleveland Cavaliers,-10,85,8:00 pm,Chicago Bulls,95
Wed Dec 5 2012,0,Detroit Pistons,-7,97,7:30 pm,Golden State Warriors,104
Wed Dec 5 2012,1,Indiana Pacers,7,99,7:00 pm,Portland Trail Blazers,92
Wed Dec 5 2012,1,Los Angeles Clippers,22,112,7:30 pm,Dallas Mavericks,90
Wed Dec 5 2012,0,New Orleans Hornets,-16,87,7:00 pm,Los Angeles Lakers,103
Wed Dec 5 2012,1,Sacramento Kings,7,107,7:00 pm,Toronto Raptors,100
Wed Dec 5 2012,1,San Antonio Spurs,11,110,7:30 pm,Milwaukee Bucks,99
Wed Dec 5 2012,1,Utah Jazz,6,87,7:00 pm,Orlando Magic,81
Thu Dec 6 2012,0,Miami Heat,-20,92,8:00 pm,New York Knicks,112
Thu Dec 6 2012,0,Phoenix Suns,-3,94,8:30 pm,Dallas Mavericks,97
Fri Dec 7 2012,1,Atlanta Hawks,9,104,7:30 pm,Washington Wizards,95
Fri Dec 7 2012,0,Brooklyn Nets,-7,102,7:30 pm,Golden State Warriors,109
Fri Dec 7 2012,0,Detroit Pistons,-4,104,7:30 pm,Chicago Bulls,108
Fri Dec 7 2012,0,Indiana Pacers,-3,89,7:00 pm,Denver Nuggets,92
Fri Dec 7 2012,1,Milwaukee Bucks,15,108,7:30 pm,Charlotte Bobcats,93
Fri Dec 7 2012,1,Minnesota Timberwolves,18,91,7:00 pm,Cleveland Cavaliers,73
Fri Dec 7 2012,0,New Orleans Hornets,-7,89,7:00 pm,Memphis Grizzlies,96
Fri Dec 7 2012,1,Oklahoma City Thunder,6,114,8:30 pm,Los Angeles Lakers,108
Fri Dec 7 2012,1,Philadelphia 76ers,1,95,7:00 pm,Boston Celtics,94
Fri Dec 7 2012,1,Sacramento Kings,9,91,7:00 pm,Orlando Magic,82
Fri Dec 7 2012,1,San Antonio Spurs,22,114,7:30 pm,Houston Rockets,92
Fri Dec 7 2012,1,Utah Jazz,32,131,7:00 pm,Toronto Raptors,99
Sat Dec 8 2012,1,Boston Celtics,13,92,7:30 pm,Philadelphia 76ers,79
Sat Dec 8 2012,0,Charlotte Bobcats,-30,102,7:00 pm,San Antonio Spurs,132
Sat Dec 8 2012,1,Chicago Bulls,8,93,7:00 pm,New York Knicks,85
Sat Dec 8 2012,0,Cleveland Cavaliers,-7,97,7:30 pm,Detroit Pistons,104
Sat Dec 8 2012,0,Houston Rockets,-7,109,7:00 pm,Dallas Mavericks,116
Sat Dec 8 2012,1,Los Angeles Clippers,18,117,12:30 pm,Phoenix Suns,99
Sat Dec 8 2012,0,Memphis Grizzlies,-10,83,7:00 pm,Atlanta Hawks,93
Sat Dec 8 2012,1,Miami Heat,16,106,7:30 pm,New Orleans Hornets,90
Sat Dec 8 2012,0,Portland Trail Blazers,-19,80,7:00 pm,Sacramento Kings,99
Sat Dec 8 2012,0,Washington Wizards,-4,97,7:00 pm,Golden State Warriors,101
Sun Dec 9 2012,0,Brooklyn Nets,-9,88,6:00 pm,Milwaukee Bucks,97
Sun Dec 9 2012,1,Los Angeles Clippers,19,102,12:30 pm,Toronto Raptors,83
Sun Dec 9 2012,0,Los Angeles Lakers,-7,110,6:30 pm,Utah Jazz,117
Sun Dec 9 2012,1,New York Knicks,6,112,7:30 pm,Denver Nuggets,106
Sun Dec 9 2012,1,Oklahoma City Thunder,11,104,6:00 pm,Indiana Pacers,93
Sun Dec 9 2012,0,Phoenix Suns,-8,90,6:00 pm,Orlando Magic,98
Mon Dec 10 2012,0,Charlotte Bobcats,-8,96,7:00 pm,Golden State Warriors,104
Mon Dec 10 2012,1,Dallas Mavericks,23,119,7:30 pm,Sacramento Kings,96
Mon Dec 10 2012,0,Houston Rockets,-8,126,7:00 pm,San Antonio Spurs,134
Mon Dec 10 2012,1,Miami Heat,9,101,7:30 pm,Atlanta Hawks,92
Mon Dec 10 2012,1,Philadelphia 76ers,7,104,7:00 pm,Detroit Pistons,97
Mon Dec 10 2012,1,Portland Trail Blazers,18,92,7:00 pm,Toronto Raptors,74
Tue Dec 11 2012,0,Brooklyn Nets,-3,97,7:00 pm,New York Knicks,100
Tue Dec 11 2012,0,Chicago Bulls,-5,89,8:30 pm,Los Angeles Clippers,94
Tue Dec 11 2012,1,Cleveland Cavaliers,6,100,7:00 pm,Los Angeles Lakers,94
Tue Dec 11 2012,0,Detroit Pistons,-7,94,7:30 pm,Denver Nuggets,101
Tue Dec 11 2012,0,New Orleans Hornets,-7,70,7:00 pm,Washington Wizards,77
Wed Dec 12 2012,1,Boston Celtics,2,117,8:00 pm,Dallas Mavericks,115
Wed Dec 12 2012,0,Charlotte Bobcats,-6,94,7:30 pm,Los Angeles Clippers,100
Wed Dec 12 2012,1,Houston Rockets,6,99,7:00 pm,Washington Wizards,93
Wed Dec 12 2012,1,Indiana Pacers,15,96,7:00 pm,Cleveland Cavaliers,81
Wed Dec 12 2012,0,Miami Heat,-2,95,7:30 pm,Golden State Warriors,97
Wed Dec 12 2012,1,Milwaukee Bucks,13,98,7:00 pm,Sacramento Kings,85
Wed Dec 12 2012,1,Minnesota Timberwolves,3,108,7:00 pm,Denver Nuggets,105
Wed Dec 12 2012,1,Oklahoma City Thunder,4,92,7:00 pm,New Orleans Hornets,88
Wed Dec 12 2012,0,Orlando Magic,-6,80,7:00 pm,Atlanta Hawks,86
Wed Dec 12 2012,0,Philadelphia 76ers,-7,89,7:30 pm,Chicago Bulls,96
Wed Dec 12 2012,1,Phoenix Suns,2,82,7:00 pm,Memphis Grizzlies,80
Wed Dec 12 2012,0,Toronto Raptors,-6,88,7:00 pm,Brooklyn Nets,94
Wed Dec 12 2012,1,Utah Jazz,3,99,8:30 pm,San Antonio Spurs,96
Thu Dec 13 2012,1,Atlanta Hawks,23,113,7:30 pm,Charlotte Bobcats,90
Thu Dec 13 2012,1,New York Knicks,9,116,8:00 pm,Los Angeles Lakers,107
Thu Dec 13 2012,1,Portland Trail Blazers,8,98,7:30 pm,San Antonio Spurs,90
Fri Dec 14 2012,1,Brooklyn Nets,2,107,7:30 pm,Detroit Pistons,105
Fri Dec 14 2012,0,Cleveland Cavaliers,-4,86,7:30 pm,Milwaukee Bucks,90
Fri Dec 14 2012,1,Denver Nuggets,5,99,8:30 pm,Memphis Grizzlies,94
Fri Dec 14 2012,1,Houston Rockets,12,101,7:00 pm,Boston Celtics,89
Fri Dec 14 2012,1,Indiana Pacers,10,95,7:00 pm,Philadelphia 76ers,85
Fri Dec 14 2012,0,New Orleans Hornets,-11,102,7:00 pm,Minnesota Timberwolves,113
Fri Dec 14 2012,1,Oklahoma City Thunder,10,113,7:00 pm,Sacramento Kings,103
Fri Dec 14 2012,1,Orlando Magic,14,99,7:00 pm,Golden State Warriors,85
Fri Dec 14 2012,1,Phoenix Suns,15,99,7:00 pm,Utah Jazz,84
Fri Dec 14 2012,1,Toronto Raptors,21,95,7:00 pm,Dallas Mavericks,74
Fri Dec 14 2012,0,Washington Wizards,-6,96,7:00 pm,Los Angeles Lakers,102
Sat Dec 15 2012,0,Atlanta Hawks,-22,93,7:00 pm,Golden State Warriors,115
Sat Dec 15 2012,0,Charlotte Bobcats,-9,98,7:30 pm,Orlando Magic,107
Sat Dec 15 2012,1,Chicago Bulls,1,83,7:00 pm,Brooklyn Nets,82
Sat Dec 15 2012,0,Detroit Pistons,-11,77,7:30 pm,Indiana Pacers,88
Sat Dec 15 2012,1,Miami Heat,30,102,7:30 pm,Washington Wizards,72
Sat Dec 15 2012,0,Milwaukee Bucks,-26,85,7:30 pm,Los Angeles Clippers,111
Sat Dec 15 2012,1,Minnesota Timberwolves,8,114,7:00 pm,Dallas Mavericks,106
Sat Dec 15 2012,1,New York Knicks,1,103,7:30 pm,Cleveland Cavaliers,102
Sat Dec 15 2012,1,San Antonio Spurs,15,103,7:30 pm,Boston Celtics,88
Sat Dec 15 2012,0,Utah Jazz,-13,86,7:00 pm,Memphis Grizzlies,99
Sun Dec 16 2012,0,Philadelphia 76ers,-13,98,6:00 pm,Los Angeles Lakers,111
Sun Dec 16 2012,1,Portland Trail Blazers,1,95,6:00 pm,New Orleans Hornets,94
Sun Dec 16 2012,0,Sacramento Kings,-25,97,3:00 pm,Denver Nuggets,122
Sun Dec 16 2012,1,Toronto Raptors,7,103,1:00 pm,Houston Rockets,96
Mon Dec 17 2012,0,Detroit Pistons,-12,76,7:30 pm,Los Angeles Clippers,88
Mon Dec 17 2012,1,Memphis Grizzlies,9,80,7:00 pm,Chicago Bulls,71
Mon Dec 17 2012,0,New York Knicks,-13,96,7:30 pm,Houston Rockets,109
Mon Dec 17 2012,1,Oklahoma City Thunder,14,107,7:00 pm,San Antonio Spurs,93
Mon Dec 17 2012,1,Orlando Magic,9,102,7:00 pm,Minnesota Timberwolves,93
Mon Dec 17 2012,1,Phoenix Suns,11,101,7:00 pm,Sacramento Kings,90
Tue Dec 18 2012,0,Brooklyn Nets,-2,90,7:30 pm,Utah Jazz,92
Tue Dec 18 2012,1,Chicago Bulls,11,100,7:00 pm,Boston Celtics,89
Tue Dec 18 2012,0,Cleveland Cavaliers,-14,99,7:00 pm,Toronto Raptors,113
Tue Dec 18 2012,1,Dallas Mavericks,7,107,7:30 pm,Philadelphia 76ers,100
Tue Dec 18 2012,1,Denver Nuggets,6,112,7:00 pm,San Antonio Spurs,106
Tue Dec 18 2012,1,Golden State Warriors,7,103,7:30 pm,New Orleans Hornets,96
Tue Dec 18 2012,1,Los Angeles Lakers,1,101,7:30 pm,Charlotte Bobcats,100
Tue Dec 18 2012,1,Miami Heat,11,103,7:30 pm,Minnesota Timberwolves,92
Tue Dec 18 2012,1,Milwaukee Bucks,5,98,7:00 pm,Indiana Pacers,93
Tue Dec 18 2012,0,Washington Wizards,-5,95,7:00 pm,Atlanta Hawks,100
Wed Dec 19 2012,0,Atlanta Hawks,-8,92,7:30 pm,Oklahoma City Thunder,100
Wed Dec 19 2012,1,Boston Celtics,12,103,7:30 pm,Cleveland Cavaliers,91
Wed Dec 19 2012,1,Houston Rockets,22,125,7:00 pm,Philadelphia 76ers,103
Wed Dec 19 2012,1,Indiana Pacers,20,104,7:00 pm,Utah Jazz,84
Wed Dec 19 2012,1,Los Angeles Clippers,16,93,7:30 pm,New Orleans Hornets,77
Wed Dec 19 2012,1,Memphis Grizzlies,10,90,8:30 pm,Milwaukee Bucks,80
Wed Dec 19 2012,1,New York Knicks,14,100,7:00 pm,Brooklyn Nets,86
Wed Dec 19 2012,1,Orlando Magic,7,90,7:00 pm,Washington Wizards,83
Wed Dec 19 2012,1,Phoenix Suns,17,121,7:00 pm,Charlotte Bobcats,104
Wed Dec 19 2012,1,Sacramento Kings,4,131,7:00 pm,Golden State Warriors,127
Wed Dec 19 2012,1,Toronto Raptors,6,97,7:00 pm,Detroit Pistons,91
Thu Dec 20 2012,0,Dallas Mavericks,-15,95,8:30 pm,Miami Heat,110
Thu Dec 20 2012,1,Minnesota Timberwolves,6,99,6:00 pm,Oklahoma City Thunder,93
Thu Dec 20 2012,1,Portland Trail Blazers,8,101,7:00 pm,Denver Nuggets,93
Fri Dec 21 2012,0,Boston Celtics,-5,94,7:30 pm,Milwaukee Bucks,99
Fri Dec 21 2012,0,Cleveland Cavaliers,-10,89,7:30 pm,Indiana Pacers,99
Fri Dec 21 2012,1,Detroit Pistons,32,100,7:30 pm,Washington Wizards,68
Fri Dec 21 2012,1,Golden State Warriors,15,115,7:30 pm,Charlotte Bobcats,100
Fri Dec 21 2012,1,Los Angeles Clippers,12,97,7:30 pm,Sacramento Kings,85
Fri Dec 21 2012,1,Memphis Grizzlies,10,92,7:00 pm,Dallas Mavericks,82
Fri Dec 21 2012,0,New York Knicks,-4,106,7:30 pm,Chicago Bulls,110
Fri Dec 21 2012,1,Philadelphia 76ers,19,99,7:00 pm,Atlanta Hawks,80
Fri Dec 21 2012,1,San Antonio Spurs,5,99,7:30 pm,New Orleans Hornets,94
Fri Dec 21 2012,1,Toronto Raptors,3,93,7:00 pm,Orlando Magic,90
Sat Dec 22 2012,1,Atlanta Hawks,17,92,7:00 pm,Chicago Bulls,75
Sat Dec 22 2012,1,Denver Nuggets,22,110,7:00 pm,Charlotte Bobcats,88
Sat Dec 22 2012,0,Golden State Warriors,-3,115,7:30 pm,Los Angeles Lakers,118
Sat Dec 22 2012,1,Houston Rockets,25,121,7:00 pm,Memphis Grizzlies,96
Sat Dec 22 2012,1,Miami Heat,16,105,7:30 pm,Utah Jazz,89
Sat Dec 22 2012,0,Milwaukee Bucks,-12,82,7:30 pm,Cleveland Cavaliers,94
Sat Dec 22 2012,0,New Orleans Hornets,-6,75,7:00 pm,Indiana Pacers,81
Sat Dec 22 2012,1,Portland Trail Blazers,3,96,7:00 pm,Phoenix Suns,93
Sat Dec 22 2012,0,Washington Wizards,-9,87,7:00 pm,Detroit Pistons,96
Sun Dec 23 2012,1,Brooklyn Nets,3,95,3:00 pm,Philadelphia 76ers,92
Sun Dec 23 2012,1,New York Knicks,3,94,5:00 pm,Minnesota Timberwolves,91
Sun Dec 23 2012,0,Orlando Magic,-4,93,6:00 pm,Utah Jazz,97
Sun Dec 23 2012,0,Phoenix Suns,-26,77,6:00 pm,Los Angeles Clippers,103
Sun Dec 23 2012,1,Sacramento Kings,12,108,6:00 pm,Portland Trail Blazers,96
Sun Dec 23 2012,1,San Antonio Spurs,38,129,6:00 pm,Dallas Mavericks,91
Tue Dec 25 2012,0,Brooklyn Nets,-17,76,12:00 pm,Boston Celtics,93
Tue Dec 25 2012,0,Chicago Bulls,-23,97,7:00 pm,Houston Rockets,120
Tue Dec 25 2012,1,Los Angeles Clippers,12,112,7:30 pm,Denver Nuggets,100
Tue Dec 25 2012,1,Los Angeles Lakers,6,100,12:00 pm,New York Knicks,94
Tue Dec 25 2012,1,Miami Heat,6,103,5:30 pm,Oklahoma City Thunder,97
Wed Dec 26 2012,1,Atlanta Hawks,7,126,7:30 pm,Detroit Pistons,119
Wed Dec 26 2012,0,Charlotte Bobcats,-13,92,7:00 pm,Miami Heat,105
Wed Dec 26 2012,1,Denver Nuggets,12,126,7:00 pm,Los Angeles Lakers,114
Wed Dec 26 2012,0,Memphis Grizzlies,-10,89,7:00 pm,Philadelphia 76ers,99
Wed Dec 26 2012,1,Milwaukee Bucks,15,108,7:00 pm,Brooklyn Nets,93
Wed Dec 26 2012,0,Minnesota Timberwolves,-3,84,7:00 pm,Houston Rockets,87
Wed Dec 26 2012,0,Orlando Magic,-3,94,7:00 pm,New Orleans Hornets,97
Wed Dec 26 2012,0,Phoenix Suns,-2,97,7:00 pm,New York Knicks,99
Wed Dec 26 2012,1,Portland Trail Blazers,18,109,7:00 pm,Sacramento Kings,91
Wed Dec 26 2012,1,San Antonio Spurs,20,100,7:30 pm,Toronto Raptors,80
Wed Dec 26 2012,0,Utah Jazz,-11,83,7:00 pm,Golden State Warriors,94
Wed Dec 26 2012,0,Washington Wizards,-3,84,7:00 pm,Cleveland Cavaliers,87
Thu Dec 27 2012,1,Los Angeles Clippers,29,106,7:30 pm,Boston Celtics,77
Thu Dec 27 2012,1,Oklahoma City Thunder,6,111,7:00 pm,Dallas Mavericks,105
Fri Dec 28 2012,1,Brooklyn Nets,16,97,7:30 pm,Charlotte Bobcats,81
Fri Dec 28 2012,0,Cleveland Cavaliers,-8,94,7:30 pm,Atlanta Hawks,102
Fri Dec 28 2012,0,Dallas Mavericks,-21,85,7:30 pm,Denver Nuggets,106
Fri Dec 28 2012,1,Detroit Pistons,10,109,7:30 pm,Miami Heat,99
Fri Dec 28 2012,1,Golden State Warriors,7,96,7:30 pm,Philadelphia 76ers,89
Fri Dec 28 2012,1,Indiana Pacers,6,97,7:00 pm,Phoenix Suns,91
Fri Dec 28 2012,1,Los Angeles Lakers,17,104,7:30 pm,Portland Trail Blazers,87
Fri Dec 28 2012,0,New Orleans Hornets,-7,97,7:00 pm,Toronto Raptors,104
Fri Dec 28 2012,1,Sacramento Kings,1,106,7:00 pm,New York Knicks,105
Fri Dec 28 2012,1,San Antonio Spurs,6,122,7:30 pm,Houston Rockets,116
Fri Dec 28 2012,0,Utah Jazz,-2,114,7:00 pm,Los Angeles Clippers,116
Fri Dec 28 2012,1,Washington Wizards,8,105,7:00 pm,Orlando Magic,97
Sat Dec 29 2012,1,Atlanta Hawks,9,109,7:00 pm,Indiana Pacers,100
Sat Dec 29 2012,1,Brooklyn Nets,3,103,7:30 pm,Cleveland Cavaliers,100
Sat Dec 29 2012,0,Charlotte Bobcats,-3,95,7:00 pm,New Orleans Hornets,98
Sat Dec 29 2012,1,Chicago Bulls,10,87,7:00 pm,Washington Wizards,77
Sat Dec 29 2012,1,Golden State Warriors,18,101,7:30 pm,Boston Celtics,83
Sat Dec 29 2012,0,Houston Rockets,-30,94,7:00 pm,Oklahoma City Thunder,124
Sat Dec 29 2012,1,Memphis Grizzlies,9,81,7:00 pm,Denver Nuggets,72
Sat Dec 29 2012,1,Milwaukee Bucks,19,104,7:30 pm,Miami Heat,85
Sat Dec 29 2012,1,Minnesota Timberwolves,4,111,7:00 pm,Phoenix Suns,107
Sat Dec 29 2012,0,Orlando Magic,-35,88,7:00 pm,Toronto Raptors,123
Sat Dec 29 2012,1,Portland Trail Blazers,4,89,7:00 pm,Philadelphia 76ers,85
Sun Dec 30 2012,0,Dallas Mavericks,-25,86,6:30 pm,San Antonio Spurs,111
Sun Dec 30 2012,1,Detroit Pistons,2,96,7:30 pm,Milwaukee Bucks,94
Sun Dec 30 2012,1,Los Angeles Clippers,11,107,6:30 pm,Utah Jazz,96
Sun Dec 30 2012,1,Sacramento Kings,22,118,6:00 pm,Boston Celtics,96
Mon Dec 31 2012,0,Chicago Bulls,-10,81,2:00 pm,Charlotte Bobcats,91
Mon Dec 31 2012,1,Houston Rockets,19,123,6:00 pm,Atlanta Hawks,104
Mon Dec 31 2012,1,Indiana Pacers,5,88,3:00 pm,Memphis Grizzlies,83
Mon Dec 31 2012,1,Oklahoma City Thunder,18,114,7:00 pm,Phoenix Suns,96
Mon Dec 31 2012,0,Orlando Magic,-2,110,5:00 pm,Miami Heat,112
Mon Dec 31 2012,1,San Antonio Spurs,31,104,6:00 pm,Brooklyn Nets,73
Tue Jan 1 2013,1,Denver Nuggets,14,92,7:00 pm,Los Angeles Clippers,78
Tue Jan 1 2013,1,Detroit Pistons,6,103,7:30 pm,Sacramento Kings,97
Tue Jan 1 2013,0,Los Angeles Lakers,-4,99,7:30 pm,Philadelphia 76ers,103
Tue Jan 1 2013,0,New Orleans Hornets,-9,86,7:00 pm,Atlanta Hawks,95
Tue Jan 1 2013,0,New York Knicks,-5,100,7:30 pm,Portland Trail Blazers,105
Tue Jan 1 2013,0,Washington Wizards,-9,94,6:00 pm,Dallas Mavericks,103
Wed Jan 2 2013,0,Boston Celtics,-10,83,7:30 pm,Memphis Grizzlies,93
Wed Jan 2 2013,0,Cleveland Cavaliers,-3,94,7:00 pm,Sacramento Kings,97
Wed Jan 2 2013,1,Golden State Warriors,21,115,7:30 pm,Los Angeles Clippers,94
Wed Jan 2 2013,1,Houston Rockets,12,104,7:00 pm,New Orleans Hornets,92
Wed Jan 2 2013,1,Indiana Pacers,8,89,7:00 pm,Washington Wizards,81
Wed Jan 2 2013,1,Miami Heat,10,119,7:30 pm,Dallas Mavericks,109
Wed Jan 2 2013,0,Milwaukee Bucks,-7,110,7:00 pm,San Antonio Spurs,117
Wed Jan 2 2013,0,Oklahoma City Thunder,-17,93,7:00 pm,Brooklyn Nets,110
Wed Jan 2 2013,0,Orlando Magic,-2,94,7:00 pm,Chicago Bulls,96
Wed Jan 2 2013,1,Phoenix Suns,6,95,7:00 pm,Philadelphia 76ers,89
Wed Jan 2 2013,1,Toronto Raptors,23,102,7:00 pm,Portland Trail Blazers,79
Wed Jan 2 2013,1,Utah Jazz,22,106,7:00 pm,Minnesota Timberwolves,84
Thu Jan 3 2013,0,Denver Nuggets,-4,97,7:00 pm,Minnesota Timberwolves,101
Thu Jan 3 2013,1,New York Knicks,17,100,7:30 pm,San Antonio Spurs,83
Fri Jan 4 2013,1,Boston Celtics,19,94,8:00 pm,Indiana Pacers,75
Fri Jan 4 2013,0,Charlotte Bobcats,-2,104,7:00 pm,Cleveland Cavaliers,106
Fri Jan 4 2013,1,Detroit Pistons,1,85,7:30 pm,Atlanta Hawks,84
Fri Jan 4 2013,1,Los Angeles Clippers,5,107,7:30 pm,Los Angeles Lakers,102
Fri Jan 4 2013,0,Memphis Grizzlies,-2,84,7:00 pm,Portland Trail Blazers,86
Fri Jan 4 2013,0,Miami Heat,-7,89,8:00 pm,Chicago Bulls,96
Fri Jan 4 2013,0,Milwaukee Bucks,-14,101,7:30 pm,Houston Rockets,115
Fri Jan 4 2013,1,Oklahoma City Thunder,24,109,7:00 pm,Philadelphia 76ers,85
Fri Jan 4 2013,0,Phoenix Suns,-7,80,7:00 pm,Utah Jazz,87
Fri Jan 4 2013,0,Toronto Raptors,-9,96,7:00 pm,Sacramento Kings,105
Fri Jan 4 2013,0,Washington Wizards,-2,113,7:00 pm,Brooklyn Nets,115
Sat Jan 5 2013,0,Atlanta Hawks,-8,81,7:00 pm,Boston Celtics,89
Sat Jan 5 2013,1,Brooklyn Nets,20,113,7:30 pm,Sacramento Kings,93
Sat Jan 5 2013,0,Cleveland Cavaliers,-8,104,7:30 pm,Houston Rockets,112
Sat Jan 5 2013,0,Dallas Mavericks,-3,96,7:30 pm,New Orleans Hornets,99
Sat Jan 5 2013,1,Denver Nuggets,19,110,7:00 pm,Utah Jazz,91
Sat Jan 5 2013,1,Indiana Pacers,15,95,7:00 pm,Milwaukee Bucks,80
Sat Jan 5 2013,1,Los Angeles Clippers,26,115,7:30 pm,Golden State Warriors,89
Sat Jan 5 2013,0,Minnesota Timberwolves,-5,97,7:00 pm,Portland Trail Blazers,102
Sat Jan 5 2013,0,Orlando Magic,-8,106,7:00 pm,New York Knicks,114
Sat Jan 5 2013,1,San Antonio Spurs,23,109,7:30 pm,Philadelphia 76ers,86
Sun Jan 6 2013,0,Detroit Pistons,-7,101,7:30 pm,Charlotte Bobcats,108
Sun Jan 6 2013,0,Los Angeles Lakers,-7,105,6:30 pm,Denver Nuggets,112
Sun Jan 6 2013,1,Miami Heat,28,99,6:00 pm,Washington Wizards,71
Sun Jan 6 2013,0,Phoenix Suns,-11,81,6:00 pm,Memphis Grizzlies,92
Sun Jan 6 2013,0,Toronto Raptors,-12,92,1:00 pm,Oklahoma City Thunder,104
Mon Jan 7 2013,1,Chicago Bulls,26,118,7:00 pm,Cleveland Cavaliers,92
Mon Jan 7 2013,1,New Orleans Hornets,7,95,7:00 pm,San Antonio Spurs,88
Mon Jan 7 2013,0,New York Knicks,-6,96,7:30 pm,Boston Celtics,102
Mon Jan 7 2013,1,Portland Trail Blazers,6,125,7:00 pm,Orlando Magic,119
Mon Jan 7 2013,0,Sacramento Kings,-32,81,7:00 pm,Memphis Grizzlies,113
Mon Jan 7 2013,1,Utah Jazz,6,100,7:00 pm,Dallas Mavericks,94
Mon Jan 7 2013,1,Washington Wizards,2,101,7:00 pm,Oklahoma City Thunder,99
Tue Jan 8 2013,1,Houston Rockets,13,125,7:00 pm,Los Angeles Lakers,112
Tue Jan 8 2013,1,Indiana Pacers,10,87,7:00 pm,Miami Heat,77
Tue Jan 8 2013,1,Milwaukee Bucks,9,108,7:00 pm,Phoenix Suns,99
Tue Jan 8 2013,1,Minnesota Timberwolves,5,108,7:00 pm,Atlanta Hawks,103
Tue Jan 8 2013,0,Philadelphia 76ers,-20,89,7:00 pm,Brooklyn Nets,109
Wed Jan 9 2013,1,Boston Celtics,8,87,7:30 pm,Phoenix Suns,79
Wed Jan 9 2013,0,Charlotte Bobcats,-10,102,7:00 pm,Utah Jazz,112
Wed Jan 9 2013,0,Chicago Bulls,-8,96,7:00 pm,Milwaukee Bucks,104
Wed Jan 9 2013,1,Cleveland Cavaliers,16,99,7:00 pm,Atlanta Hawks,83
Wed Jan 9 2013,1,Denver Nuggets,3,108,7:00 pm,Orlando Magic,105
Wed Jan 9 2013,0,Golden State Warriors,-7,87,7:30 pm,Memphis Grizzlies,94
Wed Jan 9 2013,1,Los Angeles Clippers,6,99,7:30 pm,Dallas Mavericks,93
Wed Jan 9 2013,1,New Orleans Hornets,9,88,7:00 pm,Houston Rockets,79
Wed Jan 9 2013,1,Oklahoma City Thunder,22,106,7:00 pm,Minnesota Timberwolves,84
Wed Jan 9 2013,1,San Antonio Spurs,3,108,7:00 pm,Los Angeles Lakers,105
Wed Jan 9 2013,1,Toronto Raptors,18,90,7:00 pm,Philadelphia 76ers,72
Thu Jan 10 2013,1,Indiana Pacers,5,81,8:00 pm,New York Knicks,76
Thu Jan 10 2013,1,Portland Trail Blazers,2,92,7:30 pm,Miami Heat,90
Thu Jan 10 2013,0,Sacramento Kings,-5,112,7:00 pm,Dallas Mavericks,117
Fri Jan 11 2013,1,Atlanta Hawks,8,103,7:30 pm,Utah Jazz,95
Fri Jan 11 2013,1,Boston Celtics,12,103,7:30 pm,Houston Rockets,91
Fri Jan 11 2013,1,Brooklyn Nets,20,99,7:30 pm,Phoenix Suns,79
Fri Jan 11 2013,1,Denver Nuggets,7,98,7:00 pm,Cleveland Cavaliers,91
Fri Jan 11 2013,1,Golden State Warriors,6,103,7:30 pm,Portland Trail Blazers,97
Fri Jan 11 2013,0,Los Angeles Lakers,-15,101,7:30 pm,Oklahoma City Thunder,116
Fri Jan 11 2013,1,Memphis Grizzlies,3,101,7:00 pm,San Antonio Spurs,98
Fri Jan 11 2013,0,Milwaukee Bucks,-16,87,7:30 pm,Detroit Pistons,103
Fri Jan 11 2013,1,New Orleans Hornets,12,104,7:00 pm,Minnesota Timberwolves,92
Fri Jan 11 2013,0,New York Knicks,-7,101,8:00 pm,Chicago Bulls,108
Fri Jan 11 2013,1,Toronto Raptors,21,99,7:00 pm,Charlotte Bobcats,78
Sat Jan 12 2013,0,Chicago Bulls,-16,81,7:00 pm,Phoenix Suns,97
Sat Jan 12 2013,1,Dallas Mavericks,21,104,8:00 pm,Memphis Grizzlies,83
Sat Jan 12 2013,0,Detroit Pistons,-3,87,7:30 pm,Utah Jazz,90
Sat Jan 12 2013,1,Indiana Pacers,8,96,7:00 pm,Charlotte Bobcats,88
Sat Jan 12 2013,0,Los Angeles Clippers,-3,101,12:30 pm,Orlando Magic,104
Sat Jan 12 2013,1,Philadelphia 76ers,7,107,7:30 pm,Houston Rockets,100
Sat Jan 12 2013,0,Sacramento Kings,-29,99,7:00 pm,Miami Heat,128
Sat Jan 12 2013,1,Washington Wizards,10,93,7:00 pm,Atlanta Hawks,83
Sun Jan 13 2013,1,Brooklyn Nets,11,97,6:00 pm,Indiana Pacers,86
Sun Jan 13 2013,1,Denver Nuggets,11,116,6:00 pm,Golden State Warriors,105
Sun Jan 13 2013,1,Los Angeles Lakers,20,113,6:30 pm,Cleveland Cavaliers,93
Sun Jan 13 2013,1,New York Knicks,13,100,12:00 pm,New Orleans Hornets,87
Sun Jan 13 2013,0,Portland Trail Blazers,-4,83,6:00 pm,Oklahoma City Thunder,87
Sun Jan 13 2013,1,San Antonio Spurs,18,106,6:00 pm,Minnesota Timberwolves,88
Sun Jan 13 2013,0,Toronto Raptors,-11,96,1:00 pm,Milwaukee Bucks,107
Mon Jan 14 2013,1,Boston Celtics,11,100,7:30 pm,Charlotte Bobcats,89
Mon Jan 14 2013,1,Chicago Bulls,39,97,7:00 pm,Atlanta Hawks,58
Mon Jan 14 2013,1,Dallas Mavericks,15,113,7:30 pm,Minnesota Timberwolves,98
Mon Jan 14 2013,0,Memphis Grizzlies,-26,73,7:00 pm,Los Angeles Clippers,99
Mon Jan 14 2013,0,Phoenix Suns,-12,90,7:00 pm,Oklahoma City Thunder,102
Mon Jan 14 2013,1,Sacramento Kings,6,124,7:00 pm,Cleveland Cavaliers,118
Mon Jan 14 2013,1,Utah Jazz,7,104,7:00 pm,Miami Heat,97
Mon Jan 14 2013,1,Washington Wizards,29,120,7:00 pm,Orlando Magic,91
Tue Jan 15 2013,1,Brooklyn Nets,7,113,7:30 pm,Toronto Raptors,106
Tue Jan 15 2013,0,Charlotte Bobcats,-27,76,7:00 pm,Indiana Pacers,103
Tue Jan 15 2013,1,Denver Nuggets,4,115,7:00 pm,Portland Trail Blazers,111
Tue Jan 15 2013,0,Houston Rockets,-8,109,7:00 pm,Los Angeles Clippers,117
Tue Jan 15 2013,1,Los Angeles Lakers,16,104,7:30 pm,Milwaukee Bucks,88
Tue Jan 15 2013,0,Philadelphia 76ers,-12,99,7:00 pm,New Orleans Hornets,111
Wed Jan 16 2013,1,Atlanta Hawks,14,109,7:30 pm,Brooklyn Nets,95
Wed Jan 16 2013,0,Boston Celtics,-12,78,8:00 pm,New Orleans Hornets,90
Wed Jan 16 2013,1,Dallas Mavericks,5,105,7:00 pm,Houston Rockets,100
Wed Jan 16 2013,0,Golden State Warriors,-17,75,7:30 pm,Miami Heat,92
Wed Jan 16 2013,1,Oklahoma City Thunder,20,117,7:00 pm,Denver Nuggets,97
Wed Jan 16 2013,1,Orlando Magic,11,97,7:00 pm,Indiana Pacers,86
Wed Jan 16 2013,0,Portland Trail Blazers,-5,88,7:00 pm,Cleveland Cavaliers,93
Wed Jan 16 2013,1,Sacramento Kings,1,95,7:00 pm,Washington Wizards,94
Wed Jan 16 2013,1,San Antonio Spurs,21,103,7:30 pm,Memphis Grizzlies,82
Wed Jan 16 2013,0,Toronto Raptors,-2,105,7:00 pm,Chicago Bulls,107
Thu Jan 17 2013,0,Detroit Pistons,-15,87,8:00 pm,New York Knicks,102
Thu Jan 17 2013,0,Los Angeles Lakers,-9,90,7:30 pm,Miami Heat,99
Thu Jan 17 2013,0,Minnesota Timberwolves,-13,77,7:00 pm,Los Angeles Clippers,90
Thu Jan 17 2013,0,Phoenix Suns,-4,94,7:00 pm,Milwaukee Bucks,98
Fri Jan 18 2013,0,Boston Celtics,-1,99,7:00 pm,Chicago Bulls,100
Fri Jan 18 2013,1,Brooklyn Nets,5,94,7:30 pm,Atlanta Hawks,89
Fri Jan 18 2013,0,Dallas Mavericks,-3,114,8:30 pm,Oklahoma City Thunder,117
Fri Jan 18 2013,0,Denver Nuggets,-4,108,7:00 pm,Washington Wizards,112
Fri Jan 18 2013,1,Indiana Pacers,10,105,7:00 pm,Houston Rockets,95
Fri Jan 18 2013,1,Memphis Grizzlies,16,85,7:00 pm,Sacramento Kings,69
Fri Jan 18 2013,0,Orlando Magic,-6,100,7:00 pm,Charlotte Bobcats,106
Fri Jan 18 2013,1,Philadelphia 76ers,7,108,7:00 pm,Toronto Raptors,101
Fri Jan 18 2013,1,San Antonio Spurs,7,95,7:30 pm,Golden State Warriors,88
Sat Jan 19 2013,0,Atlanta Hawks,-5,93,7:00 pm,San Antonio Spurs,98
Sat Jan 19 2013,0,Charlotte Bobcats,-4,93,7:00 pm,Sacramento Kings,97
Sat Jan 19 2013,0,Chicago Bulls,-3,82,7:00 pm,Memphis Grizzlies,85
Sat Jan 19 2013,1,Los Angeles Clippers,7,94,7:30 pm,Washington Wizards,87
Sat Jan 19 2013,1,Minnesota Timberwolves,13,92,7:00 pm,Houston Rockets,79
Sat Jan 19 2013,0,New Orleans Hornets,-4,112,7:00 pm,Golden State Warriors,116
Sat Jan 19 2013,0,Portland Trail Blazers,-6,104,7:00 pm,Milwaukee Bucks,110
Sat Jan 19 2013,1,Utah Jazz,11,109,7:00 pm,Cleveland Cavaliers,98
Sun Jan 20 2013,1,Denver Nuggets,3,121,6:00 pm,Oklahoma City Thunder,118
Sun Jan 20 2013,1,Detroit Pistons,15,103,7:30 pm,Boston Celtics,88
Sun Jan 20 2013,0,Orlando Magic,-6,105,6:00 pm,Dallas Mavericks,111
Sun Jan 20 2013,1,Toronto Raptors,5,108,1:00 pm,Los Angeles Lakers,103
Mon Jan 21 2013,1,Atlanta Hawks,8,104,2:00 pm,Minnesota Timberwolves,96
Mon Jan 21 2013,0,Charlotte Bobcats,-6,94,2:00 pm,Houston Rockets,100
Mon Jan 21 2013,1,Chicago Bulls,12,95,8:30 pm,Los Angeles Lakers,83
Mon Jan 21 2013,1,Golden State Warriors,7,106,1:00 pm,Los Angeles Clippers,99
Mon Jan 21 2013,0,Memphis Grizzlies,-1,81,12:00 pm,Indiana Pacers,82
Mon Jan 21 2013,1,New Orleans Hornets,9,114,12:00 pm,Sacramento Kings,105
Mon Jan 21 2013,0,New York Knicks,-3,85,3:30 pm,Brooklyn Nets,88
Mon Jan 21 2013,0,Philadelphia 76ers,-5,85,7:00 pm,San Antonio Spurs,90
Mon Jan 21 2013,0,Portland Trail Blazers,-3,95,7:00 pm,Washington Wizards,98
Tue Jan 22 2013,1,Cleveland Cavaliers,5,95,7:00 pm,Boston Celtics,90
Tue Jan 22 2013,1,Detroit Pistons,15,105,7:30 pm,Orlando Magic,90
Tue Jan 22 2013,0,Los Angeles Clippers,-12,97,7:30 pm,Oklahoma City Thunder,109
Tue Jan 22 2013,1,Milwaukee Bucks,8,110,7:00 pm,Philadelphia 76ers,102
Wed Jan 23 2013,0,Charlotte Bobcats,-12,92,7:00 pm,Atlanta Hawks,104
Wed Jan 23 2013,1,Chicago Bulls,3,85,7:00 pm,Detroit Pistons,82
Wed Jan 23 2013,1,Golden State Warriors,5,104,7:30 pm,Oklahoma City Thunder,99
Wed Jan 23 2013,0,Houston Rockets,-10,95,7:00 pm,Denver Nuggets,105
Wed Jan 23 2013,1,Memphis Grizzlies,13,106,7:00 pm,Los Angeles Lakers,93
Wed Jan 23 2013,1,Miami Heat,7,123,7:30 pm,Toronto Raptors,116
Wed Jan 23 2013,0,Minnesota Timberwolves,-8,83,7:00 pm,Brooklyn Nets,91
Wed Jan 23 2013,1,Portland Trail Blazers,20,100,7:00 pm,Indiana Pacers,80
Wed Jan 23 2013,0,Sacramento Kings,-10,96,7:00 pm,Phoenix Suns,106
Wed Jan 23 2013,1,San Antonio Spurs,4,106,7:30 pm,New Orleans Hornets,102
Wed Jan 23 2013,1,Utah Jazz,4,92,7:00 pm,Washington Wizards,88
Thu Jan 24 2013,0,Boston Celtics,-3,86,8:00 pm,New York Knicks,89
Thu Jan 24 2013,0,Orlando Magic,-2,95,7:00 pm,Toronto Raptors,97
Thu Jan 24 2013,1,Phoenix Suns,5,93,8:30 pm,Los Angeles Clippers,88
Fri Jan 25 2013,1,Atlanta Hawks,12,123,7:30 pm,Boston Celtics,111
Fri Jan 25 2013,1,Chicago Bulls,16,103,7:00 pm,Golden State Warriors,87
Fri Jan 25 2013,1,Cleveland Cavaliers,5,113,7:30 pm,Milwaukee Bucks,108
Fri Jan 25 2013,0,Dallas Mavericks,-6,107,7:00 pm,San Antonio Spurs,113
Fri Jan 25 2013,1,Los Angeles Lakers,18,102,7:30 pm,Utah Jazz,84
Fri Jan 25 2013,1,Memphis Grizzlies,24,101,7:00 pm,Brooklyn Nets,77
Fri Jan 25 2013,1,Miami Heat,22,110,7:30 pm,Detroit Pistons,88
Fri Jan 25 2013,0,New Orleans Hornets,-18,82,7:00 pm,Houston Rockets,100
Fri Jan 25 2013,0,Sacramento Kings,-10,95,7:00 pm,Oklahoma City Thunder,105
Fri Jan 25 2013,1,Washington Wizards,13,114,7:00 pm,Minnesota Timberwolves,101
Sat Jan 26 2013,1,Charlotte Bobcats,1,102,7:30 pm,Minnesota Timberwolves,101
Sat Jan 26 2013,1,Denver Nuggets,28,121,7:00 pm,Sacramento Kings,93
Sat Jan 26 2013,1,Houston Rockets,13,119,7:00 pm,Brooklyn Nets,106
Sat Jan 26 2013,1,Milwaukee Bucks,7,109,7:30 pm,Golden State Warriors,102
Sat Jan 26 2013,1,Philadelphia 76ers,17,97,7:00 pm,New York Knicks,80
Sat Jan 26 2013,1,Portland Trail Blazers,1,101,7:00 pm,Los Angeles Clippers,100
Sat Jan 26 2013,1,San Antonio Spurs,9,108,7:30 pm,Phoenix Suns,99
Sat Jan 26 2013,0,Toronto Raptors,-1,98,7:00 pm,Cleveland Cavaliers,99
Sat Jan 26 2013,1,Utah Jazz,4,114,7:30 pm,Indiana Pacers,110
Sat Jan 26 2013,1,Washington Wizards,13,86,7:00 pm,Chicago Bulls,73
Sun Jan 27 2013,1,Boston Celtics,2,100,1:00 pm,Miami Heat,98
Sun Jan 27 2013,1,Dallas Mavericks,15,110,6:30 pm,Phoenix Suns,95
Sun Jan 27 2013,1,Los Angeles Clippers,13,96,6:30 pm,Portland Trail Blazers,83
Sun Jan 27 2013,1,Los Angeles Lakers,9,105,12:30 pm,Oklahoma City Thunder,96
Sun Jan 27 2013,0,Memphis Grizzlies,-8,83,5:00 pm,New Orleans Hornets,91
Sun Jan 27 2013,1,New York Knicks,2,106,6:30 pm,Atlanta Hawks,104
Sun Jan 27 2013,0,Orlando Magic,-2,102,6:00 pm,Detroit Pistons,104
Mon Jan 28 2013,1,Brooklyn Nets,20,97,7:30 pm,Orlando Magic,77
Mon Jan 28 2013,1,Chicago Bulls,8,93,7:00 pm,Charlotte Bobcats,85
Mon Jan 28 2013,1,Denver Nuggets,1,102,7:00 pm,Indiana Pacers,101
Mon Jan 28 2013,0,Philadelphia 76ers,-3,100,7:00 pm,Memphis Grizzlies,103
Mon Jan 28 2013,0,Toronto Raptors,-12,102,7:00 pm,Golden State Warriors,114
Mon Jan 28 2013,0,Utah Jazz,-45,80,7:00 pm,Houston Rockets,125
Mon Jan 28 2013,0,Washington Wizards,-2,94,7:00 pm,Sacramento Kings,96
Tue Jan 29 2013,0,Cleveland Cavaliers,-13,95,7:00 pm,Golden State Warriors,108
Tue Jan 29 2013,0,Detroit Pistons,-27,90,7:30 pm,Milwaukee Bucks,117
Tue Jan 29 2013,1,Los Angeles Lakers,5,111,7:30 pm,New Orleans Hornets,106
Tue Jan 29 2013,1,Portland Trail Blazers,2,106,7:00 pm,Dallas Mavericks,104
Wed Jan 30 2013,1,Atlanta Hawks,1,93,7:30 pm,Toronto Raptors,92
Wed Jan 30 2013,1,Boston Celtics,18,99,7:30 pm,Sacramento Kings,81
Wed Jan 30 2013,0,Brooklyn Nets,-20,85,8:00 pm,Miami Heat,105
Wed Jan 30 2013,1,Denver Nuggets,8,118,7:00 pm,Houston Rockets,110
Wed Jan 30 2013,1,Indiana Pacers,19,98,7:00 pm,Detroit Pistons,79
Wed Jan 30 2013,0,Milwaukee Bucks,-16,88,7:00 pm,Chicago Bulls,104
Wed Jan 30 2013,0,Minnesota Timberwolves,-6,90,7:00 pm,Los Angeles Clippers,96
Wed Jan 30 2013,1,New York Knicks,16,113,7:30 pm,Orlando Magic,97
Wed Jan 30 2013,1,Philadelphia 76ers,8,92,7:00 pm,Washington Wizards,84
Wed Jan 30 2013,1,Phoenix Suns,6,92,8:30 pm,Los Angeles Lakers,86
Wed Jan 30 2013,1,San Antonio Spurs,24,102,7:30 pm,Charlotte Bobcats,78
Wed Jan 30 2013,1,Utah Jazz,5,104,7:00 pm,New Orleans Hornets,99
Thu Jan 31 2013,1,Golden State Warriors,3,100,7:30 pm,Dallas Mavericks,97
Thu Jan 31 2013,1,Oklahoma City Thunder,17,106,7:00 pm,Memphis Grizzlies,89
Fri Feb 1 2013,1,Boston Celtics,13,97,7:30 pm,Orlando Magic,84
Fri Feb 1 2013,1,Brooklyn Nets,4,93,7:30 pm,Chicago Bulls,89
Fri Feb 1 2013,1,Denver Nuggets,15,113,7:00 pm,New Orleans Hornets,98
Fri Feb 1 2013,1,Detroit Pistons,18,117,7:30 pm,Cleveland Cavaliers,99
Fri Feb 1 2013,1,Indiana Pacers,13,102,7:00 pm,Miami Heat,89
Fri Feb 1 2013,1,Memphis Grizzlies,9,85,7:00 pm,Washington Wizards,76
Fri Feb 1 2013,0,Minnesota Timberwolves,-11,100,8:30 pm,Los Angeles Lakers,111
Fri Feb 1 2013,1,New York Knicks,10,96,7:30 pm,Milwaukee Bucks,86
Fri Feb 1 2013,1,Philadelphia 76ers,9,89,7:30 pm,Sacramento Kings,80
Fri Feb 1 2013,0,Phoenix Suns,-10,99,7:00 pm,Dallas Mavericks,109
Fri Feb 1 2013,1,Toronto Raptors,25,98,7:00 pm,Los Angeles Clippers,73
Fri Feb 1 2013,1,Utah Jazz,9,86,7:00 pm,Portland Trail Blazers,77
Sat Feb 2 2013,0,Atlanta Hawks,-17,76,7:00 pm,Chicago Bulls,93
Sat Feb 2 2013,1,Cleveland Cavaliers,5,115,7:30 pm,Oklahoma City Thunder,110
Sat Feb 2 2013,1,Golden State Warriors,20,113,7:30 pm,Phoenix Suns,93
Sat Feb 2 2013,1,Houston Rockets,14,109,7:00 pm,Charlotte Bobcats,95
Sat Feb 2 2013,1,Milwaukee Bucks,9,107,7:30 pm,Orlando Magic,98
Sat Feb 2 2013,1,Minnesota Timberwolves,29,115,7:00 pm,New Orleans Hornets,86
Sat Feb 2 2013,1,New York Knicks,39,120,7:30 pm,Sacramento Kings,81
Sat Feb 2 2013,1,Portland Trail Blazers,6,105,7:00 pm,Utah Jazz,99
Sat Feb 2 2013,1,San Antonio Spurs,10,96,7:30 pm,Washington Wizards,86
Sun Feb 3 2013,1,Boston Celtics,2,106,1:00 pm,Los Angeles Clippers,104
Sun Feb 3 2013,0,Detroit Pistons,-1,97,1:00 pm,Los Angeles Lakers,98
Sun Feb 3 2013,0,Toronto Raptors,-15,85,2:00 pm,Miami Heat,100
Mon Feb 4 2013,1,Indiana Pacers,10,111,7:00 pm,Chicago Bulls,101
Mon Feb 4 2013,1,Miami Heat,5,99,7:30 pm,Charlotte Bobcats,94
Mon Feb 4 2013,0,Minnesota Timberwolves,-2,98,7:00 pm,Portland Trail Blazers,100
Mon Feb 4 2013,1,New York Knicks,14,99,7:30 pm,Detroit Pistons,85
Mon Feb 4 2013,1,Oklahoma City Thunder,21,112,7:00 pm,Dallas Mavericks,91
Mon Feb 4 2013,1,Philadelphia 76ers,17,78,7:00 pm,Orlando Magic,61
Mon Feb 4 2013,1,Utah Jazz,7,98,7:00 pm,Sacramento Kings,91
Mon Feb 4 2013,1,Washington Wizards,8,98,7:00 pm,Los Angeles Clippers,90
Tue Feb 5 2013,0,Brooklyn Nets,-9,83,7:30 pm,Los Angeles Lakers,92
Tue Feb 5 2013,1,Denver Nuggets,8,112,7:00 pm,Milwaukee Bucks,104
Tue Feb 5 2013,1,Houston Rockets,31,140,7:00 pm,Golden State Warriors,109
Tue Feb 5 2013,1,Indiana Pacers,11,114,7:00 pm,Atlanta Hawks,103
Tue Feb 5 2013,0,Memphis Grizzlies,-6,90,7:00 pm,Phoenix Suns,96
Wed Feb 6 2013,1,Atlanta Hawks,11,103,7:30 pm,Memphis Grizzlies,92
Wed Feb 6 2013,1,Cleveland Cavaliers,27,122,7:00 pm,Charlotte Bobcats,95
Wed Feb 6 2013,1,Dallas Mavericks,6,105,7:30 pm,Portland Trail Blazers,99
Wed Feb 6 2013,0,Detroit Pistons,-3,90,7:30 pm,Brooklyn Nets,93
Wed Feb 6 2013,1,Miami Heat,6,114,7:30 pm,Houston Rockets,108
Wed Feb 6 2013,0,Minnesota Timberwolves,-10,94,8:00 pm,San Antonio Spurs,104
Wed Feb 6 2013,1,New Orleans Hornets,9,93,7:00 pm,Phoenix Suns,84
Wed Feb 6 2013,1,Oklahoma City Thunder,21,119,7:00 pm,Golden State Warriors,98
Wed Feb 6 2013,0,Orlando Magic,-10,76,7:00 pm,Los Angeles Clippers,86
Wed Feb 6 2013,0,Philadelphia 76ers,-19,69,7:00 pm,Indiana Pacers,88
Wed Feb 6 2013,0,Toronto Raptors,-4,95,7:00 pm,Boston Celtics,99
Wed Feb 6 2013,1,Utah Jazz,14,100,7:00 pm,Milwaukee Bucks,86
Wed Feb 6 2013,1,Washington Wizards,10,106,7:00 pm,New York Knicks,96
Thu Feb 7 2013,1,Boston Celtics,21,116,8:00 pm,Los Angeles Lakers,95
Thu Feb 7 2013,1,Denver Nuggets,32,128,8:30 pm,Chicago Bulls,96
Fri Feb 8 2013,0,Atlanta Hawks,-11,100,7:30 pm,New Orleans Hornets,111
Fri Feb 8 2013,0,Charlotte Bobcats,-7,93,7:00 pm,Los Angeles Lakers,100
Fri Feb 8 2013,1,Cleveland Cavaliers,11,119,7:30 pm,Orlando Magic,108
Fri Feb 8 2013,1,Detroit Pistons,10,119,7:30 pm,San Antonio Spurs,109
Fri Feb 8 2013,1,Houston Rockets,15,118,7:00 pm,Portland Trail Blazers,103
Fri Feb 8 2013,0,Indiana Pacers,-2,98,7:00 pm,Toronto Raptors,100
Fri Feb 8 2013,1,Memphis Grizzlies,6,99,7:00 pm,Golden State Warriors,93
Fri Feb 8 2013,1,Miami Heat,22,111,8:00 pm,Los Angeles Clippers,89
Fri Feb 8 2013,0,Minnesota Timberwolves,-6,94,7:00 pm,New York Knicks,100
Fri Feb 8 2013,1,Oklahoma City Thunder,31,127,7:00 pm,Phoenix Suns,96
Fri Feb 8 2013,0,Utah Jazz,-4,89,8:30 pm,Chicago Bulls,93
Fri Feb 8 2013,1,Washington Wizards,15,89,7:00 pm,Brooklyn Nets,74
Sat Feb 9 2013,0,Cleveland Cavaliers,-8,103,7:30 pm,Denver Nuggets,111
Sat Feb 9 2013,1,Dallas Mavericks,25,116,7:30 pm,Golden State Warriors,91
Sat Feb 9 2013,0,Milwaukee Bucks,-5,100,7:30 pm,Detroit Pistons,105
Sat Feb 9 2013,1,Philadelphia 76ers,11,87,8:00 pm,Charlotte Bobcats,76
Sat Feb 9 2013,1,Sacramento Kings,11,120,7:00 pm,Utah Jazz,109
Sun Feb 10 2013,1,Boston Celtics,4,118,6:00 pm,Denver Nuggets,114
Sun Feb 10 2013,0,Brooklyn Nets,-25,86,8:00 pm,San Antonio Spurs,111
Sun Feb 10 2013,1,Memphis Grizzlies,17,105,5:00 pm,Minnesota Timberwolves,88
Sun Feb 10 2013,1,Miami Heat,10,107,3:30 pm,Los Angeles Lakers,97
Sun Feb 10 2013,0,New York Knicks,-14,88,1:00 pm,Los Angeles Clippers,102
Sun Feb 10 2013,1,Orlando Magic,6,110,6:00 pm,Portland Trail Blazers,104
Sun Feb 10 2013,0,Phoenix Suns,-28,69,6:00 pm,Oklahoma City Thunder,97
Sun Feb 10 2013,1,Sacramento Kings,6,117,6:00 pm,Houston Rockets,111
Sun Feb 10 2013,1,Toronto Raptors,13,102,6:00 pm,New Orleans Hornets,89
Mon Feb 11 2013,1,Charlotte Bobcats,3,94,7:00 pm,Boston Celtics,91
Mon Feb 11 2013,0,Chicago Bulls,-14,89,7:00 pm,San Antonio Spurs,103
Mon Feb 11 2013,0,Cleveland Cavaliers,-8,92,7:00 pm,Minnesota Timberwolves,100
Mon Feb 11 2013,0,Dallas Mavericks,-4,101,7:30 pm,Atlanta Hawks,105
Mon Feb 11 2013,0,Detroit Pistons,-19,86,7:30 pm,New Orleans Hornets,105
Mon Feb 11 2013,0,Indiana Pacers,-5,84,7:00 pm,Brooklyn Nets,89
Mon Feb 11 2013,0,Milwaukee Bucks,-12,90,7:00 pm,Washington Wizards,102
Mon Feb 11 2013,0,Philadelphia 76ers,-17,90,7:00 pm,Los Angeles Clippers,107
Tue Feb 12 2013,0,Golden State Warriors,-9,107,7:30 pm,Houston Rockets,116
Tue Feb 12 2013,1,Los Angeles Lakers,6,91,7:30 pm,Phoenix Suns,85
Tue Feb 12 2013,1,Memphis Grizzlies,7,108,7:00 pm,Sacramento Kings,101
Tue Feb 12 2013,1,Miami Heat,13,117,7:30 pm,Portland Trail Blazers,104
Tue Feb 12 2013,1,Toronto Raptors,1,109,7:00 pm,Denver Nuggets,108
Tue Feb 12 2013,1,Utah Jazz,15,109,7:00 pm,Oklahoma City Thunder,94
Wed Feb 13 2013,1,Boston Celtics,2,71,7:30 pm,Chicago Bulls,69
Wed Feb 13 2013,1,Brooklyn Nets,11,119,7:30 pm,Denver Nuggets,108
Wed Feb 13 2013,0,Cleveland Cavaliers,-1,95,7:00 pm,San Antonio Spurs,96
Wed Feb 13 2013,1,Dallas Mavericks,23,123,7:30 pm,Sacramento Kings,100
Wed Feb 13 2013,1,Detroit Pistons,11,96,7:30 pm,Washington Wizards,85
Wed Feb 13 2013,1,Indiana Pacers,24,101,7:00 pm,Charlotte Bobcats,77
Wed Feb 13 2013,1,Los Angeles Clippers,10,106,7:30 pm,Houston Rockets,96
Wed Feb 13 2013,1,Milwaukee Bucks,2,94,7:00 pm,Philadelphia 76ers,92
Wed Feb 13 2013,0,Minnesota Timberwolves,-4,93,7:00 pm,Utah Jazz,97
Wed Feb 13 2013,1,New Orleans Hornets,36,99,7:00 pm,Portland Trail Blazers,63
Wed Feb 13 2013,0,New York Knicks,-4,88,7:30 pm,Toronto Raptors,92
Wed Feb 13 2013,0,Orlando Magic,-32,76,7:00 pm,Atlanta Hawks,108
Thu Feb 14 2013,0,Los Angeles Lakers,-24,101,7:30 pm,Los Angeles Clippers,125
Thu Feb 14 2013,0,Oklahoma City Thunder,-10,100,7:00 pm,Miami Heat,110
Tue Feb 19 2013,1,Brooklyn Nets,2,113,7:30 pm,Milwaukee Bucks,111
Tue Feb 19 2013,1,Denver Nuggets,7,97,7:00 pm,Boston Celtics,90
Tue Feb 19 2013,0,Detroit Pistons,-14,91,7:30 pm,Memphis Grizzlies,105
Tue Feb 19 2013,0,New Orleans Hornets,-9,87,7:00 pm,Chicago Bulls,96
Tue Feb 19 2013,0,Orlando Magic,-13,92,7:00 pm,Charlotte Bobcats,105
Tue Feb 19 2013,0,Portland Trail Blazers,-4,98,7:00 pm,Phoenix Suns,102
Tue Feb 19 2013,0,Sacramento Kings,-6,102,7:00 pm,San Antonio Spurs,108
Tue Feb 19 2013,1,Utah Jazz,14,115,7:00 pm,Golden State Warriors,101
Tue Feb 19 2013,0,Washington Wizards,-8,88,7:00 pm,Toronto Raptors,96
Wed Feb 20 2013,0,Atlanta Hawks,-13,90,8:00 pm,Miami Heat,103
Wed Feb 20 2013,0,Charlotte Bobcats,-6,99,7:00 pm,Detroit Pistons,105
Wed Feb 20 2013,1,Cleveland Cavaliers,5,105,8:00 pm,New Orleans Hornets,100
Wed Feb 20 2013,1,Dallas Mavericks,15,111,7:30 pm,Orlando Magic,96
Wed Feb 20 2013,1,Golden State Warriors,10,108,7:30 pm,Phoenix Suns,98
Wed Feb 20 2013,1,Houston Rockets,3,122,7:00 pm,Oklahoma City Thunder,119
Wed Feb 20 2013,1,Indiana Pacers,34,125,7:00 pm,New York Knicks,91
Wed Feb 20 2013,1,Los Angeles Lakers,14,113,7:30 pm,Boston Celtics,99
Wed Feb 20 2013,0,Milwaukee Bucks,-3,94,7:00 pm,Brooklyn Nets,97
Wed Feb 20 2013,1,Minnesota Timberwolves,7,94,7:00 pm,Philadelphia 76ers,87
Wed Feb 20 2013,0,Toronto Raptors,-6,82,7:00 pm,Memphis Grizzlies,88
Thu Feb 21 2013,0,Chicago Bulls,-19,67,7:00 pm,Miami Heat,86
Thu Feb 21 2013,0,Los Angeles Clippers,-26,90,7:30 pm,San Antonio Spurs,116
Fri Feb 22 2013,1,Atlanta Hawks,14,122,7:30 pm,Sacramento Kings,108
Fri Feb 22 2013,0,Brooklyn Nets,-10,96,7:30 pm,Houston Rockets,106
Fri Feb 22 2013,0,Charlotte Bobcats,-30,75,7:00 pm,Chicago Bulls,105
Fri Feb 22 2013,1,Golden State Warriors,6,107,7:30 pm,San Antonio Spurs,101
Fri Feb 22 2013,1,Indiana Pacers,32,114,7:00 pm,Detroit Pistons,82
Fri Feb 22 2013,1,Los Angeles Lakers,4,111,7:30 pm,Portland Trail Blazers,107
Fri Feb 22 2013,1,Memphis Grizzlies,6,88,7:00 pm,Orlando Magic,82
Fri Feb 22 2013,0,New Orleans Hornets,-4,100,7:00 pm,Dallas Mavericks,104
Fri Feb 22 2013,1,Oklahoma City Thunder,16,127,7:00 pm,Minnesota Timberwolves,111
Fri Feb 22 2013,0,Phoenix Suns,-25,88,7:00 pm,Boston Celtics,113
Fri Feb 22 2013,1,Toronto Raptors,2,100,7:00 pm,New York Knicks,98
Fri Feb 22 2013,1,Washington Wizards,6,119,7:00 pm,Denver Nuggets,113
Sat Feb 23 2013,0,Charlotte Bobcats,-14,99,7:00 pm,Denver Nuggets,113
Sat Feb 23 2013,0,Detroit Pistons,-18,72,7:30 pm,Indiana Pacers,90
Sat Feb 23 2013,1,Los Angeles Clippers,13,107,7:30 pm,Utah Jazz,94
Sat Feb 23 2013,0,Milwaukee Bucks,-1,102,7:30 pm,Atlanta Hawks,103
Sat Feb 23 2013,0,Orlando Magic,-24,94,7:00 pm,Cleveland Cavaliers,118
Sat Feb 23 2013,0,Philadelphia 76ers,-24,90,7:30 pm,Miami Heat,114
Sat Feb 23 2013,1,Washington Wizards,2,105,7:00 pm,Houston Rockets,103
Sun Feb 24 2013,0,Brooklyn Nets,-4,72,7:00 pm,Memphis Grizzlies,76
Sun Feb 24 2013,0,Dallas Mavericks,-4,99,12:00 pm,Los Angeles Lakers,103
Sun Feb 24 2013,1,Miami Heat,4,109,6:00 pm,Cleveland Cavaliers,105
Sun Feb 24 2013,0,Minnesota Timberwolves,-1,99,2:30 pm,Golden State Warriors,100
Sun Feb 24 2013,1,New Orleans Hornets,15,110,5:00 pm,Sacramento Kings,95
Sun Feb 24 2013,1,New York Knicks,6,99,7:00 pm,Philadelphia 76ers,93
Sun Feb 24 2013,1,Oklahoma City Thunder,30,102,8:30 pm,Chicago Bulls,72
Sun Feb 24 2013,0,Phoenix Suns,-10,87,6:00 pm,San Antonio Spurs,97
Sun Feb 24 2013,1,Portland Trail Blazers,6,92,6:00 pm,Boston Celtics,86
Mon Feb 25 2013,1,Denver Nuggets,11,119,7:00 pm,Los Angeles Lakers,108
Mon Feb 25 2013,0,Detroit Pistons,-11,103,7:30 pm,Atlanta Hawks,114
Mon Feb 25 2013,0,Toronto Raptors,-6,84,7:00 pm,Washington Wizards,90
Mon Feb 25 2013,0,Utah Jazz,-3,107,7:00 pm,Boston Celtics,110
Tue Feb 26 2013,0,Chicago Bulls,-3,98,7:00 pm,Cleveland Cavaliers,101
Tue Feb 26 2013,0,Dallas Mavericks,-5,90,7:30 pm,Milwaukee Bucks,95
Tue Feb 26 2013,1,Indiana Pacers,11,108,7:00 pm,Golden State Warriors,97
Tue Feb 26 2013,1,Los Angeles Clippers,22,106,7:30 pm,Charlotte Bobcats,84
Tue Feb 26 2013,1,Miami Heat,12,141,7:30 pm,Sacramento Kings,129
Tue Feb 26 2013,0,New Orleans Hornets,-4,97,7:00 pm,Brooklyn Nets,101
Tue Feb 26 2013,0,Philadelphia 76ers,-14,84,7:00 pm,Orlando Magic,98
Tue Feb 26 2013,1,Phoenix Suns,1,84,7:00 pm,Minnesota Timberwolves,83
Wed Feb 27 2013,1,Cleveland Cavaliers,11,103,7:00 pm,Toronto Raptors,92
Wed Feb 27 2013,0,Houston Rockets,-3,107,7:00 pm,Milwaukee Bucks,110
Wed Feb 27 2013,1,Memphis Grizzlies,6,90,7:00 pm,Dallas Mavericks,84
Wed Feb 27 2013,1,New York Knicks,4,109,8:00 pm,Golden State Warriors,105
Wed Feb 27 2013,1,Oklahoma City Thunder,45,119,7:00 pm,New Orleans Hornets,74
Wed Feb 27 2013,0,Orlando Magic,-24,101,7:00 pm,Sacramento Kings,125
Wed Feb 27 2013,0,Portland Trail Blazers,-2,109,7:30 pm,Denver Nuggets,111
Wed Feb 27 2013,0,San Antonio Spurs,-4,101,7:30 pm,Phoenix Suns,105
Wed Feb 27 2013,0,Utah Jazz,-11,91,7:00 pm,Atlanta Hawks,102
Wed Feb 27 2013,0,Washington Wizards,-1,95,7:00 pm,Detroit Pistons,96
Thu Feb 28 2013,1,Chicago Bulls,11,93,7:00 pm,Philadelphia 76ers,82
Thu Feb 28 2013,0,Indiana Pacers,-8,91,7:00 pm,Los Angeles Clippers,99
Thu Feb 28 2013,1,Los Angeles Lakers,22,116,7:30 pm,Minnesota Timberwolves,94
Fri Mar 1 2013,1,Boston Celtics,8,94,7:30 pm,Golden State Warriors,86
Fri Mar 1 2013,0,Brooklyn Nets,-8,90,8:00 pm,Dallas Mavericks,98
Fri Mar 1 2013,0,Cleveland Cavaliers,-16,89,7:30 pm,Los Angeles Clippers,105
Fri Mar 1 2013,1,Denver Nuggets,2,105,8:30 pm,Oklahoma City Thunder,103
Fri Mar 1 2013,1,Miami Heat,7,98,8:00 pm,Memphis Grizzlies,91
Fri Mar 1 2013,1,New Orleans Hornets,5,100,7:00 pm,Detroit Pistons,95
Fri Mar 1 2013,0,Orlando Magic,-8,110,7:00 pm,Houston Rockets,118
Fri Mar 1 2013,1,Phoenix Suns,5,92,7:00 pm,Atlanta Hawks,87
Fri Mar 1 2013,1,San Antonio Spurs,28,130,7:30 pm,Sacramento Kings,102
Fri Mar 1 2013,0,Toronto Raptors,-12,81,7:00 pm,Indiana Pacers,93
Fri Mar 1 2013,1,Utah Jazz,30,98,7:00 pm,Charlotte Bobcats,68
Fri Mar 1 2013,0,Washington Wizards,-8,88,7:00 pm,New York Knicks,96
Sat Mar 2 2013,1,Chicago Bulls,11,96,7:00 pm,Brooklyn Nets,85
Sat Mar 2 2013,1,Milwaukee Bucks,8,122,7:30 pm,Toronto Raptors,114
Sat Mar 2 2013,1,Philadelphia 76ers,7,104,7:00 pm,Golden State Warriors,97
Sat Mar 2 2013,1,Portland Trail Blazers,15,109,7:00 pm,Minnesota Timberwolves,94
Sun Mar 3 2013,1,Houston Rockets,33,136,6:00 pm,Dallas Mavericks,103
Sun Mar 3 2013,1,Indiana Pacers,5,97,8:00 pm,Chicago Bulls,92
Sun Mar 3 2013,0,Los Angeles Clippers,-4,104,12:30 pm,Oklahoma City Thunder,108
Sun Mar 3 2013,1,Los Angeles Lakers,1,99,6:30 pm,Atlanta Hawks,98
Sun Mar 3 2013,0,New York Knicks,-6,93,1:00 pm,Miami Heat,99
Sun Mar 3 2013,0,Orlando Magic,-26,82,6:00 pm,Memphis Grizzlies,108
Sun Mar 3 2013,1,Sacramento Kings,36,119,3:00 pm,Charlotte Bobcats,83
Sun Mar 3 2013,1,San Antonio Spurs,39,114,6:00 pm,Detroit Pistons,75
Sun Mar 3 2013,1,Washington Wizards,3,90,6:00 pm,Philadelphia 76ers,87
Mon Mar 4 2013,0,Cleveland Cavaliers,-5,97,7:00 pm,New York Knicks,102
Mon Mar 4 2013,1,Denver Nuggets,16,104,7:00 pm,Atlanta Hawks,88
Mon Mar 4 2013,1,Golden State Warriors,7,125,7:30 pm,Toronto Raptors,118
Mon Mar 4 2013,1,Milwaukee Bucks,1,109,7:00 pm,Utah Jazz,108
Mon Mar 4 2013,0,Minnesota Timberwolves,-16,81,7:00 pm,Miami Heat,97
Mon Mar 4 2013,0,New Orleans Hornets,-3,102,7:00 pm,Orlando Magic,105
Mon Mar 4 2013,1,Portland Trail Blazers,17,122,7:00 pm,Charlotte Bobcats,105
Tue Mar 5 2013,1,Oklahoma City Thunder,17,122,8:30 pm,Los Angeles Lakers,105
Tue Mar 5 2013,0,Philadelphia 76ers,-8,101,7:00 pm,Boston Celtics,109
Tue Mar 5 2013,0,Sacramento Kings,-7,113,7:00 pm,Denver Nuggets,120
Wed Mar 6 2013,1,Atlanta Hawks,11,107,7:30 pm,Philadelphia 76ers,96
Wed Mar 6 2013,0,Charlotte Bobcats,-21,78,7:00 pm,Brooklyn Nets,99
Wed Mar 6 2013,1,Cleveland Cavaliers,3,104,7:00 pm,Utah Jazz,101
Wed Mar 6 2013,1,Dallas Mavericks,4,112,7:30 pm,Houston Rockets,108
Wed Mar 6 2013,0,Detroit Pistons,-10,77,7:30 pm,New York Knicks,87
Wed Mar 6 2013,1,Golden State Warriors,4,87,7:30 pm,Sacramento Kings,83
Wed Mar 6 2013,0,Indiana Pacers,-2,81,7:00 pm,Boston Celtics,83
Wed Mar 6 2013,1,Los Angeles Clippers,16,117,7:30 pm,Milwaukee Bucks,101
Wed Mar 6 2013,1,Memphis Grizzlies,6,91,7:00 pm,Portland Trail Blazers,85
Wed Mar 6 2013,1,Miami Heat,1,97,7:30 pm,Orlando Magic,96
Wed Mar 6 2013,1,Minnesota Timberwolves,5,87,7:00 pm,Washington Wizards,82
Wed Mar 6 2013,0,New Orleans Hornets,-6,102,7:00 pm,Los Angeles Lakers,108
Wed Mar 6 2013,0,Phoenix Suns,-27,71,7:00 pm,Toronto Raptors,98
Wed Mar 6 2013,1,San Antonio Spurs,18,101,8:00 pm,Chicago Bulls,83
Thu Mar 7 2013,1,Denver Nuggets,15,107,8:30 pm,Los Angeles Clippers,92
Thu Mar 7 2013,0,New York Knicks,-1,94,8:00 pm,Oklahoma City Thunder,95
Fri Mar 8 2013,1,Boston Celtics,5,107,8:00 pm,Atlanta Hawks,102
Fri Mar 8 2013,1,Brooklyn Nets,17,95,7:30 pm,Washington Wizards,78
Fri Mar 8 2013,0,Charlotte Bobcats,-22,94,7:00 pm,Oklahoma City Thunder,116
Fri Mar 8 2013,1,Chicago Bulls,1,89,7:00 pm,Utah Jazz,88
Fri Mar 8 2013,0,Cleveland Cavaliers,-11,92,7:30 pm,Memphis Grizzlies,103
Fri Mar 8 2013,0,Detroit Pistons,-3,99,7:30 pm,Dallas Mavericks,102
Fri Mar 8 2013,0,Golden State Warriors,-6,88,7:30 pm,Houston Rockets,94
Fri Mar 8 2013,1,Los Angeles Lakers,2,118,7:30 pm,Toronto Raptors,116
Fri Mar 8 2013,1,Miami Heat,9,102,8:00 pm,Philadelphia 76ers,93
Fri Mar 8 2013,0,Orlando Magic,-29,86,7:00 pm,Indiana Pacers,115
Fri Mar 8 2013,1,Sacramento Kings,9,121,7:00 pm,Phoenix Suns,112
Fri Mar 8 2013,0,San Antonio Spurs,-30,106,7:30 pm,Portland Trail Blazers,136
Sat Mar 9 2013,0,Atlanta Hawks,-13,80,7:00 pm,Brooklyn Nets,93
Sat Mar 9 2013,1,Denver Nuggets,23,111,7:00 pm,Minnesota Timberwolves,88
Sat Mar 9 2013,0,Golden State Warriors,-10,93,7:30 pm,Milwaukee Bucks,103
Sat Mar 9 2013,1,Memphis Grizzlies,11,96,7:00 pm,New Orleans Hornets,85
Sat Mar 9 2013,1,New York Knicks,29,113,7:30 pm,Utah Jazz,84
Sat Mar 9 2013,1,Phoenix Suns,2,107,7:00 pm,Houston Rockets,105
Sat Mar 9 2013,1,Washington Wizards,17,104,8:00 pm,Charlotte Bobcats,87
Sun Mar 10 2013,1,Los Angeles Clippers,32,129,6:30 pm,Detroit Pistons,97
Sun Mar 10 2013,1,Los Angeles Lakers,9,90,12:30 pm,Chicago Bulls,81
Sun Mar 10 2013,1,Miami Heat,14,105,6:00 pm,Indiana Pacers,91
Sun Mar 10 2013,0,Minnesota Timberwolves,-23,77,6:00 pm,Dallas Mavericks,100
Sun Mar 10 2013,1,New Orleans Hornets,2,98,6:00 pm,Portland Trail Blazers,96
Sun Mar 10 2013,1,Oklahoma City Thunder,12,91,12:00 pm,Boston Celtics,79
Sun Mar 10 2013,1,Orlando Magic,8,99,6:00 pm,Philadelphia 76ers,91
Sun Mar 10 2013,0,Sacramento Kings,-2,113,6:00 pm,Milwaukee Bucks,115
Sun Mar 10 2013,1,Toronto Raptors,4,100,6:00 pm,Cleveland Cavaliers,96
Mon Mar 11 2013,1,Golden State Warriors,29,92,7:30 pm,New York Knicks,63
Mon Mar 11 2013,1,Philadelphia 76ers,9,106,7:00 pm,Brooklyn Nets,97
Mon Mar 11 2013,0,Phoenix Suns,-15,93,7:00 pm,Denver Nuggets,108
Mon Mar 11 2013,1,San Antonio Spurs,12,105,7:30 pm,Oklahoma City Thunder,93
Mon Mar 11 2013,1,Utah Jazz,13,103,7:00 pm,Detroit Pistons,90
Tue Mar 12 2013,1,Brooklyn Nets,10,108,7:30 pm,New Orleans Hornets,98
Tue Mar 12 2013,1,Charlotte Bobcats,26,100,7:00 pm,Boston Celtics,74
Tue Mar 12 2013,1,Cleveland Cavaliers,5,95,7:00 pm,Washington Wizards,90
Tue Mar 12 2013,1,Miami Heat,17,98,7:30 pm,Atlanta Hawks,81
Tue Mar 12 2013,0,Milwaukee Bucks,-7,108,7:00 pm,Dallas Mavericks,115
Tue Mar 12 2013,1,Minnesota Timberwolves,24,107,7:00 pm,San Antonio Spurs,83
Tue Mar 12 2013,0,Orlando Magic,-9,97,7:00 pm,Los Angeles Lakers,106
Tue Mar 12 2013,0,Portland Trail Blazers,-5,97,7:00 pm,Memphis Grizzlies,102
Wed Mar 13 2013,1,Atlanta Hawks,4,96,7:30 pm,Los Angeles Lakers,92
Wed Mar 13 2013,1,Boston Celtics,24,112,7:30 pm,Toronto Raptors,88
Wed Mar 13 2013,1,Denver Nuggets,23,117,8:30 pm,New York Knicks,94
Wed Mar 13 2013,1,Golden State Warriors,8,105,7:30 pm,Detroit Pistons,97
Wed Mar 13 2013,1,Houston Rockets,30,111,7:00 pm,Phoenix Suns,81
Wed Mar 13 2013,1,Indiana Pacers,16,107,7:00 pm,Minnesota Timberwolves,91
Wed Mar 13 2013,0,Los Angeles Clippers,-11,85,7:30 pm,Memphis Grizzlies,96
Wed Mar 13 2013,1,Oklahoma City Thunder,23,110,7:00 pm,Utah Jazz,87
Wed Mar 13 2013,0,Philadelphia 76ers,-4,94,7:00 pm,Miami Heat,98
Wed Mar 13 2013,1,Sacramento Kings,42,121,7:00 pm,Chicago Bulls,79
Wed Mar 13 2013,1,Washington Wizards,13,106,7:00 pm,Milwaukee Bucks,93
Thu Mar 14 2013,1,Portland Trail Blazers,15,105,7:30 pm,New York Knicks,90
Thu Mar 14 2013,1,San Antonio Spurs,1,92,7:00 pm,Dallas Mavericks,91
Fri Mar 15 2013,1,Atlanta Hawks,13,107,7:30 pm,Phoenix Suns,94
Fri Mar 15 2013,1,Dallas Mavericks,10,96,7:30 pm,Cleveland Cavaliers,86
Fri Mar 15 2013,1,Denver Nuggets,7,87,7:00 pm,Memphis Grizzlies,80
Fri Mar 15 2013,0,Golden State Warriors,-18,95,7:30 pm,Chicago Bulls,113
Fri Mar 15 2013,1,Houston Rockets,8,108,7:00 pm,Minnesota Timberwolves,100
Fri Mar 15 2013,0,Indiana Pacers,-6,93,7:00 pm,Los Angeles Lakers,99
Fri Mar 15 2013,0,Milwaukee Bucks,-13,94,7:30 pm,Miami Heat,107
Fri Mar 15 2013,1,Oklahoma City Thunder,13,117,7:00 pm,Orlando Magic,104
Fri Mar 15 2013,1,Toronto Raptors,14,92,7:00 pm,Charlotte Bobcats,78
Fri Mar 15 2013,1,Washington Wizards,9,96,7:00 pm,New Orleans Hornets,87
Sat Mar 16 2013,1,Boston Celtics,17,105,7:30 pm,Charlotte Bobcats,88
Sat Mar 16 2013,1,Philadelphia 76ers,7,98,7:30 pm,Indiana Pacers,91
Sat Mar 16 2013,1,Portland Trail Blazers,11,112,7:00 pm,Detroit Pistons,101
Sat Mar 16 2013,1,San Antonio Spurs,6,119,7:30 pm,Cleveland Cavaliers,113
Sat Mar 16 2013,1,Utah Jazz,6,90,8:00 pm,Memphis Grizzlies,84
Sat Mar 16 2013,1,Washington Wizards,22,127,7:00 pm,Phoenix Suns,105
Sun Mar 17 2013,0,Brooklyn Nets,-12,93,8:00 pm,Atlanta Hawks,105
Sun Mar 17 2013,0,Dallas Mavericks,-6,101,6:30 pm,Oklahoma City Thunder,107
Sun Mar 17 2013,0,Houston Rockets,-30,78,6:00 pm,Golden State Warriors,108
Sun Mar 17 2013,1,Los Angeles Clippers,13,93,12:30 pm,New York Knicks,80
Sun Mar 17 2013,1,Los Angeles Lakers,11,113,6:30 pm,Sacramento Kings,102
Sun Mar 17 2013,1,Milwaukee Bucks,6,115,12:00 pm,Orlando Magic,109
Sun Mar 17 2013,1,Minnesota Timberwolves,2,97,6:00 pm,New Orleans Hornets,95
Sun Mar 17 2013,0,Toronto Raptors,-17,91,1:00 pm,Miami Heat,108
Mon Mar 18 2013,0,Atlanta Hawks,-14,113,7:30 pm,Dallas Mavericks,127
Mon Mar 18 2013,0,Boston Celtics,-2,103,8:00 pm,Miami Heat,105
Mon Mar 18 2013,1,Charlotte Bobcats,5,119,7:00 pm,Washington Wizards,114
Mon Mar 18 2013,0,Chicago Bulls,-1,118,7:00 pm,Denver Nuggets,119
Mon Mar 18 2013,0,Cleveland Cavaliers,-21,90,7:00 pm,Indiana Pacers,111
Mon Mar 18 2013,0,Detroit Pistons,-37,82,7:30 pm,Brooklyn Nets,119
Mon Mar 18 2013,1,Memphis Grizzlies,15,92,7:00 pm,Minnesota Timberwolves,77
Mon Mar 18 2013,0,New Orleans Hornets,-21,72,7:00 pm,Golden State Warriors,93
Mon Mar 18 2013,1,Philadelphia 76ers,1,101,7:00 pm,Portland Trail Blazers,100
Mon Mar 18 2013,1,Phoenix Suns,23,99,7:00 pm,Los Angeles Lakers,76
Mon Mar 18 2013,0,Utah Jazz,-7,83,8:30 pm,New York Knicks,90
Tue Mar 19 2013,1,Indiana Pacers,22,95,7:00 pm,Orlando Magic,73
Tue Mar 19 2013,1,Milwaukee Bucks,7,102,7:00 pm,Portland Trail Blazers,95
Tue Mar 19 2013,0,Oklahoma City Thunder,-10,104,7:00 pm,Denver Nuggets,114
Tue Mar 19 2013,1,Sacramento Kings,15,116,7:00 pm,Los Angeles Clippers,101
Wed Mar 20 2013,1,Atlanta Hawks,8,98,7:30 pm,Milwaukee Bucks,90
Wed Mar 20 2013,1,Charlotte Bobcats,6,107,7:00 pm,Toronto Raptors,101
Wed Mar 20 2013,0,Cleveland Cavaliers,-3,95,7:00 pm,Miami Heat,98
Wed Mar 20 2013,0,Dallas Mavericks,-17,96,7:00 pm,Brooklyn Nets,113
Wed Mar 20 2013,1,Houston Rockets,7,100,7:00 pm,Utah Jazz,93
Wed Mar 20 2013,1,Los Angeles Clippers,29,101,7:30 pm,Philadelphia 76ers,72
Wed Mar 20 2013,1,Memphis Grizzlies,1,90,7:00 pm,Oklahoma City Thunder,89
Wed Mar 20 2013,1,New Orleans Hornets,1,87,7:00 pm,Boston Celtics,86
Wed Mar 20 2013,1,New York Knicks,12,106,7:30 pm,Orlando Magic,94
Wed Mar 20 2013,0,Phoenix Suns,-9,79,7:00 pm,Washington Wizards,88
Wed Mar 20 2013,1,San Antonio Spurs,11,104,7:30 pm,Golden State Warriors,93
Thu Mar 21 2013,0,Chicago Bulls,-10,89,7:00 pm,Portland Trail Blazers,99
Thu Mar 21 2013,1,Denver Nuggets,1,101,7:00 pm,Philadelphia 76ers,100
Thu Mar 21 2013,1,Sacramento Kings,3,101,7:00 pm,Minnesota Timberwolves,98
Fri Mar 22 2013,0,Atlanta Hawks,-11,93,7:30 pm,Portland Trail Blazers,104
Fri Mar 22 2013,1,Dallas Mavericks,10,104,7:30 pm,Boston Celtics,94
Fri Mar 22 2013,1,Houston Rockets,38,116,7:00 pm,Cleveland Cavaliers,78
Fri Mar 22 2013,1,Indiana Pacers,24,102,7:00 pm,Milwaukee Bucks,78
Fri Mar 22 2013,0,Los Angeles Lakers,-3,100,7:30 pm,Washington Wizards,103
Fri Mar 22 2013,1,Miami Heat,14,103,7:30 pm,Detroit Pistons,89
Fri Mar 22 2013,1,New Orleans Hornets,7,90,7:00 pm,Memphis Grizzlies,83
Fri Mar 22 2013,0,Orlando Magic,-8,89,7:00 pm,Oklahoma City Thunder,97
Fri Mar 22 2013,0,Phoenix Suns,-31,86,7:00 pm,Minnesota Timberwolves,117
Fri Mar 22 2013,1,San Antonio Spurs,7,104,7:30 pm,Utah Jazz,97
Fri Mar 22 2013,0,Toronto Raptors,-5,94,7:00 pm,New York Knicks,99
Sat Mar 23 2013,0,Charlotte Bobcats,-1,91,7:00 pm,Detroit Pistons,92
Sat Mar 23 2013,1,Chicago Bulls,3,87,7:00 pm,Indiana Pacers,84
Sat Mar 23 2013,1,Denver Nuggets,6,101,7:00 pm,Sacramento Kings,95
Sat Mar 23 2013,1,Golden State Warriors,9,101,7:30 pm,Washington Wizards,92
Sat Mar 23 2013,1,Los Angeles Clippers,6,101,7:30 pm,Brooklyn Nets,95
Sat Mar 23 2013,1,Memphis Grizzlies,4,110,7:00 pm,Boston Celtics,106
Sat Mar 23 2013,1,New York Knicks,26,110,7:30 pm,Toronto Raptors,84
Sun Mar 24 2013,1,Dallas Mavericks,5,113,6:30 pm,Utah Jazz,108
Sun Mar 24 2013,1,Houston Rockets,1,96,6:00 pm,San Antonio Spurs,95
Sun Mar 24 2013,1,Miami Heat,32,109,6:00 pm,Charlotte Bobcats,77
Sun Mar 24 2013,0,Milwaukee Bucks,-5,99,2:00 pm,Atlanta Hawks,104
Sun Mar 24 2013,0,Minnesota Timberwolves,-7,97,6:00 pm,Chicago Bulls,104
Sun Mar 24 2013,1,Oklahoma City Thunder,20,103,6:00 pm,Portland Trail Blazers,83
Sun Mar 24 2013,0,Phoenix Suns,-2,100,6:00 pm,Brooklyn Nets,102
Sun Mar 24 2013,0,Sacramento Kings,-14,103,6:00 pm,Philadelphia 76ers,117
Mon Mar 25 2013,1,Golden State Warriors,6,109,7:30 pm,Los Angeles Lakers,103
Mon Mar 25 2013,1,Indiana Pacers,6,100,7:00 pm,Atlanta Hawks,94
Mon Mar 25 2013,1,New Orleans Hornets,24,110,7:00 pm,Denver Nuggets,86
Mon Mar 25 2013,0,Orlando Magic,-14,94,7:00 pm,Miami Heat,108
Mon Mar 25 2013,1,Utah Jazz,16,107,7:00 pm,Philadelphia 76ers,91
Mon Mar 25 2013,1,Washington Wizards,13,107,7:00 pm,Memphis Grizzlies,94
Tue Mar 26 2013,0,Boston Celtics,-15,85,7:00 pm,New York Knicks,100
Tue Mar 26 2013,1,Dallas Mavericks,7,109,8:30 pm,Los Angeles Clippers,102
Tue Mar 26 2013,0,Detroit Pistons,-23,82,7:30 pm,Minnesota Timberwolves,105
Wed Mar 27 2013,1,Charlotte Bobcats,6,114,7:00 pm,Orlando Magic,108
Wed Mar 27 2013,1,Chicago Bulls,4,101,7:00 pm,Miami Heat,97
Wed Mar 27 2013,0,Cleveland Cavaliers,-1,92,7:00 pm,Boston Celtics,93
Wed Mar 27 2013,0,Golden State Warriors,-7,98,7:30 pm,Sacramento Kings,105
Wed Mar 27 2013,0,Houston Rockets,-9,91,7:00 pm,Indiana Pacers,100
Wed Mar 27 2013,0,Minnesota Timberwolves,-3,117,7:00 pm,Los Angeles Lakers,120
Wed Mar 27 2013,0,New Orleans Hornets,-14,91,7:00 pm,Los Angeles Clippers,105
Wed Mar 27 2013,1,New York Knicks,7,108,7:30 pm,Memphis Grizzlies,101
Wed Mar 27 2013,1,Oklahoma City Thunder,23,103,7:00 pm,Washington Wizards,80
Wed Mar 27 2013,1,Philadelphia 76ers,8,100,7:00 pm,Milwaukee Bucks,92
Wed Mar 27 2013,0,Portland Trail Blazers,-18,93,7:30 pm,Brooklyn Nets,111
Wed Mar 27 2013,1,San Antonio Spurs,1,100,7:30 pm,Denver Nuggets,99
Wed Mar 27 2013,0,Toronto Raptors,-19,88,7:00 pm,Atlanta Hawks,107
Wed Mar 27 2013,1,Utah Jazz,15,103,7:00 pm,Phoenix Suns,88
Thu Mar 28 2013,0,Dallas Mavericks,-25,78,7:30 pm,Indiana Pacers,103
Thu Mar 28 2013,1,Milwaukee Bucks,10,113,7:00 pm,Los Angeles Lakers,103
Thu Mar 28 2013,0,Phoenix Suns,-14,103,7:00 pm,Sacramento Kings,117
Fri Mar 29 2013,1,Boston Celtics,11,118,7:30 pm,Atlanta Hawks,107
Fri Mar 29 2013,0,Cleveland Cavaliers,-10,87,7:30 pm,Philadelphia 76ers,97
Fri Mar 29 2013,1,Denver Nuggets,22,109,7:00 pm,Brooklyn Nets,87
Fri Mar 29 2013,0,Detroit Pistons,-17,82,7:30 pm,Toronto Raptors,99
Fri Mar 29 2013,1,Memphis Grizzlies,9,103,7:00 pm,Houston Rockets,94
Fri Mar 29 2013,1,Minnesota Timberwolves,8,101,7:00 pm,Oklahoma City Thunder,93
Fri Mar 29 2013,0,New Orleans Hornets,-19,89,7:00 pm,Miami Heat,108
Fri Mar 29 2013,1,New York Knicks,9,111,7:30 pm,Charlotte Bobcats,102
Fri Mar 29 2013,1,Orlando Magic,5,97,7:00 pm,Washington Wizards,92
Fri Mar 29 2013,0,Portland Trail Blazers,-10,95,7:00 pm,Utah Jazz,105
Fri Mar 29 2013,1,San Antonio Spurs,2,104,7:30 pm,Los Angeles Clippers,102
Sat Mar 30 2013,1,Atlanta Hawks,9,97,7:00 pm,Orlando Magic,88
Sat Mar 30 2013,1,Dallas Mavericks,2,100,1:00 pm,Chicago Bulls,98
Sat Mar 30 2013,1,Golden State Warriors,27,125,7:30 pm,Portland Trail Blazers,98
Sat Mar 30 2013,1,Houston Rockets,17,98,7:00 pm,Los Angeles Clippers,81
Sat Mar 30 2013,0,Milwaukee Bucks,-10,99,7:30 pm,Oklahoma City Thunder,109
Sat Mar 30 2013,0,Minnesota Timberwolves,-13,86,7:00 pm,Memphis Grizzlies,99
Sat Mar 30 2013,1,Philadelphia 76ers,8,100,8:00 pm,Charlotte Bobcats,92
Sat Mar 30 2013,0,Phoenix Suns,-8,104,7:00 pm,Indiana Pacers,112
Sat Mar 30 2013,0,Sacramento Kings,-5,98,7:00 pm,Los Angeles Lakers,103
Sat Mar 30 2013,1,Utah Jazz,9,116,7:00 pm,Brooklyn Nets,107
Sun Mar 31 2013,1,Chicago Bulls,1,95,6:00 pm,Detroit Pistons,94
Sun Mar 31 2013,1,New Orleans Hornets,20,112,5:00 pm,Cleveland Cavaliers,92
Sun Mar 31 2013,1,New York Knicks,19,108,7:30 pm,Boston Celtics,89
Sun Mar 31 2013,0,San Antonio Spurs,-2,86,6:00 pm,Miami Heat,88
Sun Mar 31 2013,1,Washington Wizards,17,109,6:00 pm,Toronto Raptors,92
