Date,HW,Home,Home_Diff,Home_Pts,Start_Time,Total_Pts,Visitor,Visitor_Pts
Oct 17 2017,1,Cleveland Cavaliers,3,102,8:01p,201,Boston Celtics,99
Oct 17 2017,0,Golden State Warriors,-1,121,10:30p,243,Houston Rockets,122
Oct 18 2017,0,Boston Celtics,-8,100,7:30p,208,Milwaukee Bucks,108
Oct 18 2017,0,Dallas Mavericks,-6,111,8:30p,228,Atlanta Hawks,117
Oct 18 2017,1,Detroit Pistons,12,102,7:00p,192,Charlotte Hornets,90
Oct 18 2017,1,Indiana Pacers,9,140,7:00p,271,Brooklyn Nets,131
Oct 18 2017,1,Memphis Grizzlies,12,103,8:00p,194,New Orleans Pelicans,91
Oct 18 2017,1,Orlando Magic,7,116,7:00p,225,Miami Heat,109
Oct 18 2017,0,Phoenix Suns,-48,76,10:00p,200,Portland Trail Blazers,124
Oct 18 2017,0,Sacramento Kings,-5,100,10:00p,205,Houston Rockets,105
Oct 18 2017,1,San Antonio Spurs,8,107,9:30p,206,Minnesota Timberwolves,99
Oct 18 2017,1,Utah Jazz,10,106,9:00p,202,Denver Nuggets,96
Oct 18 2017,1,Washington Wizards,5,120,7:00p,235,Philadelphia 76ers,115
Oct 19 2017,0,Los Angeles Lakers,-16,92,10:30p,200,Los Angeles Clippers,108
Oct 19 2017,1,Oklahoma City Thunder,21,105,8:00p,189,New York Knicks,84
Oct 19 2017,1,Toronto Raptors,17,117,7:30p,217,Chicago Bulls,100
Oct 20 2017,1,Brooklyn Nets,5,126,7:30p,247,Orlando Magic,121
Oct 20 2017,1,Charlotte Hornets,18,109,7:00p,200,Atlanta Hawks,91
Oct 20 2017,0,Dallas Mavericks,-5,88,8:30p,181,Sacramento Kings,93
Oct 20 2017,0,Indiana Pacers,-18,96,7:00p,210,Portland Trail Blazers,114
Oct 20 2017,0,Milwaukee Bucks,-19,97,7:00p,213,Cleveland Cavaliers,116
Oct 20 2017,1,Minnesota Timberwolves,3,100,8:00p,197,Utah Jazz,97
Oct 20 2017,0,New Orleans Pelicans,-8,120,9:30p,248,Golden State Warriors,128
Oct 20 2017,0,Philadelphia 76ers,-10,92,7:00p,194,Boston Celtics,102
Oct 20 2017,0,Phoenix Suns,-2,130,10:00p,262,Los Angeles Lakers,132
Oct 20 2017,1,Washington Wizards,4,115,7:00p,226,Detroit Pistons,111
Oct 21 2017,0,Chicago Bulls,-10,77,8:00p,164,San Antonio Spurs,87
Oct 21 2017,0,Cleveland Cavaliers,-21,93,8:00p,207,Orlando Magic,114
Oct 21 2017,1,Denver Nuggets,17,96,9:00p,175,Sacramento Kings,79
Oct 21 2017,1,Houston Rockets,16,107,8:00p,198,Dallas Mavericks,91
Oct 21 2017,1,Los Angeles Clippers,42,130,10:30p,218,Phoenix Suns,88
Oct 21 2017,1,Memphis Grizzlies,10,111,8:00p,212,Golden State Warriors,101
Oct 21 2017,1,Miami Heat,4,112,8:00p,220,Indiana Pacers,108
Oct 21 2017,1,Milwaukee Bucks,3,113,8:30p,223,Portland Trail Blazers,110
Oct 21 2017,0,New York Knicks,-4,107,8:00p,218,Detroit Pistons,111
Oct 21 2017,1,Toronto Raptors,34,128,7:30p,222,Philadelphia 76ers,94
Oct 21 2017,1,Utah Jazz,9,96,9:00p,183,Oklahoma City Thunder,87
Oct 22 2017,1,Brooklyn Nets,12,116,3:30p,220,Atlanta Hawks,104
Oct 22 2017,0,Los Angeles Lakers,-7,112,9:30p,231,New Orleans Pelicans,119
Oct 22 2017,0,Oklahoma City Thunder,-2,113,7:00p,228,Minnesota Timberwolves,115
Oct 23 2017,0,Dallas Mavericks,-30,103,8:30p,236,Golden State Warriors,133
Oct 23 2017,0,Denver Nuggets,-5,104,9:00p,213,Washington Wizards,109
Oct 23 2017,0,Detroit Pistons,-11,86,7:00p,183,Philadelphia 76ers,97
Oct 23 2017,0,Houston Rockets,-8,90,8:00p,188,Memphis Grizzlies,98
Oct 23 2017,1,Miami Heat,11,104,7:30p,197,Atlanta Hawks,93
Oct 23 2017,1,Milwaukee Bucks,9,103,8:00p,197,Charlotte Hornets,94
Oct 23 2017,1,Phoenix Suns,2,117,10:00p,232,Sacramento Kings,115
Oct 23 2017,1,San Antonio Spurs,4,101,8:30p,198,Toronto Raptors,97
Oct 24 2017,1,Boston Celtics,21,110,7:30p,199,New York Knicks,89
Oct 24 2017,1,Cleveland Cavaliers,7,119,7:00p,231,Chicago Bulls,112
Oct 24 2017,1,Los Angeles Clippers,18,102,10:30p,186,Utah Jazz,84
Oct 24 2017,0,Minnesota Timberwolves,-23,107,8:00p,237,Indiana Pacers,130
Oct 24 2017,1,Orlando Magic,4,125,7:00p,246,Brooklyn Nets,121
Oct 24 2017,1,Portland Trail Blazers,10,103,10:00p,196,New Orleans Pelicans,93
Oct 25 2017,1,Brooklyn Nets,5,112,7:30p,219,Cleveland Cavaliers,107
Oct 25 2017,1,Charlotte Hornets,17,110,7:00p,203,Denver Nuggets,93
Oct 25 2017,1,Dallas Mavericks,9,103,8:30p,197,Memphis Grizzlies,94
Oct 25 2017,1,Detroit Pistons,21,122,7:00p,223,Minnesota Timberwolves,101
Oct 25 2017,1,Golden State Warriors,5,117,10:30p,229,Toronto Raptors,112
Oct 25 2017,1,Los Angeles Lakers,3,102,10:30p,201,Washington Wizards,99
Oct 25 2017,0,Miami Heat,-17,100,8:00p,217,San Antonio Spurs,117
Oct 25 2017,1,Oklahoma City Thunder,18,114,8:00p,210,Indiana Pacers,96
Oct 25 2017,0,Philadelphia 76ers,-1,104,7:00p,209,Houston Rockets,105
Oct 25 2017,1,Phoenix Suns,9,97,10:00p,185,Utah Jazz,88
Oct 26 2017,1,Chicago Bulls,5,91,8:00p,177,Atlanta Hawks,86
Oct 26 2017,1,Memphis Grizzlies,5,96,8:00p,187,Dallas Mavericks,91
Oct 26 2017,0,Milwaukee Bucks,-7,89,8:00p,185,Boston Celtics,96
Oct 26 2017,0,Portland Trail Blazers,-1,103,10:00p,207,Los Angeles Clippers,104
Oct 26 2017,0,Sacramento Kings,-8,106,10:30p,220,New Orleans Pelicans,114
Oct 27 2017,0,Atlanta Hawks,-5,100,7:30p,205,Denver Nuggets,105
Oct 27 2017,0,Charlotte Hornets,-16,93,7:00p,202,Houston Rockets,109
Oct 27 2017,1,Golden State Warriors,3,120,10:30p,237,Washington Wizards,117
Oct 27 2017,0,Los Angeles Lakers,-9,92,10:30p,193,Toronto Raptors,101
Oct 27 2017,1,Minnesota Timberwolves,3,119,8:00p,235,Oklahoma City Thunder,116
Oct 27 2017,1,New York Knicks,21,107,7:30p,193,Brooklyn Nets,86
Oct 27 2017,1,Orlando Magic,27,114,7:00p,201,San Antonio Spurs,87
Oct 28 2017,0,Chicago Bulls,-32,69,8:00p,170,Oklahoma City Thunder,101
Oct 28 2017,0,Dallas Mavericks,-2,110,8:30p,222,Philadelphia 76ers,112
Oct 28 2017,0,Los Angeles Clippers,-8,87,10:30p,182,Detroit Pistons,95
Oct 28 2017,1,Memphis Grizzlies,14,103,8:00p,192,Houston Rockets,89
Oct 28 2017,0,Miami Heat,-6,90,8:00p,186,Boston Celtics,96
Oct 28 2017,1,New Orleans Pelicans,22,123,7:00p,224,Cleveland Cavaliers,101
Oct 28 2017,1,Portland Trail Blazers,7,114,10:00p,221,Phoenix Suns,107
Oct 28 2017,1,Utah Jazz,15,96,9:00p,177,Los Angeles Lakers,81
Oct 29 2017,0,Atlanta Hawks,-11,106,3:30p,223,Milwaukee Bucks,117
Oct 29 2017,0,Brooklyn Nets,-13,111,6:00p,235,Denver Nuggets,124
Oct 29 2017,1,Charlotte Hornets,7,120,6:00p,233,Orlando Magic,113
Oct 29 2017,0,Cleveland Cavaliers,-19,95,7:00p,209,New York Knicks,114
Oct 29 2017,0,Golden State Warriors,-8,107,8:30p,222,Detroit Pistons,115
Oct 29 2017,1,Indiana Pacers,3,97,4:30p,191,San Antonio Spurs,94
Oct 29 2017,0,Sacramento Kings,-27,83,6:00p,193,Washington Wizards,110
Oct 30 2017,1,Boston Celtics,14,108,7:30p,202,San Antonio Spurs,94
Oct 30 2017,0,Houston Rockets,-8,107,8:00p,222,Philadelphia 76ers,115
Oct 30 2017,0,Los Angeles Clippers,-28,113,10:30p,254,Golden State Warriors,141
Oct 30 2017,0,Memphis Grizzlies,-5,99,8:00p,203,Charlotte Hornets,104
Oct 30 2017,0,Miami Heat,-3,122,7:30p,247,Minnesota Timberwolves,125
Oct 30 2017,0,New Orleans Pelicans,-16,99,8:00p,214,Orlando Magic,115
Oct 30 2017,1,New York Knicks,6,116,7:30p,226,Denver Nuggets,110
Oct 30 2017,0,Portland Trail Blazers,-14,85,10:00p,184,Toronto Raptors,99
Oct 30 2017,1,Utah Jazz,15,104,9:00p,193,Dallas Mavericks,89
Oct 31 2017,0,Brooklyn Nets,-8,114,7:30p,236,Phoenix Suns,122
Oct 31 2017,1,Indiana Pacers,18,101,7:00p,184,Sacramento Kings,83
Oct 31 2017,1,Los Angeles Lakers,20,113,10:30p,206,Detroit Pistons,93
Oct 31 2017,0,Milwaukee Bucks,-19,91,8:00p,201,Oklahoma City Thunder,110
Nov 1 2017,1,Boston Celtics,27,113,7:30p,199,Sacramento Kings,86
Nov 1 2017,1,Charlotte Hornets,5,126,7:00p,247,Milwaukee Bucks,121
Nov 1 2017,0,Cleveland Cavaliers,-17,107,7:00p,231,Indiana Pacers,124
Nov 1 2017,1,Denver Nuggets,18,129,9:00p,240,Toronto Raptors,111
Nov 1 2017,1,Los Angeles Clippers,21,119,10:30p,217,Dallas Mavericks,98
Nov 1 2017,0,Memphis Grizzlies,-2,99,8:00p,200,Orlando Magic,101
Nov 1 2017,1,Miami Heat,6,97,7:30p,188,Chicago Bulls,91
Nov 1 2017,0,New Orleans Pelicans,-6,98,8:00p,202,Minnesota Timberwolves,104
Nov 1 2017,0,New York Knicks,-22,97,8:00p,216,Houston Rockets,119
Nov 1 2017,1,Philadelphia 76ers,10,119,7:00p,228,Atlanta Hawks,109
Nov 1 2017,1,Utah Jazz,9,112,9:00p,215,Portland Trail Blazers,103
Nov 1 2017,0,Washington Wizards,-6,116,7:00p,238,Phoenix Suns,122
Nov 2 2017,1,Portland Trail Blazers,3,113,10:30p,223,Los Angeles Lakers,110
Nov 2 2017,0,San Antonio Spurs,-20,92,8:00p,204,Golden State Warriors,112
Nov 3 2017,0,Atlanta Hawks,-15,104,7:30p,223,Houston Rockets,119
Nov 3 2017,0,Dallas Mavericks,-5,94,8:30p,193,New Orleans Pelicans,99
Nov 3 2017,1,Denver Nuggets,1,95,9:00p,189,Miami Heat,94
Nov 3 2017,1,Detroit Pistons,9,105,7:00p,201,Milwaukee Bucks,96
Nov 3 2017,1,Los Angeles Lakers,12,124,10:30p,236,Brooklyn Nets,112
Nov 3 2017,1,New York Knicks,13,120,7:30p,227,Phoenix Suns,107
Nov 3 2017,0,Oklahoma City Thunder,-7,94,9:30p,195,Boston Celtics,101
Nov 3 2017,0,Orlando Magic,-22,83,7:00p,188,Chicago Bulls,105
Nov 3 2017,1,Philadelphia 76ers,11,121,7:00p,231,Indiana Pacers,110
Nov 3 2017,1,San Antonio Spurs,7,108,8:30p,209,Charlotte Hornets,101
Nov 3 2017,0,Utah Jazz,-9,100,9:00p,209,Toronto Raptors,109
Nov 3 2017,0,Washington Wizards,-8,122,7:00p,252,Cleveland Cavaliers,130
Nov 4 2017,0,Chicago Bulls,-6,90,8:00p,186,New Orleans Pelicans,96
Nov 4 2017,0,Denver Nuggets,-19,108,9:00p,235,Golden State Warriors,127
Nov 4 2017,1,Detroit Pistons,9,108,7:00p,207,Sacramento Kings,99
Nov 4 2017,0,Los Angeles Clippers,-9,104,3:30p,217,Memphis Grizzlies,113
Nov 4 2017,1,Minnesota Timberwolves,13,112,8:00p,211,Dallas Mavericks,99
Nov 5 2017,0,Cleveland Cavaliers,-2,115,3:00p,232,Atlanta Hawks,117
Nov 5 2017,1,Houston Rockets,27,137,7:00p,247,Utah Jazz,110
Nov 5 2017,0,Los Angeles Clippers,-3,101,3:30p,205,Miami Heat,104
Nov 5 2017,1,Los Angeles Lakers,5,107,9:30p,209,Memphis Grizzlies,102
Nov 5 2017,1,Minnesota Timberwolves,18,112,8:00p,206,Charlotte Hornets,94
Nov 5 2017,1,New York Knicks,7,108,7:30p,209,Indiana Pacers,101
Nov 5 2017,0,Orlando Magic,-16,88,6:00p,192,Boston Celtics,104
Nov 5 2017,1,Portland Trail Blazers,4,103,9:00p,202,Oklahoma City Thunder,99
Nov 5 2017,1,San Antonio Spurs,17,112,7:00p,207,Phoenix Suns,95
Nov 5 2017,0,Toronto Raptors,-11,96,6:00p,203,Washington Wizards,107
Nov 6 2017,0,Atlanta Hawks,-3,107,7:30p,217,Boston Celtics,110
Nov 6 2017,1,Golden State Warriors,17,97,10:30p,177,Miami Heat,80
Nov 6 2017,0,Phoenix Suns,-6,92,9:00p,190,Brooklyn Nets,98
Nov 7 2017,1,Cleveland Cavaliers,5,124,7:00p,243,Milwaukee Bucks,119
Nov 7 2017,1,Denver Nuggets,8,112,9:00p,216,Brooklyn Nets,104
Nov 7 2017,0,Indiana Pacers,-5,112,7:00p,229,New Orleans Pelicans,117
Nov 7 2017,1,New York Knicks,5,118,7:30p,231,Charlotte Hornets,113
Nov 7 2017,0,Portland Trail Blazers,-1,97,10:00p,195,Memphis Grizzlies,98
Nov 7 2017,1,Sacramento Kings,8,94,10:00p,180,Oklahoma City Thunder,86
Nov 7 2017,1,San Antonio Spurs,13,120,8:30p,227,Los Angeles Clippers,107
Nov 7 2017,1,Toronto Raptors,5,119,7:30p,233,Chicago Bulls,114
Nov 7 2017,0,Utah Jazz,-7,97,9:00p,201,Philadelphia 76ers,104
Nov 7 2017,0,Washington Wizards,-14,99,7:00p,212,Dallas Mavericks,113
Nov 8 2017,1,Boston Celtics,11,107,8:00p,203,Los Angeles Lakers,96
Nov 8 2017,1,Detroit Pistons,17,114,7:00p,211,Indiana Pacers,97
Nov 8 2017,1,Golden State Warriors,24,125,10:30p,226,Minnesota Timberwolves,101
Nov 8 2017,1,Orlando Magic,13,112,7:00p,211,New York Knicks,99
Nov 8 2017,0,Phoenix Suns,-11,115,9:00p,241,Miami Heat,126
Nov 9 2017,1,Denver Nuggets,8,102,10:30p,196,Oklahoma City Thunder,94
Nov 9 2017,1,Houston Rockets,4,117,8:00p,230,Cleveland Cavaliers,113
Nov 9 2017,1,Sacramento Kings,1,109,10:00p,217,Philadelphia 76ers,108
Nov 9 2017,1,Toronto Raptors,4,122,7:30p,240,New Orleans Pelicans,118
Nov 9 2017,1,Washington Wizards,16,111,7:00p,206,Los Angeles Lakers,95
Nov 10 2017,1,Boston Celtics,3,90,7:30p,177,Charlotte Hornets,87
Nov 10 2017,0,Chicago Bulls,-18,87,8:00p,192,Indiana Pacers,105
Nov 10 2017,1,Detroit Pistons,7,111,7:00p,215,Atlanta Hawks,104
Nov 10 2017,1,Oklahoma City Thunder,9,120,9:00p,231,Los Angeles Clippers,111
Nov 10 2017,0,Phoenix Suns,-16,112,9:00p,240,Orlando Magic,128
Nov 10 2017,0,Portland Trail Blazers,-4,97,10:00p,198,Brooklyn Nets,101
Nov 10 2017,0,San Antonio Spurs,-7,87,9:00p,181,Milwaukee Bucks,94
Nov 10 2017,0,Utah Jazz,-10,74,9:00p,158,Miami Heat,84
Nov 11 2017,0,Dallas Mavericks,-7,104,8:30p,215,Cleveland Cavaliers,111
Nov 11 2017,1,Denver Nuggets,18,125,9:00p,232,Orlando Magic,107
Nov 11 2017,1,Golden State Warriors,21,135,8:30p,249,Philadelphia 76ers,114
Nov 11 2017,1,Houston Rockets,15,111,8:00p,207,Memphis Grizzlies,96
Nov 11 2017,1,Milwaukee Bucks,8,98,8:30p,188,Los Angeles Lakers,90
Nov 11 2017,1,New Orleans Pelicans,8,111,7:00p,214,Los Angeles Clippers,103
Nov 11 2017,1,New York Knicks,27,118,8:00p,209,Sacramento Kings,91
Nov 11 2017,1,Phoenix Suns,8,118,9:00p,228,Minnesota Timberwolves,110
Nov 11 2017,1,San Antonio Spurs,39,133,8:30p,227,Chicago Bulls,94
Nov 11 2017,1,Utah Jazz,8,114,9:00p,220,Brooklyn Nets,106
Nov 11 2017,1,Washington Wizards,19,113,7:00p,207,Atlanta Hawks,94
Nov 12 2017,1,Boston Celtics,1,95,3:30p,189,Toronto Raptors,94
Nov 12 2017,1,Detroit Pistons,9,112,4:00p,215,Miami Heat,103
Nov 12 2017,0,Indiana Pacers,-23,95,6:00p,213,Houston Rockets,118
Nov 12 2017,1,Oklahoma City Thunder,13,112,7:00p,211,Dallas Mavericks,99
Nov 13 2017,1,Golden State Warriors,10,110,10:30p,210,Orlando Magic,100
Nov 13 2017,0,Los Angeles Clippers,-4,105,10:30p,214,Philadelphia 76ers,109
Nov 13 2017,1,Milwaukee Bucks,7,110,8:00p,213,Memphis Grizzlies,103
Nov 13 2017,1,New Orleans Pelicans,1,106,8:00p,211,Atlanta Hawks,105
Nov 13 2017,0,New York Knicks,-3,101,7:30p,205,Cleveland Cavaliers,104
Nov 13 2017,0,Phoenix Suns,-7,93,9:00p,193,Los Angeles Lakers,100
Nov 13 2017,1,Portland Trail Blazers,17,99,10:00p,181,Denver Nuggets,82
Nov 13 2017,0,Utah Jazz,-11,98,9:00p,207,Minnesota Timberwolves,109
Nov 13 2017,1,Washington Wizards,18,110,7:00p,202,Sacramento Kings,92
Nov 14 2017,0,Brooklyn Nets,-7,102,7:30p,211,Boston Celtics,109
Nov 14 2017,0,Dallas Mavericks,-6,91,8:30p,188,San Antonio Spurs,97
Nov 14 2017,0,Houston Rockets,-16,113,8:00p,242,Toronto Raptors,129
Nov 15 2017,1,Atlanta Hawks,46,126,7:30p,206,Sacramento Kings,80
Nov 15 2017,0,Charlotte Hornets,-8,107,8:00p,222,Cleveland Cavaliers,115
Nov 15 2017,0,Los Angeles Lakers,-6,109,10:30p,224,Philadelphia 76ers,115
Nov 15 2017,0,Memphis Grizzlies,-3,113,8:00p,229,Indiana Pacers,116
Nov 15 2017,0,Miami Heat,-9,93,7:30p,195,Washington Wizards,102
Nov 15 2017,1,Milwaukee Bucks,4,99,8:00p,194,Detroit Pistons,95
Nov 15 2017,1,Minnesota Timberwolves,12,98,8:00p,184,San Antonio Spurs,86
Nov 15 2017,0,New Orleans Pelicans,-9,116,8:00p,241,Toronto Raptors,125
Nov 15 2017,1,New York Knicks,5,106,7:30p,207,Utah Jazz,101
Nov 15 2017,1,Oklahoma City Thunder,13,92,8:00p,171,Chicago Bulls,79
Nov 15 2017,1,Portland Trail Blazers,5,99,10:00p,193,Orlando Magic,94
Nov 16 2017,1,Boston Celtics,4,92,8:00p,180,Golden State Warriors,88
Nov 16 2017,0,Phoenix Suns,-26,116,10:30p,258,Houston Rockets,142
Nov 17 2017,1,Brooklyn Nets,11,118,7:30p,225,Utah Jazz,107
Nov 17 2017,1,Chicago Bulls,3,123,8:00p,243,Charlotte Hornets,120
Nov 17 2017,1,Cleveland Cavaliers,5,118,7:30p,231,Los Angeles Clippers,113
Nov 17 2017,0,Dallas Mavericks,-24,87,8:30p,198,Minnesota Timberwolves,111
Nov 17 2017,1,Denver Nuggets,32,146,10:30p,260,New Orleans Pelicans,114
Nov 17 2017,1,Indiana Pacers,7,107,7:00p,207,Detroit Pistons,100
Nov 17 2017,0,Los Angeles Lakers,-9,113,10:30p,235,Phoenix Suns,122
Nov 17 2017,1,Sacramento Kings,4,86,10:00p,168,Portland Trail Blazers,82
Nov 17 2017,1,San Antonio Spurs,3,104,8:00p,205,Oklahoma City Thunder,101
Nov 17 2017,1,Toronto Raptors,23,107,7:30p,191,New York Knicks,84
Nov 17 2017,0,Washington Wizards,-3,88,7:00p,179,Miami Heat,91
Nov 18 2017,0,Atlanta Hawks,-11,99,7:30p,209,Boston Celtics,110
Nov 18 2017,1,Charlotte Hornets,15,102,7:00p,189,Los Angeles Clippers,87
Nov 18 2017,1,Dallas Mavericks,32,111,9:00p,190,Milwaukee Bucks,79
Nov 18 2017,0,Memphis Grizzlies,-22,83,8:00p,188,Houston Rockets,105
Nov 18 2017,0,Orlando Magic,-40,85,7:00p,210,Utah Jazz,125
Nov 18 2017,0,Philadelphia 76ers,-8,116,7:30p,240,Golden State Warriors,124
Nov 18 2017,1,Portland Trail Blazers,12,102,10:00p,192,Sacramento Kings,90
Nov 19 2017,0,Brooklyn Nets,-7,111,6:00p,229,Golden State Warriors,118
Nov 19 2017,1,Los Angeles Lakers,18,127,9:30p,236,Denver Nuggets,109
Nov 19 2017,0,Miami Heat,-25,95,5:00p,215,Indiana Pacers,120
Nov 19 2017,0,Minnesota Timberwolves,-3,97,7:00p,197,Detroit Pistons,100
Nov 19 2017,1,Phoenix Suns,8,113,8:00p,218,Chicago Bulls,105
Nov 19 2017,1,Toronto Raptors,9,100,3:30p,191,Washington Wizards,91
Nov 20 2017,1,Charlotte Hornets,16,118,7:00p,220,Minnesota Timberwolves,102
Nov 20 2017,0,Dallas Mavericks,-8,102,8:30p,212,Boston Celtics,110
Nov 20 2017,0,Detroit Pistons,-28,88,7:00p,204,Cleveland Cavaliers,116
Nov 20 2017,0,Memphis Grizzlies,-8,92,8:00p,192,Portland Trail Blazers,100
Nov 20 2017,0,Milwaukee Bucks,-11,88,8:00p,187,Washington Wizards,99
Nov 20 2017,1,New Orleans Pelicans,7,114,8:00p,221,Oklahoma City Thunder,107
Nov 20 2017,1,New York Knicks,22,107,7:30p,192,Los Angeles Clippers,85
Nov 20 2017,0,Orlando Magic,-8,97,7:00p,202,Indiana Pacers,105
Nov 20 2017,1,Philadelphia 76ers,21,107,7:00p,193,Utah Jazz,86
Nov 20 2017,0,Sacramento Kings,-16,98,10:00p,212,Denver Nuggets,114
Nov 20 2017,1,San Antonio Spurs,11,96,8:30p,181,Atlanta Hawks,85
Nov 21 2017,1,Los Angeles Lakers,9,103,10:30p,197,Chicago Bulls,94
Nov 22 2017,0,Atlanta Hawks,-13,103,7:30p,219,Los Angeles Clippers,116
Nov 22 2017,1,Charlotte Hornets,5,129,7:00p,253,Washington Wizards,124
Nov 22 2017,1,Cleveland Cavaliers,10,119,7:00p,228,Brooklyn Nets,109
Nov 22 2017,1,Houston Rockets,30,125,8:00p,220,Denver Nuggets,95
Nov 22 2017,0,Memphis Grizzlies,-1,94,8:00p,189,Dallas Mavericks,95
Nov 22 2017,1,Miami Heat,6,104,7:30p,202,Boston Celtics,98
Nov 22 2017,1,Minnesota Timberwolves,6,124,8:00p,242,Orlando Magic,118
Nov 22 2017,1,New Orleans Pelicans,17,107,8:00p,197,San Antonio Spurs,90
Nov 22 2017,1,New York Knicks,8,108,7:30p,208,Toronto Raptors,100
Nov 22 2017,1,Oklahoma City Thunder,17,108,8:00p,199,Golden State Warriors,91
Nov 22 2017,1,Philadelphia 76ers,20,101,7:00p,182,Portland Trail Blazers,81
Nov 22 2017,0,Phoenix Suns,-6,107,9:00p,220,Milwaukee Bucks,113
Nov 22 2017,1,Sacramento Kings,11,113,10:30p,215,Los Angeles Lakers,102
Nov 22 2017,1,Utah Jazz,30,110,9:00p,190,Chicago Bulls,80
Nov 24 2017,1,Atlanta Hawks,12,116,7:30p,220,New York Knicks,104
Nov 24 2017,1,Boston Celtics,15,118,7:30p,221,Orlando Magic,103
Nov 24 2017,0,Brooklyn Nets,-2,125,12:00p,252,Portland Trail Blazers,127
Nov 24 2017,1,Cleveland Cavaliers,1,100,8:00p,199,Charlotte Hornets,99
Nov 24 2017,1,Denver Nuggets,12,104,9:00p,196,Memphis Grizzlies,92
Nov 24 2017,1,Golden State Warriors,49,143,10:30p,237,Chicago Bulls,94
Nov 24 2017,1,Indiana Pacers,3,107,8:00p,211,Toronto Raptors,104
Nov 24 2017,0,Minnesota Timberwolves,-12,97,8:00p,206,Miami Heat,109
Nov 24 2017,0,Oklahoma City Thunder,-1,98,8:00p,197,Detroit Pistons,99
Nov 24 2017,0,Phoenix Suns,-24,91,9:00p,206,New Orleans Pelicans,115
Nov 25 2017,0,Atlanta Hawks,-34,78,7:30p,190,Toronto Raptors,112
Nov 25 2017,0,Charlotte Hornets,-20,86,7:00p,192,San Antonio Spurs,106
Nov 25 2017,1,Dallas Mavericks,16,97,8:30p,178,Oklahoma City Thunder,81
Nov 25 2017,1,Golden State Warriors,15,110,8:30p,205,New Orleans Pelicans,95
Nov 25 2017,1,Houston Rockets,15,117,8:00p,219,New York Knicks,102
Nov 25 2017,0,Indiana Pacers,-10,98,8:00p,206,Boston Celtics,108
Nov 25 2017,1,Philadelphia 76ers,19,130,7:00p,241,Orlando Magic,111
Nov 25 2017,0,Sacramento Kings,-2,95,10:00p,192,Los Angeles Clippers,97
Nov 25 2017,1,Utah Jazz,13,121,9:00p,229,Milwaukee Bucks,108
Nov 25 2017,0,Washington Wizards,-3,105,7:00p,213,Portland Trail Blazers,108
Nov 26 2017,0,Chicago Bulls,-7,93,3:30p,193,Miami Heat,100
Nov 26 2017,0,Memphis Grizzlies,-10,88,6:00p,186,Brooklyn Nets,98
Nov 26 2017,1,Minnesota Timberwolves,11,119,3:30p,227,Phoenix Suns,108
Nov 27 2017,0,Boston Celtics,-10,108,7:30p,226,Detroit Pistons,118
Nov 27 2017,0,Golden State Warriors,-4,106,10:30p,216,Sacramento Kings,110
Nov 27 2017,1,Houston Rockets,14,117,8:00p,220,Brooklyn Nets,103
Nov 27 2017,1,Indiana Pacers,12,121,7:00p,230,Orlando Magic,109
Nov 27 2017,1,Los Angeles Clippers,5,120,10:30p,235,Los Angeles Lakers,115
Nov 27 2017,0,New York Knicks,-12,91,7:30p,194,Portland Trail Blazers,103
Nov 27 2017,0,Philadelphia 76ers,-22,91,7:00p,204,Cleveland Cavaliers,113
Nov 27 2017,1,San Antonio Spurs,7,115,8:30p,223,Dallas Mavericks,108
Nov 28 2017,0,Chicago Bulls,-5,99,8:00p,203,Phoenix Suns,104
Nov 28 2017,1,Cleveland Cavaliers,11,108,7:00p,205,Miami Heat,97
Nov 28 2017,0,Minnesota Timberwolves,-3,89,8:00p,181,Washington Wizards,92
Nov 28 2017,0,Sacramento Kings,-25,87,10:00p,199,Milwaukee Bucks,112
Nov 28 2017,1,Utah Jazz,29,106,10:00p,183,Denver Nuggets,77
Nov 29 2017,0,Dallas Mavericks,-5,104,8:30p,213,Brooklyn Nets,109
Nov 29 2017,1,Detroit Pistons,24,131,7:00p,238,Phoenix Suns,107
Nov 29 2017,1,Houston Rockets,21,118,8:00p,215,Indiana Pacers,97
Nov 29 2017,0,Los Angeles Lakers,-4,123,10:30p,250,Golden State Warriors,127
Nov 29 2017,0,New Orleans Pelicans,-18,102,8:00p,222,Minnesota Timberwolves,120
Nov 29 2017,1,New York Knicks,29,115,7:30p,201,Miami Heat,86
Nov 29 2017,1,Orlando Magic,13,121,7:00p,229,Oklahoma City Thunder,108
Nov 29 2017,1,Philadelphia 76ers,5,118,7:00p,231,Washington Wizards,113
Nov 29 2017,1,San Antonio Spurs,9,104,8:30p,199,Memphis Grizzlies,95
Nov 29 2017,1,Toronto Raptors,13,126,7:30p,239,Charlotte Hornets,113
Nov 30 2017,0,Atlanta Hawks,-7,114,7:30p,235,Cleveland Cavaliers,121
Nov 30 2017,1,Boston Celtics,11,108,7:30p,205,Philadelphia 76ers,97
Nov 30 2017,1,Denver Nuggets,1,111,9:00p,221,Chicago Bulls,110
Nov 30 2017,0,Los Angeles Clippers,-19,107,10:30p,233,Utah Jazz,126
Nov 30 2017,0,Portland Trail Blazers,-12,91,10:00p,194,Milwaukee Bucks,103
Dec 1 2017,0,Chicago Bulls,-1,106,8:00p,213,Sacramento Kings,107
Dec 1 2017,0,Memphis Grizzlies,-16,79,8:00p,174,San Antonio Spurs,95
Dec 1 2017,1,Miami Heat,5,105,8:00p,205,Charlotte Hornets,100
Dec 1 2017,1,Oklahoma City Thunder,4,111,8:00p,218,Minnesota Timberwolves,107
Dec 1 2017,0,Orlando Magic,-21,112,7:00p,245,Golden State Warriors,133
Dec 1 2017,1,Toronto Raptors,5,120,7:30p,235,Indiana Pacers,115
Dec 1 2017,1,Utah Jazz,6,114,9:00p,222,New Orleans Pelicans,108
Dec 1 2017,1,Washington Wizards,18,109,7:00p,200,Detroit Pistons,91
Dec 2 2017,1,Boston Celtics,5,116,1:00p,227,Phoenix Suns,111
Dec 2 2017,0,Brooklyn Nets,-12,102,3:00p,216,Atlanta Hawks,114
Dec 2 2017,1,Cleveland Cavaliers,5,116,7:30p,227,Memphis Grizzlies,111
Dec 2 2017,1,Dallas Mavericks,26,108,2:00p,190,Los Angeles Clippers,82
Dec 2 2017,1,Denver Nuggets,15,115,9:00p,215,Los Angeles Lakers,100
Dec 2 2017,1,Milwaukee Bucks,5,109,8:30p,213,Sacramento Kings,104
Dec 2 2017,1,Philadelphia 76ers,5,108,7:30p,211,Detroit Pistons,103
Dec 2 2017,0,Portland Trail Blazers,-7,116,10:00p,239,New Orleans Pelicans,123
Dec 3 2017,0,Los Angeles Lakers,-23,95,9:30p,213,Houston Rockets,118
Dec 3 2017,0,Miami Heat,-28,95,7:00p,218,Golden State Warriors,123
Dec 3 2017,1,Minnesota Timberwolves,6,112,7:00p,218,Los Angeles Clippers,106
Dec 3 2017,0,New York Knicks,-5,100,3:30p,205,Orlando Magic,105
Dec 3 2017,1,Oklahoma City Thunder,3,90,7:00p,177,San Antonio Spurs,87
Dec 4 2017,0,Atlanta Hawks,-20,90,7:30p,200,Brooklyn Nets,110
Dec 4 2017,1,Boston Celtics,11,111,7:30p,211,Milwaukee Bucks,100
Dec 4 2017,0,Chicago Bulls,-22,91,8:00p,204,Cleveland Cavaliers,113
Dec 4 2017,1,Charlotte Hornets,10,104,7:00p,198,Orlando Magic,94
Dec 4 2017,1,Dallas Mavericks,17,122,8:30p,227,Denver Nuggets,105
Dec 4 2017,1,Indiana Pacers,18,115,7:00p,212,New York Knicks,97
Dec 4 2017,1,Memphis Grizzlies,3,95,8:00p,187,Minnesota Timberwolves,92
Dec 4 2017,0,New Orleans Pelicans,-10,115,8:00p,240,Golden State Warriors,125
Dec 4 2017,0,Philadelphia 76ers,-14,101,7:00p,216,Phoenix Suns,115
Dec 4 2017,1,San Antonio Spurs,3,96,8:30p,189,Detroit Pistons,93
Dec 4 2017,1,Utah Jazz,47,116,9:00p,185,Washington Wizards,69
Dec 5 2017,1,Oklahoma City Thunder,6,100,8:00p,194,Utah Jazz,94
Dec 5 2017,0,Portland Trail Blazers,-14,92,10:00p,198,Washington Wizards,106
Dec 5 2017,1,Toronto Raptors,13,126,7:30p,239,Phoenix Suns,113
Dec 6 2017,1,Boston Celtics,7,97,7:30p,187,Dallas Mavericks,90
Dec 6 2017,0,Charlotte Hornets,-14,87,8:00p,188,Golden State Warriors,101
Dec 6 2017,1,Cleveland Cavaliers,6,101,7:00p,196,Sacramento Kings,95
Dec 6 2017,1,Indiana Pacers,2,98,7:00p,194,Chicago Bulls,96
Dec 6 2017,0,Los Angeles Clippers,-6,107,10:30p,220,Minnesota Timberwolves,113
Dec 6 2017,1,Milwaukee Bucks,4,104,8:00p,204,Detroit Pistons,100
Dec 6 2017,1,New Orleans Pelicans,9,123,8:00p,237,Denver Nuggets,114
Dec 6 2017,1,New York Knicks,11,99,7:30p,187,Memphis Grizzlies,88
Dec 6 2017,1,Orlando Magic,4,110,7:00p,216,Atlanta Hawks,106
Dec 6 2017,1,San Antonio Spurs,12,117,8:30p,222,Miami Heat,105
Dec 7 2017,1,Brooklyn Nets,5,100,10:00p,195,Oklahoma City Thunder,95
Dec 7 2017,0,Philadelphia 76ers,-3,104,8:00p,211,Los Angeles Lakers,107
Dec 7 2017,0,Phoenix Suns,-10,99,9:00p,208,Washington Wizards,109
Dec 7 2017,0,Utah Jazz,-11,101,10:30p,213,Houston Rockets,112
Dec 8 2017,0,Charlotte Hornets,-8,111,7:00p,230,Chicago Bulls,119
Dec 8 2017,0,Detroit Pistons,-4,98,7:00p,200,Golden State Warriors,102
Dec 8 2017,1,Indiana Pacers,4,106,7:00p,208,Cleveland Cavaliers,102
Dec 8 2017,0,Memphis Grizzlies,-9,107,8:00p,223,Toronto Raptors,116
Dec 8 2017,1,Milwaukee Bucks,7,109,8:00p,211,Dallas Mavericks,102
Dec 8 2017,0,New Orleans Pelicans,-7,109,8:00p,225,Sacramento Kings,116
Dec 8 2017,0,Orlando Magic,-14,89,7:00p,192,Denver Nuggets,103
Dec 8 2017,1,San Antonio Spurs,3,105,9:30p,207,Boston Celtics,102
Dec 9 2017,1,Atlanta Hawks,7,117,7:30p,227,Orlando Magic,110
Dec 9 2017,0,Brooklyn Nets,-12,89,6:00p,190,Miami Heat,101
Dec 9 2017,1,Chicago Bulls,2,104,8:00p,206,New York Knicks,102
Dec 9 2017,0,Charlotte Hornets,-11,99,7:00p,209,Los Angeles Lakers,110
Dec 9 2017,1,Cleveland Cavaliers,7,105,8:00p,203,Philadelphia 76ers,98
Dec 9 2017,1,Los Angeles Clippers,1,113,3:30p,225,Washington Wizards,112
Dec 9 2017,0,Memphis Grizzlies,-1,101,9:00p,203,Oklahoma City Thunder,102
Dec 9 2017,1,Milwaukee Bucks,17,117,8:30p,217,Utah Jazz,100
Dec 9 2017,0,Phoenix Suns,-3,101,9:00p,205,San Antonio Spurs,104
Dec 9 2017,0,Portland Trail Blazers,-7,117,10:00p,241,Houston Rockets,124
Dec 10 2017,0,Detroit Pistons,-10,81,4:00p,172,Boston Celtics,91
Dec 10 2017,1,Indiana Pacers,10,126,5:00p,242,Denver Nuggets,116
Dec 10 2017,1,Minnesota Timberwolves,5,97,7:00p,189,Dallas Mavericks,92
Dec 10 2017,1,New Orleans Pelicans,7,131,7:00p,255,Philadelphia 76ers,124
Dec 10 2017,1,New York Knicks,4,111,7:30p,218,Atlanta Hawks,107
Dec 10 2017,0,Sacramento Kings,-15,87,3:30p,189,Toronto Raptors,102
Dec 11 2017,1,Chicago Bulls,23,108,8:00p,193,Boston Celtics,85
Dec 11 2017,1,Golden State Warriors,7,111,10:30p,215,Portland Trail Blazers,104
Dec 11 2017,1,Houston Rockets,7,130,8:00p,253,New Orleans Pelicans,123
Dec 11 2017,1,Los Angeles Clippers,5,96,10:30p,187,Toronto Raptors,91
Dec 11 2017,0,Memphis Grizzlies,-25,82,8:00p,189,Miami Heat,107
Dec 11 2017,0,Oklahoma City Thunder,-13,103,8:00p,219,Charlotte Hornets,116
Dec 12 2017,1,Brooklyn Nets,5,103,7:30p,201,Washington Wizards,98
Dec 12 2017,1,Cleveland Cavaliers,9,123,7:00p,237,Atlanta Hawks,114
Dec 12 2017,1,Dallas Mavericks,6,95,8:30p,184,San Antonio Spurs,89
Dec 12 2017,0,Detroit Pistons,-19,84,7:00p,187,Denver Nuggets,103
Dec 12 2017,0,Minnesota Timberwolves,-6,112,9:30p,230,Philadelphia 76ers,118
Dec 12 2017,1,New York Knicks,4,113,7:00p,222,Los Angeles Lakers,109
Dec 12 2017,1,Sacramento Kings,7,99,10:00p,191,Phoenix Suns,92
Dec 13 2017,1,Boston Celtics,6,124,7:30p,242,Denver Nuggets,118
Dec 13 2017,1,Chicago Bulls,3,103,8:00p,203,Utah Jazz,100
Dec 13 2017,1,Houston Rockets,12,108,9:30p,204,Charlotte Hornets,96
Dec 13 2017,0,Indiana Pacers,-5,95,7:00p,195,Oklahoma City Thunder,100
Dec 13 2017,0,Miami Heat,-7,95,7:30p,197,Portland Trail Blazers,102
Dec 13 2017,1,New Orleans Pelicans,7,115,8:00p,223,Milwaukee Bucks,108
Dec 13 2017,0,Orlando Magic,-11,95,7:00p,201,Los Angeles Clippers,106
Dec 13 2017,0,Phoenix Suns,-6,109,9:00p,224,Toronto Raptors,115
Dec 13 2017,1,Washington Wizards,6,93,7:00p,180,Memphis Grizzlies,87
Dec 14 2017,0,Atlanta Hawks,-14,91,7:30p,196,Detroit Pistons,105
Dec 14 2017,0,Brooklyn Nets,-7,104,7:30p,215,New York Knicks,111
Dec 14 2017,1,Cleveland Cavaliers,9,121,8:00p,233,Los Angeles Lakers,112
Dec 14 2017,1,Golden State Warriors,15,112,10:30p,209,Dallas Mavericks,97
Dec 14 2017,1,Minnesota Timberwolves,23,119,8:00p,215,Sacramento Kings,96
Dec 15 2017,0,Boston Celtics,-12,95,7:30p,202,Utah Jazz,107
Dec 15 2017,0,Charlotte Hornets,-6,98,7:00p,202,Miami Heat,104
Dec 15 2017,1,Denver Nuggets,6,117,9:00p,228,New Orleans Pelicans,111
Dec 15 2017,1,Houston Rockets,15,124,9:30p,233,San Antonio Spurs,109
Dec 15 2017,0,Indiana Pacers,-6,98,7:00p,202,Detroit Pistons,104
Dec 15 2017,1,Memphis Grizzlies,2,96,8:00p,190,Atlanta Hawks,94
Dec 15 2017,0,Milwaukee Bucks,-6,109,8:00p,224,Chicago Bulls,115
Dec 15 2017,0,Orlando Magic,-7,88,7:00p,183,Portland Trail Blazers,95
Dec 15 2017,0,Philadelphia 76ers,-2,117,7:00p,236,Oklahoma City Thunder,119
Dec 15 2017,1,Toronto Raptors,33,120,7:30p,207,Brooklyn Nets,87
Dec 15 2017,1,Washington Wizards,9,100,7:00p,191,Los Angeles Clippers,91
Dec 16 2017,0,Charlotte Hornets,-2,91,7:00p,184,Portland Trail Blazers,93
Dec 16 2017,1,Cleveland Cavaliers,9,109,7:30p,209,Utah Jazz,100
Dec 16 2017,1,Houston Rockets,4,115,8:00p,226,Milwaukee Bucks,111
Dec 16 2017,0,Memphis Grizzlies,-9,93,9:00p,195,Boston Celtics,102
Dec 16 2017,1,Miami Heat,5,90,8:00p,175,Los Angeles Clippers,85
Dec 16 2017,0,Minnesota Timberwolves,-2,106,8:00p,214,Phoenix Suns,108
Dec 16 2017,1,New York Knicks,15,111,7:30p,207,Oklahoma City Thunder,96
Dec 16 2017,1,San Antonio Spurs,2,98,8:30p,194,Dallas Mavericks,96
Dec 17 2017,0,Brooklyn Nets,-12,97,6:00p,206,Indiana Pacers,109
Dec 17 2017,1,Detroit Pistons,4,114,4:00p,224,Orlando Magic,110
Dec 17 2017,1,Toronto Raptors,15,108,3:30p,201,Sacramento Kings,93
Dec 17 2017,0,Washington Wizards,-7,99,6:00p,205,Cleveland Cavaliers,106
Dec 18 2017,1,Atlanta Hawks,6,110,7:30p,214,Miami Heat,104
Dec 18 2017,1,Chicago Bulls,2,117,8:00p,232,Philadelphia 76ers,115
Dec 18 2017,1,Charlotte Hornets,18,109,7:00p,200,New York Knicks,91
Dec 18 2017,0,Dallas Mavericks,-6,91,8:30p,188,Phoenix Suns,97
Dec 18 2017,1,Houston Rockets,21,120,8:00p,219,Utah Jazz,99
Dec 18 2017,0,Indiana Pacers,-1,111,7:00p,223,Boston Celtics,112
Dec 18 2017,0,Los Angeles Lakers,-2,114,10:30p,230,Golden State Warriors,116
Dec 18 2017,1,Minnesota Timberwolves,1,108,8:00p,215,Portland Trail Blazers,107
Dec 18 2017,1,Oklahoma City Thunder,1,95,8:00p,189,Denver Nuggets,94
Dec 18 2017,1,San Antonio Spurs,18,109,8:30p,200,Los Angeles Clippers,91
Dec 19 2017,1,Milwaukee Bucks,3,119,8:00p,235,Cleveland Cavaliers,116
Dec 19 2017,0,Philadelphia 76ers,-6,95,7:00p,196,Sacramento Kings,101
Dec 19 2017,1,Washington Wizards,10,116,7:00p,222,New Orleans Pelicans,106
Dec 20 2017,0,Atlanta Hawks,-10,95,7:30p,200,Indiana Pacers,105
Dec 20 2017,0,Boston Celtics,-1,89,7:30p,179,Miami Heat,90
Dec 20 2017,0,Brooklyn Nets,-5,99,7:30p,203,Sacramento Kings,104
Dec 20 2017,1,Chicago Bulls,18,112,8:00p,206,Orlando Magic,94
Dec 20 2017,0,Charlotte Hornets,-18,111,7:00p,240,Toronto Raptors,129
Dec 20 2017,1,Dallas Mavericks,17,110,8:30p,203,Detroit Pistons,93
Dec 20 2017,0,Denver Nuggets,-8,104,9:00p,216,Minnesota Timberwolves,112
Dec 20 2017,1,Golden State Warriors,13,97,10:30p,181,Memphis Grizzlies,84
Dec 20 2017,0,Houston Rockets,-6,116,8:00p,238,Los Angeles Lakers,122
Dec 20 2017,1,Los Angeles Clippers,13,108,10:30p,203,Phoenix Suns,95
Dec 20 2017,1,Oklahoma City Thunder,28,107,8:00p,186,Utah Jazz,79
Dec 20 2017,0,Portland Trail Blazers,-2,91,10:00p,184,San Antonio Spurs,93
Dec 21 2017,1,Cleveland Cavaliers,3,115,7:00p,227,Chicago Bulls,112
Dec 21 2017,1,New York Knicks,9,102,8:00p,195,Boston Celtics,93
Dec 21 2017,0,Philadelphia 76ers,-5,109,7:00p,223,Toronto Raptors,114
Dec 21 2017,1,Phoenix Suns,2,97,9:00p,192,Memphis Grizzlies,95
Dec 21 2017,1,Utah Jazz,11,100,10:30p,189,San Antonio Spurs,89
Dec 22 2017,1,Brooklyn Nets,35,119,7:30p,203,Washington Wizards,84
Dec 22 2017,1,Detroit Pistons,3,104,7:00p,205,New York Knicks,101
Dec 22 2017,1,Golden State Warriors,7,113,10:30p,219,Los Angeles Lakers,106
Dec 22 2017,0,Houston Rockets,-10,118,8:00p,246,Los Angeles Clippers,128
Dec 22 2017,1,Miami Heat,12,113,8:00p,214,Dallas Mavericks,101
Dec 22 2017,1,Milwaukee Bucks,5,109,8:00p,213,Charlotte Hornets,104
Dec 22 2017,1,Oklahoma City Thunder,3,120,8:00p,237,Atlanta Hawks,117
Dec 22 2017,0,Orlando Magic,-14,97,7:00p,208,New Orleans Pelicans,111
Dec 22 2017,0,Portland Trail Blazers,-17,85,10:00p,187,Denver Nuggets,102
Dec 23 2017,1,Atlanta Hawks,5,112,7:30p,219,Dallas Mavericks,107
Dec 23 2017,1,Boston Celtics,25,117,7:30p,209,Chicago Bulls,92
Dec 23 2017,1,Charlotte Hornets,5,111,7:00p,217,Milwaukee Bucks,106
Dec 23 2017,0,Golden State Warriors,-15,81,8:30p,177,Denver Nuggets,96
Dec 23 2017,1,Indiana Pacers,4,123,7:00p,242,Brooklyn Nets,119
Dec 23 2017,0,Los Angeles Lakers,-3,92,9:30p,187,Portland Trail Blazers,95
Dec 23 2017,1,Memphis Grizzlies,3,115,8:00p,227,Los Angeles Clippers,112
Dec 23 2017,0,Miami Heat,-15,94,8:00p,203,New Orleans Pelicans,109
Dec 23 2017,0,Phoenix Suns,-9,106,9:00p,221,Minnesota Timberwolves,115
Dec 23 2017,0,Sacramento Kings,-9,99,10:00p,207,San Antonio Spurs,108
Dec 23 2017,1,Toronto Raptors,16,102,5:00p,188,Philadelphia 76ers,86
Dec 23 2017,0,Utah Jazz,-14,89,8:00p,192,Oklahoma City Thunder,103
Dec 23 2017,1,Washington Wizards,27,130,7:00p,233,Orlando Magic,103
Dec 25 2017,0,Boston Celtics,-8,103,5:30p,214,Washington Wizards,111
Dec 25 2017,1,Golden State Warriors,7,99,3:00p,191,Cleveland Cavaliers,92
Dec 25 2017,0,Los Angeles Lakers,-17,104,10:30p,225,Minnesota Timberwolves,121
Dec 25 2017,0,New York Knicks,-7,98,12:00p,203,Philadelphia 76ers,105
Dec 25 2017,1,Oklahoma City Thunder,5,112,8:00p,219,Houston Rockets,107
Dec 26 2017,1,Dallas Mavericks,5,98,7:00p,191,Toronto Raptors,93
Dec 26 2017,1,Denver Nuggets,24,107,9:00p,190,Utah Jazz,83
Dec 26 2017,1,Detroit Pistons,24,107,7:00p,190,Indiana Pacers,83
Dec 26 2017,1,Los Angeles Clippers,27,122,10:30p,217,Sacramento Kings,95
Dec 26 2017,1,Miami Heat,18,107,7:30p,196,Orlando Magic,89
Dec 26 2017,0,Milwaukee Bucks,-9,106,8:00p,221,Chicago Bulls,115
Dec 26 2017,1,Phoenix Suns,2,99,9:00p,196,Memphis Grizzlies,97
Dec 26 2017,1,San Antonio Spurs,12,109,8:30p,206,Brooklyn Nets,97
Dec 27 2017,1,Atlanta Hawks,14,113,7:30p,212,Washington Wizards,99
Dec 27 2017,1,Chicago Bulls,5,92,8:00p,179,New York Knicks,87
Dec 27 2017,0,Charlotte Hornets,-11,91,7:00p,193,Boston Celtics,102
Dec 27 2017,1,Golden State Warriors,25,126,10:30p,227,Utah Jazz,101
Dec 27 2017,0,Indiana Pacers,-4,94,7:00p,192,Dallas Mavericks,98
Dec 27 2017,0,Los Angeles Lakers,-10,99,10:30p,208,Memphis Grizzlies,109
Dec 27 2017,1,Minnesota Timberwolves,3,128,8:00p,253,Denver Nuggets,125
Dec 27 2017,1,New Orleans Pelicans,15,128,8:00p,241,Brooklyn Nets,113
Dec 27 2017,1,Oklahoma City Thunder,17,124,8:00p,231,Toronto Raptors,107
Dec 27 2017,1,Sacramento Kings,14,109,10:00p,204,Cleveland Cavaliers,95
Dec 28 2017,1,Boston Celtics,1,99,8:00p,197,Houston Rockets,98
Dec 28 2017,1,Milwaukee Bucks,6,102,8:00p,198,Minnesota Timberwolves,96
Dec 28 2017,1,Orlando Magic,13,102,7:00p,191,Detroit Pistons,89
Dec 28 2017,1,Portland Trail Blazers,4,114,10:30p,224,Philadelphia 76ers,110
Dec 28 2017,1,San Antonio Spurs,12,119,8:30p,226,New York Knicks,107
Dec 29 2017,1,Chicago Bulls,12,119,8:00p,226,Indiana Pacers,107
Dec 29 2017,0,Golden State Warriors,-11,100,10:30p,211,Charlotte Hornets,111
Dec 29 2017,0,Los Angeles Lakers,-15,106,10:30p,227,Los Angeles Clippers,121
Dec 29 2017,0,Miami Heat,-24,87,8:00p,198,Brooklyn Nets,111
Dec 29 2017,0,New Orleans Pelicans,-8,120,8:00p,248,Dallas Mavericks,128
Dec 29 2017,0,Oklahoma City Thunder,-2,95,8:00p,192,Milwaukee Bucks,97
Dec 29 2017,0,Sacramento Kings,-10,101,10:00p,212,Phoenix Suns,111
Dec 29 2017,1,Toronto Raptors,13,111,7:30p,209,Atlanta Hawks,98
Dec 29 2017,1,Washington Wizards,18,121,7:00p,224,Houston Rockets,103
Dec 30 2017,1,Atlanta Hawks,15,104,7:30p,193,Portland Trail Blazers,89
Dec 30 2017,0,Denver Nuggets,-5,102,9:00p,209,Philadelphia 76ers,107
Dec 30 2017,1,Detroit Pistons,14,93,7:00p,172,San Antonio Spurs,79
Dec 30 2017,1,Golden State Warriors,13,141,8:30p,269,Memphis Grizzlies,128
Dec 30 2017,0,New Orleans Pelicans,-2,103,7:00p,208,New York Knicks,105
Dec 30 2017,0,Orlando Magic,-6,111,7:00p,228,Miami Heat,117
Dec 30 2017,1,Utah Jazz,3,104,8:00p,205,Cleveland Cavaliers,101
Dec 31 2017,1,Boston Celtics,3,108,5:30p,213,Brooklyn Nets,105
Dec 31 2017,1,Houston Rockets,6,148,7:00p,290,Los Angeles Lakers,142
Dec 31 2017,0,Indiana Pacers,-17,90,5:00p,197,Minnesota Timberwolves,107
Dec 31 2017,1,Los Angeles Clippers,8,106,7:00p,204,Charlotte Hornets,98
Dec 31 2017,0,Oklahoma City Thunder,-3,113,7:00p,229,Dallas Mavericks,116
Dec 31 2017,0,Phoenix Suns,-13,110,8:00p,233,Philadelphia 76ers,123
Dec 31 2017,0,Sacramento Kings,-18,96,7:00p,210,Memphis Grizzlies,114
Dec 31 2017,1,Washington Wizards,4,114,3:30p,224,Chicago Bulls,110
Jan 1 2018,1,Brooklyn Nets,3,98,7:30p,193,Orlando Magic,95
Jan 1 2018,0,Chicago Bulls,-4,120,8:00p,244,Portland Trail Blazers,124
Jan 1 2018,1,Minnesota Timberwolves,18,114,8:00p,210,Los Angeles Lakers,96
Jan 1 2018,1,Toronto Raptors,4,131,7:30p,258,Milwaukee Bucks,127
Jan 2 2018,1,Cleveland Cavaliers,17,127,7:00p,237,Portland Trail Blazers,110
Jan 2 2018,1,Los Angeles Clippers,8,113,10:30p,218,Memphis Grizzlies,105
Jan 2 2018,0,New York Knicks,-9,91,7:30p,191,San Antonio Spurs,100
Jan 2 2018,1,Phoenix Suns,1,104,9:00p,207,Atlanta Hawks,103
Jan 2 2018,0,Sacramento Kings,-20,111,10:00p,242,Charlotte Hornets,131
Jan 3 2018,1,Boston Celtics,14,102,8:00p,190,Cleveland Cavaliers,88
Jan 3 2018,1,Brooklyn Nets,1,98,7:30p,195,Minnesota Timberwolves,97
Jan 3 2018,0,Chicago Bulls,-9,115,8:00p,239,Toronto Raptors,124
Jan 3 2018,0,Dallas Mavericks,-3,122,8:30p,247,Golden State Warriors,125
Jan 3 2018,1,Denver Nuggets,23,134,9:00p,245,Phoenix Suns,111
Jan 3 2018,0,Los Angeles Lakers,-37,96,10:30p,229,Oklahoma City Thunder,133
Jan 3 2018,1,Miami Heat,7,111,7:30p,215,Detroit Pistons,104
Jan 3 2018,1,Milwaukee Bucks,21,122,8:00p,223,Indiana Pacers,101
Jan 3 2018,0,Orlando Magic,-18,98,7:00p,214,Houston Rockets,116
Jan 3 2018,1,Philadelphia 76ers,6,112,7:00p,218,San Antonio Spurs,106
Jan 3 2018,0,Utah Jazz,-10,98,9:00p,206,New Orleans Pelicans,108
Jan 3 2018,1,Washington Wizards,18,121,7:00p,224,New York Knicks,103
Jan 4 2018,0,Houston Rockets,-10,114,8:00p,238,Golden State Warriors,124
Jan 4 2018,0,Los Angeles Clippers,-10,117,10:30p,244,Oklahoma City Thunder,127
Jan 5 2018,1,Boston Celtics,7,91,7:00p,175,Minnesota Timberwolves,84
Jan 5 2018,0,Dallas Mavericks,-3,124,8:30p,251,Chicago Bulls,127
Jan 5 2018,1,Denver Nuggets,8,99,9:00p,190,Utah Jazz,91
Jan 5 2018,0,Los Angeles Lakers,-14,94,10:30p,202,Charlotte Hornets,108
Jan 5 2018,0,Memphis Grizzlies,-2,100,9:30p,202,Washington Wizards,102
Jan 5 2018,1,Miami Heat,4,107,8:00p,210,New York Knicks,103
Jan 5 2018,0,Milwaukee Bucks,-19,110,8:00p,239,Toronto Raptors,129
Jan 5 2018,1,Philadelphia 76ers,36,114,7:00p,192,Detroit Pistons,78
Jan 5 2018,1,Portland Trail Blazers,21,110,10:00p,199,Atlanta Hawks,89
Jan 5 2018,1,San Antonio Spurs,14,103,8:30p,192,Phoenix Suns,89
Jan 6 2018,0,Brooklyn Nets,-2,85,6:00p,172,Boston Celtics,87
Jan 6 2018,1,Detroit Pistons,7,108,7:00p,209,Houston Rockets,101
Jan 6 2018,1,Indiana Pacers,39,125,7:00p,211,Chicago Bulls,86
Jan 6 2018,0,Los Angeles Clippers,-16,105,3:30p,226,Golden State Warriors,121
Jan 6 2018,1,Minnesota Timberwolves,18,116,9:00p,214,New Orleans Pelicans,98
Jan 6 2018,0,Orlando Magic,-4,127,7:00p,258,Cleveland Cavaliers,131
Jan 6 2018,1,Sacramento Kings,8,106,10:00p,204,Denver Nuggets,98
Jan 6 2018,0,Washington Wizards,-7,103,8:00p,213,Milwaukee Bucks,110
Jan 7 2018,0,Dallas Mavericks,-4,96,7:00p,196,New York Knicks,100
Jan 7 2018,1,Los Angeles Lakers,19,132,9:30p,245,Atlanta Hawks,113
Jan 7 2018,1,Miami Heat,1,103,3:30p,205,Utah Jazz,102
Jan 7 2018,1,Phoenix Suns,14,114,8:00p,214,Oklahoma City Thunder,100
Jan 7 2018,1,Portland Trail Blazers,1,111,9:00p,221,San Antonio Spurs,110
Jan 8 2018,0,Brooklyn Nets,-1,113,7:30p,227,Toronto Raptors,114
Jan 8 2018,0,Chicago Bulls,-9,107,8:00p,223,Houston Rockets,116
Jan 8 2018,1,Golden State Warriors,10,124,10:30p,238,Denver Nuggets,114
Jan 8 2018,1,Indiana Pacers,13,109,7:00p,205,Milwaukee Bucks,96
Jan 8 2018,1,Los Angeles Clippers,1,108,10:30p,215,Atlanta Hawks,107
Jan 8 2018,1,Minnesota Timberwolves,28,127,8:00p,226,Cleveland Cavaliers,99
Jan 8 2018,1,New Orleans Pelicans,3,112,8:00p,221,Detroit Pistons,109
Jan 8 2018,0,Sacramento Kings,-7,100,10:00p,207,San Antonio Spurs,107
Jan 9 2018,1,Dallas Mavericks,15,114,8:30p,213,Orlando Magic,99
Jan 9 2018,1,Los Angeles Lakers,13,99,10:30p,185,Sacramento Kings,86
Jan 9 2018,0,Oklahoma City Thunder,-11,106,8:00p,223,Portland Trail Blazers,117
Jan 9 2018,0,Toronto Raptors,-1,89,7:30p,179,Miami Heat,90
Jan 10 2018,0,Brooklyn Nets,-34,80,7:30p,194,Detroit Pistons,114
Jan 10 2018,0,Charlotte Hornets,-4,111,7:00p,226,Dallas Mavericks,115
Jan 10 2018,0,Denver Nuggets,-13,97,9:00p,207,Atlanta Hawks,110
Jan 10 2018,0,Golden State Warriors,-19,106,10:30p,231,Los Angeles Clippers,125
Jan 10 2018,1,Houston Rockets,9,121,8:00p,233,Portland Trail Blazers,112
Jan 10 2018,0,Indiana Pacers,-8,106,7:00p,220,Miami Heat,114
Jan 10 2018,1,Memphis Grizzlies,3,105,8:00p,207,New Orleans Pelicans,102
Jan 10 2018,1,Milwaukee Bucks,7,110,8:00p,213,Orlando Magic,103
Jan 10 2018,1,Minnesota Timberwolves,16,104,8:00p,192,Oklahoma City Thunder,88
Jan 10 2018,0,New York Knicks,-3,119,7:30p,241,Chicago Bulls,122
Jan 10 2018,0,Washington Wizards,-3,104,7:00p,211,Utah Jazz,107
Jan 11 2018,1,Los Angeles Lakers,12,93,10:30p,174,San Antonio Spurs,81
Jan 11 2018,0,Philadelphia 76ers,-11,103,3:00p,217,Boston Celtics,114
Jan 11 2018,0,Sacramento Kings,-6,115,10:00p,236,Los Angeles Clippers,121
Jan 11 2018,1,Toronto Raptors,34,133,8:00p,232,Cleveland Cavaliers,99
Jan 12 2018,0,Atlanta Hawks,-5,105,7:30p,215,Brooklyn Nets,110
Jan 12 2018,1,Charlotte Hornets,11,99,7:00p,187,Utah Jazz,88
Jan 12 2018,1,Denver Nuggets,9,87,9:00p,165,Memphis Grizzlies,78
Jan 12 2018,1,Indiana Pacers,2,97,7:00p,192,Cleveland Cavaliers,95
Jan 12 2018,0,Milwaukee Bucks,-14,94,8:00p,202,Golden State Warriors,108
Jan 12 2018,1,Minnesota Timberwolves,10,118,8:00p,226,New York Knicks,108
Jan 12 2018,1,New Orleans Pelicans,6,119,8:00p,232,Portland Trail Blazers,113
Jan 12 2018,0,Phoenix Suns,-17,95,10:30p,207,Houston Rockets,112
Jan 12 2018,1,Washington Wizards,6,125,7:00p,244,Orlando Magic,119
Jan 13 2018,1,Chicago Bulls,2,107,8:00p,212,Detroit Pistons,105
Jan 13 2018,0,Charlotte Hornets,-10,91,5:00p,192,Oklahoma City Thunder,101
Jan 13 2018,0,Dallas Mavericks,-6,101,2:00p,208,Los Angeles Lakers,107
Jan 13 2018,1,Los Angeles Clippers,21,126,3:30p,231,Sacramento Kings,105
Jan 13 2018,1,San Antonio Spurs,32,112,8:30p,192,Denver Nuggets,80
Jan 13 2018,0,Toronto Raptors,-2,125,7:30p,252,Golden State Warriors,127
Jan 13 2018,1,Washington Wizards,6,119,7:00p,232,Brooklyn Nets,113
Jan 14 2018,1,Miami Heat,18,97,1:00p,176,Milwaukee Bucks,79
Jan 14 2018,1,Minnesota Timberwolves,17,120,9:00p,223,Portland Trail Blazers,103
Jan 14 2018,0,New York Knicks,-5,118,3:30p,241,New Orleans Pelicans,123
Jan 14 2018,0,Phoenix Suns,-23,97,8:00p,217,Indiana Pacers,120
Jan 15 2018,1,Atlanta Hawks,3,102,3:00p,201,San Antonio Spurs,99
Jan 15 2018,0,Brooklyn Nets,-15,104,3:00p,223,New York Knicks,119
Jan 15 2018,1,Chicago Bulls,8,119,3:30p,230,Miami Heat,111
Jan 15 2018,0,Cleveland Cavaliers,-10,108,8:00p,226,Golden State Warriors,118
Jan 15 2018,0,Detroit Pistons,-11,107,12:30p,225,Charlotte Hornets,118
Jan 15 2018,1,Los Angeles Clippers,11,113,10:30p,215,Houston Rockets,102
Jan 15 2018,1,Memphis Grizzlies,9,123,5:30p,237,Los Angeles Lakers,114
Jan 15 2018,1,Oklahoma City Thunder,7,95,8:00p,183,Sacramento Kings,88
Jan 15 2018,1,Philadelphia 76ers,6,117,1:00p,228,Toronto Raptors,111
Jan 15 2018,0,Utah Jazz,-15,94,9:00p,203,Indiana Pacers,109
Jan 15 2018,0,Washington Wizards,-9,95,2:00p,199,Milwaukee Bucks,104
Jan 16 2018,0,Boston Celtics,-3,113,7:30p,229,New Orleans Pelicans,116
Jan 16 2018,1,Denver Nuggets,3,105,9:00p,207,Dallas Mavericks,102
Jan 16 2018,1,Orlando Magic,6,108,7:00p,210,Minnesota Timberwolves,102
Jan 16 2018,1,Portland Trail Blazers,7,118,10:00p,229,Phoenix Suns,111
Jan 17 2018,1,Atlanta Hawks,1,94,7:30p,187,New Orleans Pelicans,93
Jan 17 2018,0,Brooklyn Nets,-5,95,7:30p,195,San Antonio Spurs,100
Jan 17 2018,0,Chicago Bulls,-7,112,8:00p,231,Golden State Warriors,119
Jan 17 2018,1,Charlotte Hornets,24,133,7:00p,242,Washington Wizards,109
Jan 17 2018,1,Los Angeles Clippers,5,109,10:30p,213,Denver Nuggets,104
Jan 17 2018,1,Memphis Grizzlies,6,105,8:00p,204,New York Knicks,99
Jan 17 2018,0,Milwaukee Bucks,-5,101,8:00p,207,Miami Heat,106
Jan 17 2018,1,Oklahoma City Thunder,24,114,8:00p,204,Los Angeles Lakers,90
Jan 17 2018,0,Sacramento Kings,-15,105,10:00p,225,Utah Jazz,120
Jan 17 2018,1,Toronto Raptors,5,96,7:30p,187,Detroit Pistons,91
Jan 18 2018,0,Boston Celtics,-9,80,7:00p,169,Philadelphia 76ers,89
Jan 18 2018,1,Cleveland Cavaliers,1,104,7:00p,207,Orlando Magic,103
Jan 18 2018,1,Houston Rockets,18,116,9:30p,214,Minnesota Timberwolves,98
Jan 18 2018,1,Portland Trail Blazers,14,100,10:00p,186,Indiana Pacers,86
Jan 19 2018,1,Brooklyn Nets,6,101,7:30p,196,Miami Heat,95
Jan 19 2018,0,Denver Nuggets,-8,100,9:00p,208,Phoenix Suns,108
Jan 19 2018,0,Detroit Pistons,-10,112,8:00p,234,Washington Wizards,122
Jan 19 2018,1,Los Angeles Lakers,13,99,10:30p,185,Indiana Pacers,86
Jan 19 2018,1,Memphis Grizzlies,18,106,8:00p,194,Sacramento Kings,88
Jan 19 2018,1,Toronto Raptors,3,86,7:00p,169,San Antonio Spurs,83
Jan 19 2018,0,Utah Jazz,-2,115,10:30p,232,New York Knicks,117
Jan 20 2018,0,Atlanta Hawks,-16,97,5:00p,210,Chicago Bulls,113
Jan 20 2018,0,Charlotte Hornets,-1,105,7:00p,211,Miami Heat,106
Jan 20 2018,0,Cleveland Cavaliers,-24,124,3:30p,272,Oklahoma City Thunder,148
Jan 20 2018,1,Houston Rockets,8,116,8:30p,224,Golden State Warriors,108
Jan 20 2018,1,Minnesota Timberwolves,6,115,9:00p,224,Toronto Raptors,109
Jan 20 2018,1,New Orleans Pelicans,7,111,7:00p,215,Memphis Grizzlies,104
Jan 20 2018,1,Philadelphia 76ers,22,116,7:30p,210,Milwaukee Bucks,94
Jan 20 2018,1,Portland Trail Blazers,9,117,10:00p,225,Dallas Mavericks,108
Jan 20 2018,1,Utah Jazz,12,125,9:00p,238,Los Angeles Clippers,113
Jan 21 2018,0,Boston Celtics,-8,95,1:00p,198,Orlando Magic,103
Jan 21 2018,0,Detroit Pistons,-1,100,4:00p,201,Brooklyn Nets,101
Jan 21 2018,1,Los Angeles Lakers,20,127,3:30p,234,New York Knicks,107
Jan 21 2018,0,San Antonio Spurs,-8,86,7:00p,180,Indiana Pacers,94
Jan 22 2018,1,Atlanta Hawks,14,104,7:30p,194,Utah Jazz,90
Jan 22 2018,1,Charlotte Hornets,5,112,7:00p,219,Sacramento Kings,107
Jan 22 2018,1,Dallas Mavericks,23,98,8:30p,173,Washington Wizards,75
Jan 22 2018,1,Denver Nuggets,3,104,9:00p,205,Portland Trail Blazers,101
Jan 22 2018,1,Houston Rockets,9,99,8:00p,189,Miami Heat,90
Jan 22 2018,0,Los Angeles Clippers,-8,118,10:30p,244,Minnesota Timberwolves,126
Jan 22 2018,1,Memphis Grizzlies,4,105,8:00p,206,Philadelphia 76ers,101
Jan 22 2018,1,Milwaukee Bucks,4,109,8:00p,214,Phoenix Suns,105
Jan 22 2018,1,New Orleans Pelicans,4,132,8:00p,260,Chicago Bulls,128
Jan 23 2018,1,Golden State Warriors,11,123,10:30p,235,New York Knicks,112
Jan 23 2018,1,Los Angeles Lakers,1,108,10:30p,215,Boston Celtics,107
Jan 23 2018,1,Oklahoma City Thunder,1,109,8:00p,217,Brooklyn Nets,108
Jan 23 2018,0,Orlando Magic,-6,99,7:00p,204,Sacramento Kings,105
Jan 23 2018,1,San Antonio Spurs,12,114,8:00p,216,Cleveland Cavaliers,102
Jan 24 2018,0,Atlanta Hawks,-15,93,7:30p,201,Toronto Raptors,108
Jan 24 2018,0,Charlotte Hornets,-5,96,7:00p,197,New Orleans Pelicans,101
Jan 24 2018,0,Dallas Mavericks,-7,97,8:00p,201,Houston Rockets,104
Jan 24 2018,0,Detroit Pistons,-3,95,7:00p,193,Utah Jazz,98
Jan 24 2018,1,Indiana Pacers,15,116,7:00p,217,Phoenix Suns,101
Jan 24 2018,0,Los Angeles Clippers,-11,102,10:30p,215,Boston Celtics,113
Jan 24 2018,0,Memphis Grizzlies,-23,85,8:00p,193,San Antonio Spurs,108
Jan 24 2018,1,Philadelphia 76ers,14,115,7:00p,216,Chicago Bulls,101
Jan 24 2018,1,Portland Trail Blazers,9,123,10:00p,237,Minnesota Timberwolves,114
Jan 25 2018,1,Denver Nuggets,12,130,9:00p,248,New York Knicks,118
Jan 25 2018,1,Golden State Warriors,13,126,10:30p,239,Minnesota Timberwolves,113
Jan 25 2018,0,Miami Heat,-1,88,7:30p,177,Sacramento Kings,89
Jan 25 2018,1,Oklahoma City Thunder,9,121,8:00p,233,Washington Wizards,112
Jan 26 2018,0,Chicago Bulls,-5,103,8:00p,211,Los Angeles Lakers,108
Jan 26 2018,1,Charlotte Hornets,11,121,7:00p,231,Atlanta Hawks,110
Jan 26 2018,1,Cleveland Cavaliers,7,115,7:30p,223,Indiana Pacers,108
Jan 26 2018,0,Dallas Mavericks,-14,93,8:30p,200,Portland Trail Blazers,107
Jan 26 2018,0,Memphis Grizzlies,-9,100,8:00p,209,Los Angeles Clippers,109
Jan 26 2018,1,Milwaukee Bucks,25,116,8:00p,207,Brooklyn Nets,91
Jan 26 2018,1,New Orleans Pelicans,2,115,8:00p,228,Houston Rockets,113
Jan 26 2018,0,Phoenix Suns,-22,85,9:00p,192,New York Knicks,107
Jan 26 2018,0,San Antonio Spurs,-19,78,8:30p,175,Philadelphia 76ers,97
Jan 26 2018,0,Toronto Raptors,-4,93,7:30p,190,Utah Jazz,97
Jan 27 2018,0,Atlanta Hawks,-25,104,7:30p,233,Washington Wizards,129
Jan 27 2018,1,Denver Nuggets,2,91,9:00p,180,Dallas Mavericks,89
Jan 27 2018,0,Detroit Pistons,-13,108,5:00p,229,Oklahoma City Thunder,121
Jan 27 2018,1,Golden State Warriors,4,109,8:30p,214,Boston Celtics,105
Jan 27 2018,1,Indiana Pacers,2,114,7:00p,226,Orlando Magic,112
Jan 27 2018,1,Miami Heat,4,95,7:30p,186,Charlotte Hornets,91
Jan 27 2018,1,Minnesota Timberwolves,14,111,9:00p,208,Brooklyn Nets,97
Jan 28 2018,0,Chicago Bulls,-14,96,3:30p,206,Milwaukee Bucks,110
Jan 28 2018,1,Cleveland Cavaliers,17,121,6:00p,225,Detroit Pistons,104
Jan 28 2018,1,Houston Rockets,11,113,3:30p,215,Phoenix Suns,102
Jan 28 2018,0,New Orleans Pelicans,-9,103,4:00p,215,Los Angeles Clippers,112
Jan 28 2018,1,Oklahoma City Thunder,10,122,6:00p,234,Philadelphia 76ers,112
Jan 28 2018,1,San Antonio Spurs,15,113,7:00p,211,Sacramento Kings,98
Jan 28 2018,1,Toronto Raptors,12,123,6:00p,234,Los Angeles Lakers,111
Jan 29 2018,1,Atlanta Hawks,5,105,7:30p,205,Minnesota Timberwolves,100
Jan 29 2018,0,Dallas Mavericks,-7,88,8:30p,183,Miami Heat,95
Jan 29 2018,0,Denver Nuggets,-1,110,9:00p,221,Boston Celtics,111
Jan 29 2018,1,Indiana Pacers,9,105,7:00p,201,Charlotte Hornets,96
Jan 29 2018,1,Memphis Grizzlies,11,120,8:00p,229,Phoenix Suns,109
Jan 29 2018,1,Milwaukee Bucks,12,107,8:00p,202,Philadelphia 76ers,95
Jan 30 2018,1,Detroit Pistons,11,125,8:00p,239,Cleveland Cavaliers,114
Jan 30 2018,1,Houston Rockets,7,114,8:00p,221,Orlando Magic,107
Jan 30 2018,0,Los Angeles Clippers,-8,96,10:30p,200,Portland Trail Blazers,104
Jan 30 2018,0,New Orleans Pelicans,-11,103,8:00p,217,Sacramento Kings,114
Jan 30 2018,1,New York Knicks,16,111,7:30p,206,Brooklyn Nets,95
Jan 30 2018,1,San Antonio Spurs,2,106,8:30p,210,Denver Nuggets,104
Jan 30 2018,1,Toronto Raptors,5,109,7:30p,213,Minnesota Timberwolves,104
Jan 30 2018,1,Utah Jazz,30,129,9:00p,228,Golden State Warriors,99
Jan 30 2018,1,Washington Wizards,6,102,7:00p,198,Oklahoma City Thunder,96
Jan 31 2018,0,Atlanta Hawks,-13,110,7:30p,233,Charlotte Hornets,123
Jan 31 2018,1,Boston Celtics,30,103,8:00p,176,New York Knicks,73
Jan 31 2018,1,Brooklyn Nets,8,116,7:30p,224,Philadelphia 76ers,108
Jan 31 2018,1,Cleveland Cavaliers,2,91,7:30p,180,Miami Heat,89
Jan 31 2018,1,Indiana Pacers,4,105,7:00p,206,Memphis Grizzlies,101
Jan 31 2018,1,Orlando Magic,22,127,7:00p,232,Los Angeles Lakers,105
Jan 31 2018,1,Phoenix Suns,14,102,10:30p,190,Dallas Mavericks,88
Jan 31 2018,1,Portland Trail Blazers,16,124,10:00p,232,Chicago Bulls,108
Feb 1 2018,1,Denver Nuggets,3,127,10:30p,251,Oklahoma City Thunder,124
Feb 1 2018,1,Detroit Pistons,2,104,7:00p,206,Memphis Grizzlies,102
Feb 1 2018,1,Minnesota Timberwolves,19,108,8:00p,197,Milwaukee Bucks,89
Feb 1 2018,0,San Antonio Spurs,-11,91,8:00p,193,Houston Rockets,102
Feb 1 2018,1,Washington Wizards,3,122,7:00p,241,Toronto Raptors,119
Feb 2 2018,1,Boston Celtics,9,119,7:30p,229,Atlanta Hawks,110
Feb 2 2018,0,Brooklyn Nets,-3,99,7:30p,201,Los Angeles Lakers,102
Feb 2 2018,1,Charlotte Hornets,7,133,7:00p,259,Indiana Pacers,126
Feb 2 2018,1,Milwaukee Bucks,2,92,8:00p,182,New York Knicks,90
Feb 2 2018,0,Oklahoma City Thunder,-14,100,9:00p,214,New Orleans Pelicans,114
Feb 2 2018,1,Philadelphia 76ers,6,103,8:00p,200,Miami Heat,97
Feb 2 2018,0,Phoenix Suns,-32,97,9:00p,226,Utah Jazz,129
Feb 2 2018,0,Sacramento Kings,-15,104,10:30p,223,Golden State Warriors,119
Feb 2 2018,1,Toronto Raptors,25,130,7:30p,235,Portland Trail Blazers,105
Feb 3 2018,0,Cleveland Cavaliers,-32,88,8:30p,208,Houston Rockets,120
Feb 3 2018,1,Denver Nuggets,7,115,9:00p,223,Golden State Warriors,108
Feb 3 2018,1,Detroit Pistons,4,111,7:00p,218,Miami Heat,107
Feb 3 2018,1,Indiana Pacers,8,100,7:00p,192,Philadelphia 76ers,92
Feb 3 2018,1,Los Angeles Clippers,10,113,3:30p,216,Chicago Bulls,103
Feb 3 2018,1,Minnesota Timberwolves,11,118,9:00p,225,New Orleans Pelicans,107
Feb 3 2018,0,Orlando Magic,-17,98,7:00p,213,Washington Wizards,115
Feb 3 2018,0,Sacramento Kings,-7,99,10:00p,205,Dallas Mavericks,106
Feb 3 2018,0,San Antonio Spurs,-9,111,9:00p,231,Utah Jazz,120
Feb 4 2018,1,Boston Celtics,1,97,12:00p,193,Portland Trail Blazers,96
Feb 4 2018,0,Brooklyn Nets,-15,94,12:00p,203,Milwaukee Bucks,109
Feb 4 2018,0,New York Knicks,-3,96,12:00p,195,Atlanta Hawks,99
Feb 4 2018,0,Oklahoma City Thunder,-4,104,2:00p,212,Los Angeles Lakers,108
Feb 4 2018,0,Phoenix Suns,-5,110,3:00p,225,Charlotte Hornets,115
Feb 4 2018,1,Toronto Raptors,15,101,12:00p,187,Memphis Grizzlies,86
Feb 5 2018,1,Denver Nuggets,17,121,9:00p,225,Charlotte Hornets,104
Feb 5 2018,1,Detroit Pistons,20,111,7:00p,202,Portland Trail Blazers,91
Feb 5 2018,0,Indiana Pacers,-9,102,7:00p,213,Washington Wizards,111
Feb 5 2018,1,Los Angeles Clippers,3,104,10:30p,205,Dallas Mavericks,101
Feb 5 2018,0,Miami Heat,-2,109,7:30p,220,Orlando Magic,111
Feb 5 2018,0,New Orleans Pelicans,-24,109,8:00p,242,Utah Jazz,133
Feb 5 2018,1,Sacramento Kings,6,104,10:00p,202,Chicago Bulls,98
Feb 6 2018,1,Atlanta Hawks,26,108,7:30p,190,Memphis Grizzlies,82
Feb 6 2018,0,Brooklyn Nets,-10,113,7:30p,236,Houston Rockets,123
Feb 6 2018,0,Golden State Warriors,-20,105,10:30p,230,Oklahoma City Thunder,125
Feb 6 2018,1,Los Angeles Lakers,19,112,10:30p,205,Phoenix Suns,93
Feb 6 2018,0,New York Knicks,-14,89,7:30p,192,Milwaukee Bucks,103
Feb 6 2018,1,Orlando Magic,18,116,7:00p,214,Cleveland Cavaliers,98
Feb 6 2018,1,Philadelphia 76ers,13,115,8:00p,217,Washington Wizards,102
Feb 6 2018,1,Toronto Raptors,20,111,7:30p,202,Boston Celtics,91
Feb 7 2018,1,Cleveland Cavaliers,2,140,8:00p,278,Minnesota Timberwolves,138
Feb 7 2018,1,Detroit Pistons,9,115,7:00p,221,Brooklyn Nets,106
Feb 7 2018,0,Memphis Grizzlies,-4,88,8:00p,180,Utah Jazz,92
Feb 7 2018,0,Miami Heat,-8,101,7:30p,210,Houston Rockets,109
Feb 7 2018,0,Phoenix Suns,-48,81,10:30p,210,San Antonio Spurs,129
Feb 8 2018,1,Golden State Warriors,18,121,10:30p,224,Dallas Mavericks,103
Feb 8 2018,1,Los Angeles Lakers,25,106,10:30p,187,Oklahoma City Thunder,81
Feb 8 2018,1,Orlando Magic,2,100,7:00p,198,Atlanta Hawks,98
Feb 8 2018,1,Portland Trail Blazers,6,109,10:00p,212,Charlotte Hornets,103
Feb 8 2018,1,Toronto Raptors,25,113,7:30p,201,New York Knicks,88
Feb 8 2018,0,Washington Wizards,-6,104,8:00p,214,Boston Celtics,110
Feb 9 2018,0,Atlanta Hawks,-16,107,7:30p,230,Cleveland Cavaliers,123
Feb 9 2018,0,Boston Celtics,-6,91,7:30p,188,Indiana Pacers,97
Feb 9 2018,1,Chicago Bulls,1,114,9:30p,227,Minnesota Timberwolves,113
Feb 9 2018,0,Detroit Pistons,-13,95,7:00p,203,Los Angeles Clippers,108
Feb 9 2018,1,Houston Rockets,26,130,8:00p,234,Denver Nuggets,104
Feb 9 2018,1,Miami Heat,6,91,8:00p,176,Milwaukee Bucks,85
Feb 9 2018,1,Philadelphia 76ers,18,100,7:00p,182,New Orleans Pelicans,82
Feb 9 2018,0,Sacramento Kings,-18,100,10:30p,218,Portland Trail Blazers,118
Feb 9 2018,1,Utah Jazz,12,106,9:00p,200,Charlotte Hornets,94
Feb 10 2018,0,Brooklyn Nets,-10,128,6:00p,266,New Orleans Pelicans,138
Feb 10 2018,0,Chicago Bulls,-11,90,8:00p,191,Washington Wizards,101
Feb 10 2018,1,Dallas Mavericks,7,130,8:30p,253,Los Angeles Lakers,123
Feb 10 2018,1,Golden State Warriors,17,122,8:30p,227,San Antonio Spurs,105
Feb 10 2018,0,Orlando Magic,-7,104,7:00p,215,Milwaukee Bucks,111
Feb 10 2018,1,Philadelphia 76ers,14,112,7:00p,210,Los Angeles Clippers,98
Feb 10 2018,0,Phoenix Suns,-10,113,9:00p,236,Denver Nuggets,123
Feb 11 2018,1,Atlanta Hawks,3,118,3:30p,233,Detroit Pistons,115
Feb 11 2018,0,Boston Celtics,-22,99,3:30p,220,Cleveland Cavaliers,121
Feb 11 2018,0,Charlotte Hornets,-20,103,1:00p,226,Toronto Raptors,123
Feb 11 2018,1,Houston Rockets,7,104,7:00p,201,Dallas Mavericks,97
Feb 11 2018,1,Indiana Pacers,8,121,5:00p,234,New York Knicks,113
Feb 11 2018,1,Minnesota Timberwolves,5,111,7:00p,217,Sacramento Kings,106
Feb 11 2018,1,Oklahoma City Thunder,18,110,7:00p,202,Memphis Grizzlies,92
Feb 11 2018,0,Portland Trail Blazers,-19,96,9:00p,211,Utah Jazz,115
Feb 12 2018,0,Brooklyn Nets,-13,101,7:30p,215,Los Angeles Clippers,114
Feb 12 2018,1,Chicago Bulls,4,105,8:00p,206,Orlando Magic,101
Feb 12 2018,0,Detroit Pistons,-15,103,7:00p,221,New Orleans Pelicans,118
Feb 12 2018,1,Golden State Warriors,46,129,10:30p,212,Phoenix Suns,83
Feb 12 2018,1,Philadelphia 76ers,16,108,7:00p,200,New York Knicks,92
Feb 12 2018,1,Utah Jazz,2,101,9:00p,200,San Antonio Spurs,99
Feb 13 2018,0,Dallas Mavericks,-5,109,8:30p,223,Sacramento Kings,114
Feb 13 2018,1,Denver Nuggets,8,117,10:30p,226,San Antonio Spurs,109
Feb 13 2018,1,Milwaukee Bucks,5,97,8:00p,189,Atlanta Hawks,92
Feb 13 2018,0,Minnesota Timberwolves,-18,108,8:00p,234,Houston Rockets,126
Feb 13 2018,0,Oklahoma City Thunder,-8,112,8:00p,232,Cleveland Cavaliers,120
Feb 13 2018,1,Toronto Raptors,3,115,7:00p,227,Miami Heat,112
Feb 14 2018,0,Boston Celtics,-10,119,8:00p,248,Los Angeles Clippers,129
Feb 14 2018,0,Brooklyn Nets,-5,103,7:30p,211,Indiana Pacers,108
Feb 14 2018,0,Chicago Bulls,-24,98,8:00p,220,Toronto Raptors,122
Feb 14 2018,1,Detroit Pistons,6,104,7:00p,202,Atlanta Hawks,98
Feb 14 2018,1,Houston Rockets,9,100,8:00p,191,Sacramento Kings,91
Feb 14 2018,0,Memphis Grizzlies,-7,114,8:00p,235,Oklahoma City Thunder,121
Feb 14 2018,1,New Orleans Pelicans,22,139,8:00p,256,Los Angeles Lakers,117
Feb 14 2018,0,New York Knicks,-5,113,7:30p,231,Washington Wizards,118
Feb 14 2018,0,Orlando Magic,-2,102,7:00p,206,Charlotte Hornets,104
Feb 14 2018,1,Philadelphia 76ers,2,104,7:00p,206,Miami Heat,102
Feb 14 2018,1,Portland Trail Blazers,6,123,10:30p,240,Golden State Warriors,117
Feb 14 2018,1,Utah Jazz,10,107,9:00p,204,Phoenix Suns,97
Feb 15 2018,0,Milwaukee Bucks,-11,123,8:00p,257,Denver Nuggets,134
Feb 15 2018,1,Minnesota Timberwolves,8,119,9:00p,230,Los Angeles Lakers,111
Feb 22 2018,0,Chicago Bulls,-1,115,8:00p,231,Philadelphia 76ers,116
Feb 22 2018,1,Charlotte Hornets,15,111,7:00p,207,Brooklyn Nets,96
Feb 22 2018,0,Cleveland Cavaliers,-7,103,8:00p,213,Washington Wizards,110
Feb 22 2018,1,Golden State Warriors,7,134,10:30p,261,Los Angeles Clippers,127
Feb 22 2018,0,Orlando Magic,-7,113,7:00p,233,New York Knicks,120
Feb 22 2018,0,Sacramento Kings,-3,107,10:00p,217,Oklahoma City Thunder,110
Feb 23 2018,1,Denver Nuggets,3,122,9:00p,241,San Antonio Spurs,119
Feb 23 2018,0,Detroit Pistons,-12,98,7:00p,208,Boston Celtics,110
Feb 23 2018,1,Houston Rockets,18,120,8:00p,222,Minnesota Timberwolves,102
Feb 23 2018,1,Indiana Pacers,23,116,7:00p,209,Atlanta Hawks,93
Feb 23 2018,1,Los Angeles Lakers,22,124,10:30p,226,Dallas Mavericks,102
Feb 23 2018,0,Memphis Grizzlies,-23,89,8:00p,201,Cleveland Cavaliers,112
Feb 23 2018,1,New Orleans Pelicans,1,124,8:00p,247,Miami Heat,123
Feb 23 2018,0,Phoenix Suns,-11,117,9:00p,245,Los Angeles Clippers,128
Feb 23 2018,0,Toronto Raptors,-3,119,7:30p,241,Milwaukee Bucks,122
Feb 23 2018,0,Utah Jazz,-19,81,9:00p,181,Portland Trail Blazers,100
Feb 23 2018,0,Washington Wizards,-17,105,7:00p,227,Charlotte Hornets,122
Feb 24 2018,1,Golden State Warriors,32,112,8:30p,192,Oklahoma City Thunder,80
Feb 24 2018,1,Miami Heat,26,115,7:30p,204,Memphis Grizzlies,89
Feb 24 2018,1,Minnesota Timberwolves,18,122,9:00p,226,Chicago Bulls,104
Feb 24 2018,0,New York Knicks,-9,112,7:30p,233,Boston Celtics,121
Feb 24 2018,1,Philadelphia 76ers,11,116,5:00p,221,Orlando Magic,105
Feb 24 2018,0,Phoenix Suns,-2,104,9:00p,210,Portland Trail Blazers,106
Feb 24 2018,0,Sacramento Kings,-5,108,10:00p,221,Los Angeles Lakers,113
Feb 24 2018,1,Utah Jazz,7,97,9:00p,187,Dallas Mavericks,90
Feb 25 2018,1,Charlotte Hornets,16,114,1:00p,212,Detroit Pistons,98
Feb 25 2018,0,Cleveland Cavaliers,-16,94,3:30p,204,San Antonio Spurs,110
Feb 25 2018,0,Denver Nuggets,-5,114,8:00p,233,Houston Rockets,119
Feb 25 2018,0,Milwaukee Bucks,-2,121,3:00p,244,New Orleans Pelicans,123
Feb 25 2018,1,Washington Wizards,15,109,8:00p,203,Philadelphia 76ers,94
Feb 26 2018,0,Atlanta Hawks,-19,104,7:30p,227,Los Angeles Lakers,123
Feb 26 2018,1,Boston Celtics,11,109,7:30p,207,Memphis Grizzlies,98
Feb 26 2018,1,Brooklyn Nets,17,104,7:30p,191,Chicago Bulls,87
Feb 26 2018,1,Dallas Mavericks,6,109,8:30p,212,Indiana Pacers,103
Feb 26 2018,1,New Orleans Pelicans,9,125,8:00p,241,Phoenix Suns,116
Feb 26 2018,0,New York Knicks,-14,111,7:30p,236,Golden State Warriors,125
Feb 26 2018,1,Oklahoma City Thunder,7,112,8:00p,217,Orlando Magic,105
Feb 26 2018,0,Sacramento Kings,-18,100,10:00p,218,Minnesota Timberwolves,118
Feb 26 2018,1,Toronto Raptors,29,123,7:30p,217,Detroit Pistons,94
Feb 26 2018,0,Utah Jazz,-11,85,9:00p,181,Houston Rockets,96
Feb 27 2018,1,Charlotte Hornets,15,118,7:00p,221,Chicago Bulls,103
Feb 27 2018,1,Cleveland Cavaliers,6,129,7:00p,252,Brooklyn Nets,123
Feb 27 2018,0,Denver Nuggets,-2,120,10:30p,242,Los Angeles Clippers,122
Feb 27 2018,1,Miami Heat,1,102,7:30p,203,Philadelphia 76ers,101
Feb 27 2018,0,Milwaukee Bucks,-3,104,8:00p,211,Washington Wizards,107
Feb 27 2018,1,Portland Trail Blazers,17,116,10:00p,215,Sacramento Kings,99
Feb 28 2018,1,Atlanta Hawks,5,107,7:30p,209,Indiana Pacers,102
Feb 28 2018,1,Boston Celtics,28,134,7:30p,240,Charlotte Hornets,106
Feb 28 2018,0,Dallas Mavericks,-1,110,8:30p,221,Oklahoma City Thunder,111
Feb 28 2018,1,Detroit Pistons,23,110,7:00p,197,Milwaukee Bucks,87
Feb 28 2018,0,Los Angeles Clippers,-13,92,10:30p,197,Houston Rockets,105
Feb 28 2018,0,Memphis Grizzlies,-8,102,8:00p,212,Phoenix Suns,110
Feb 28 2018,0,Orlando Magic,-13,104,7:00p,221,Toronto Raptors,117
Feb 28 2018,0,San Antonio Spurs,-5,116,8:30p,237,New Orleans Pelicans,121
Feb 28 2018,0,Washington Wizards,-8,101,8:00p,210,Golden State Warriors,109
Mar 1 2018,0,Cleveland Cavaliers,-11,97,8:00p,205,Philadelphia 76ers,108
Mar 1 2018,0,Miami Heat,-18,113,7:30p,244,Los Angeles Lakers,131
Mar 1 2018,1,Portland Trail Blazers,9,108,10:30p,207,Minnesota Timberwolves,99
Mar 1 2018,1,Sacramento Kings,5,116,10:00p,227,Brooklyn Nets,111
Mar 2 2018,0,Atlanta Hawks,-5,109,7:30p,223,Golden State Warriors,114
Mar 2 2018,1,Chicago Bulls,8,108,8:00p,208,Dallas Mavericks,100
Mar 2 2018,1,Los Angeles Clippers,23,128,10:30p,233,New York Knicks,105
Mar 2 2018,0,Memphis Grizzlies,-6,102,8:00p,210,Denver Nuggets,108
Mar 2 2018,0,Milwaukee Bucks,-7,96,8:00p,199,Indiana Pacers,103
Mar 2 2018,1,Orlando Magic,9,115,7:00p,221,Detroit Pistons,106
Mar 2 2018,1,Philadelphia 76ers,11,110,7:00p,209,Charlotte Hornets,99
Mar 2 2018,0,Phoenix Suns,-8,116,9:00p,240,Oklahoma City Thunder,124
Mar 2 2018,1,Utah Jazz,8,116,10:30p,224,Minnesota Timberwolves,108
Mar 2 2018,0,Washington Wizards,-7,95,8:00p,197,Toronto Raptors,102
Mar 3 2018,0,Cleveland Cavaliers,-9,117,7:30p,243,Denver Nuggets,126
Mar 3 2018,1,Houston Rockets,3,123,8:30p,243,Boston Celtics,120
Mar 3 2018,1,Miami Heat,9,105,7:30p,201,Detroit Pistons,96
Mar 3 2018,1,Orlando Magic,7,107,7:00p,207,Memphis Grizzlies,100
Mar 3 2018,1,Portland Trail Blazers,8,108,10:00p,208,Oklahoma City Thunder,100
Mar 3 2018,0,Sacramento Kings,-7,91,10:00p,189,Utah Jazz,98
Mar 3 2018,0,San Antonio Spurs,-4,112,9:00p,228,Los Angeles Lakers,116
Mar 4 2018,1,Atlanta Hawks,1,113,3:30p,225,Phoenix Suns,112
Mar 4 2018,0,Dallas Mavericks,-17,109,7:00p,235,New Orleans Pelicans,126
Mar 4 2018,1,Los Angeles Clippers,3,123,9:00p,243,Brooklyn Nets,120
Mar 4 2018,1,Milwaukee Bucks,8,118,8:00p,228,Philadelphia 76ers,110
Mar 4 2018,1,Sacramento Kings,3,102,9:00p,201,New York Knicks,99
Mar 4 2018,1,Toronto Raptors,5,103,6:00p,201,Charlotte Hornets,98
Mar 4 2018,0,Washington Wizards,-3,95,6:00p,193,Indiana Pacers,98
Mar 5 2018,0,Chicago Bulls,-16,89,8:00p,194,Boston Celtics,105
Mar 5 2018,1,Cleveland Cavaliers,22,112,7:00p,202,Detroit Pistons,90
Mar 5 2018,1,Indiana Pacers,3,92,7:00p,181,Milwaukee Bucks,89
Mar 5 2018,0,Los Angeles Lakers,-5,103,10:30p,211,Portland Trail Blazers,108
Mar 5 2018,1,Miami Heat,22,125,7:30p,228,Phoenix Suns,103
Mar 5 2018,1,San Antonio Spurs,2,100,8:30p,198,Memphis Grizzlies,98
Mar 5 2018,1,Utah Jazz,14,94,9:00p,174,Orlando Magic,80
Mar 6 2018,0,Charlotte Hornets,-14,114,7:00p,242,Philadelphia 76ers,128
Mar 6 2018,1,Dallas Mavericks,11,118,8:30p,225,Denver Nuggets,107
Mar 6 2018,1,Golden State Warriors,13,114,10:30p,215,Brooklyn Nets,101
Mar 6 2018,0,Los Angeles Clippers,-5,116,10:30p,237,New Orleans Pelicans,121
Mar 6 2018,0,Oklahoma City Thunder,-10,112,8:00p,234,Houston Rockets,122
Mar 6 2018,1,Portland Trail Blazers,24,111,10:00p,198,New York Knicks,87
Mar 6 2018,1,Toronto Raptors,16,106,7:00p,196,Atlanta Hawks,90
Mar 6 2018,1,Washington Wizards,4,117,7:00p,230,Miami Heat,113
Mar 7 2018,1,Chicago Bulls,9,119,8:00p,229,Memphis Grizzlies,110
Mar 7 2018,0,Denver Nuggets,-5,108,10:30p,221,Cleveland Cavaliers,113
Mar 7 2018,0,Detroit Pistons,-2,119,8:00p,240,Toronto Raptors,121
Mar 7 2018,0,Indiana Pacers,-20,84,7:00p,188,Utah Jazz,104
Mar 7 2018,1,Los Angeles Lakers,1,108,10:30p,215,Orlando Magic,107
Mar 7 2018,0,Milwaukee Bucks,-11,99,8:00p,209,Houston Rockets,110
Mar 7 2018,0,Sacramento Kings,-13,101,10:00p,215,New Orleans Pelicans,114
Mar 8 2018,0,Charlotte Hornets,-14,111,7:00p,236,Brooklyn Nets,125
Mar 8 2018,1,Golden State Warriors,3,110,10:30p,217,San Antonio Spurs,107
Mar 8 2018,1,Miami Heat,9,108,7:30p,207,Philadelphia 76ers,99
Mar 8 2018,0,Minnesota Timberwolves,-8,109,8:00p,226,Boston Celtics,117
Mar 8 2018,1,Oklahoma City Thunder,28,115,8:00p,202,Phoenix Suns,87
Mar 9 2018,1,Denver Nuggets,9,125,9:00p,241,Los Angeles Lakers,116
Mar 9 2018,1,Detroit Pistons,16,99,7:00p,182,Chicago Bulls,83
Mar 9 2018,1,Indiana Pacers,25,112,7:00p,199,Atlanta Hawks,87
Mar 9 2018,1,Los Angeles Clippers,14,116,10:30p,218,Cleveland Cavaliers,102
Mar 9 2018,0,Memphis Grizzlies,-17,78,8:00p,173,Utah Jazz,95
Mar 9 2018,1,Milwaukee Bucks,8,120,8:00p,232,New York Knicks,112
Mar 9 2018,0,New Orleans Pelicans,-19,97,8:00p,213,Washington Wizards,116
Mar 9 2018,1,Portland Trail Blazers,17,125,10:00p,233,Golden State Warriors,108
Mar 9 2018,1,Sacramento Kings,6,94,10:00p,182,Orlando Magic,88
Mar 9 2018,1,Toronto Raptors,3,108,7:30p,213,Houston Rockets,105
Mar 10 2018,1,Charlotte Hornets,7,122,5:00p,237,Phoenix Suns,115
Mar 10 2018,1,Dallas Mavericks,34,114,8:30p,194,Memphis Grizzlies,80
Mar 10 2018,1,Los Angeles Clippers,8,113,10:30p,218,Orlando Magic,105
Mar 10 2018,1,Miami Heat,27,129,7:30p,231,Washington Wizards,102
Mar 10 2018,1,Oklahoma City Thunder,10,104,8:30p,198,San Antonio Spurs,94
Mar 11 2018,0,Atlanta Hawks,-7,122,3:30p,251,Chicago Bulls,129
Mar 11 2018,0,Boston Celtics,-2,97,7:30p,196,Indiana Pacers,99
Mar 11 2018,0,Brooklyn Nets,-23,97,7:30p,217,Philadelphia 76ers,120
Mar 11 2018,0,Dallas Mavericks,-23,82,7:00p,187,Houston Rockets,105
Mar 11 2018,1,Denver Nuggets,26,130,5:00p,234,Sacramento Kings,104
Mar 11 2018,1,Los Angeles Lakers,14,127,9:00p,240,Cleveland Cavaliers,113
Mar 11 2018,1,Minnesota Timberwolves,6,109,3:30p,212,Golden State Warriors,103
Mar 11 2018,0,New Orleans Pelicans,-17,99,4:00p,215,Utah Jazz,116
Mar 11 2018,0,New York Knicks,-26,106,1:00p,238,Toronto Raptors,132
Mar 12 2018,1,Houston Rockets,16,109,8:00p,202,San Antonio Spurs,93
Mar 12 2018,0,Memphis Grizzlies,-18,103,8:00p,224,Milwaukee Bucks,121
Mar 12 2018,1,Oklahoma City Thunder,5,106,8:00p,207,Sacramento Kings,101
Mar 12 2018,1,Portland Trail Blazers,16,115,10:30p,214,Miami Heat,99
Mar 13 2018,0,Atlanta Hawks,-12,107,7:30p,226,Oklahoma City Thunder,119
Mar 13 2018,0,Brooklyn Nets,-14,102,7:30p,218,Toronto Raptors,116
Mar 13 2018,0,Chicago Bulls,-6,106,8:00p,218,Los Angeles Clippers,112
Mar 13 2018,1,Los Angeles Lakers,9,112,10:30p,215,Denver Nuggets,103
Mar 13 2018,1,New Orleans Pelicans,4,119,8:00p,234,Charlotte Hornets,115
Mar 13 2018,0,New York Knicks,-13,97,7:30p,207,Dallas Mavericks,110
Mar 13 2018,0,Philadelphia 76ers,-3,98,7:00p,199,Indiana Pacers,101
Mar 13 2018,0,Phoenix Suns,-22,107,10:00p,236,Cleveland Cavaliers,129
Mar 13 2018,1,San Antonio Spurs,36,108,8:30p,180,Orlando Magic,72
Mar 13 2018,1,Utah Jazz,31,110,9:00p,189,Detroit Pistons,79
Mar 13 2018,0,Washington Wizards,-5,111,7:00p,227,Minnesota Timberwolves,116
Mar 14 2018,0,Boston Celtics,-1,124,8:00p,249,Washington Wizards,125
Mar 14 2018,1,Golden State Warriors,11,117,10:30p,223,Los Angeles Lakers,106
Mar 14 2018,1,Orlando Magic,9,126,7:00p,243,Milwaukee Bucks,117
Mar 14 2018,1,Sacramento Kings,4,123,10:00p,242,Miami Heat,119
Mar 15 2018,0,Atlanta Hawks,-12,117,7:30p,246,Charlotte Hornets,129
Mar 15 2018,1,Denver Nuggets,7,120,9:00p,233,Detroit Pistons,113
Mar 15 2018,1,Houston Rockets,5,101,8:00p,197,Los Angeles Clippers,96
Mar 15 2018,0,Indiana Pacers,-7,99,7:00p,205,Toronto Raptors,106
Mar 15 2018,0,Memphis Grizzlies,-1,110,8:00p,221,Chicago Bulls,111
Mar 15 2018,0,New York Knicks,-8,110,7:30p,228,Philadelphia 76ers,118
Mar 15 2018,1,Portland Trail Blazers,8,113,10:00p,218,Cleveland Cavaliers,105
Mar 15 2018,1,San Antonio Spurs,5,98,8:30p,191,New Orleans Pelicans,93
Mar 15 2018,1,Utah Jazz,28,116,9:00p,204,Phoenix Suns,88
Mar 16 2018,0,Golden State Warriors,-5,93,10:30p,191,Sacramento Kings,98
Mar 16 2018,0,Los Angeles Lakers,-1,91,10:30p,183,Miami Heat,92
Mar 16 2018,1,Oklahoma City Thunder,8,121,8:00p,234,Los Angeles Clippers,113
Mar 16 2018,0,Orlando Magic,-9,83,7:00p,175,Boston Celtics,92
Mar 16 2018,1,Philadelphia 76ers,4,120,7:00p,236,Brooklyn Nets,116
Mar 16 2018,1,Toronto Raptors,7,122,7:30p,237,Dallas Mavericks,115
Mar 17 2018,1,Brooklyn Nets,8,114,7:30p,220,Dallas Mavericks,106
Mar 17 2018,0,Chicago Bulls,-5,109,8:00p,223,Cleveland Cavaliers,114
Mar 17 2018,1,Memphis Grizzlies,7,101,8:00p,195,Denver Nuggets,94
Mar 17 2018,1,Milwaukee Bucks,5,122,6:00p,239,Atlanta Hawks,117
Mar 17 2018,0,New Orleans Pelicans,-6,101,7:00p,208,Houston Rockets,107
Mar 17 2018,1,New York Knicks,23,124,7:30p,225,Charlotte Hornets,101
Mar 17 2018,0,Phoenix Suns,-15,109,10:00p,233,Golden State Warriors,124
Mar 17 2018,1,Portland Trail Blazers,13,100,10:00p,187,Detroit Pistons,87
Mar 17 2018,1,San Antonio Spurs,16,117,8:30p,218,Minnesota Timberwolves,101
Mar 17 2018,1,Utah Jazz,6,103,9:00p,200,Sacramento Kings,97
Mar 17 2018,1,Washington Wizards,7,109,7:00p,211,Indiana Pacers,102
Mar 18 2018,0,Los Angeles Clippers,-13,109,10:30p,231,Portland Trail Blazers,122
Mar 18 2018,0,Minnesota Timberwolves,-9,120,7:00p,249,Houston Rockets,129
Mar 18 2018,1,New Orleans Pelicans,19,108,6:00p,197,Boston Celtics,89
Mar 18 2018,0,Toronto Raptors,-7,125,1:00p,257,Oklahoma City Thunder,132
Mar 19 2018,1,Brooklyn Nets,3,118,7:30p,233,Memphis Grizzlies,115
Mar 19 2018,1,Cleveland Cavaliers,7,124,7:00p,241,Milwaukee Bucks,117
Mar 19 2018,1,Indiana Pacers,10,110,7:00p,210,Los Angeles Lakers,100
Mar 19 2018,1,Miami Heat,8,149,7:30p,290,Denver Nuggets,141
Mar 19 2018,1,New York Knicks,18,110,7:30p,202,Chicago Bulls,92
Mar 19 2018,1,Philadelphia 76ers,14,108,7:00p,202,Charlotte Hornets,94
Mar 19 2018,0,Sacramento Kings,-16,90,10:00p,196,Detroit Pistons,106
Mar 19 2018,1,San Antonio Spurs,14,89,9:30p,164,Golden State Warriors,75
Mar 20 2018,1,Boston Celtics,1,100,8:00p,199,Oklahoma City Thunder,99
Mar 20 2018,1,Minnesota Timberwolves,14,123,8:00p,232,Los Angeles Clippers,109
Mar 20 2018,1,New Orleans Pelicans,10,115,8:00p,220,Dallas Mavericks,105
Mar 20 2018,0,Orlando Magic,-7,86,7:00p,179,Toronto Raptors,93
Mar 20 2018,0,Phoenix Suns,-27,88,10:00p,203,Detroit Pistons,115
Mar 20 2018,0,Portland Trail Blazers,-4,111,10:30p,226,Houston Rockets,115
Mar 20 2018,0,Utah Jazz,-5,94,9:00p,193,Atlanta Hawks,99
Mar 21 2018,0,Brooklyn Nets,-6,105,7:30p,216,Charlotte Hornets,111
Mar 21 2018,0,Chicago Bulls,-33,102,8:00p,237,Denver Nuggets,135
Mar 21 2018,1,Cleveland Cavaliers,3,132,7:00p,261,Toronto Raptors,129
Mar 21 2018,1,Miami Heat,21,119,7:30p,217,New York Knicks,98
Mar 21 2018,0,Milwaukee Bucks,-7,120,8:00p,247,Los Angeles Clippers,127
Mar 21 2018,1,New Orleans Pelicans,4,96,8:00p,188,Indiana Pacers,92
Mar 21 2018,1,Philadelphia 76ers,14,119,7:00p,224,Memphis Grizzlies,105
Mar 21 2018,1,San Antonio Spurs,8,98,9:30p,188,Washington Wizards,90
Mar 22 2018,1,Charlotte Hornets,61,140,7:00p,219,Memphis Grizzlies,79
Mar 22 2018,0,Dallas Mavericks,-7,112,8:30p,231,Utah Jazz,119
Mar 22 2018,1,Houston Rockets,4,100,8:00p,196,Detroit Pistons,96
Mar 22 2018,1,New Orleans Pelicans,3,128,8:00p,253,Los Angeles Lakers,125
Mar 22 2018,0,Orlando Magic,-20,98,7:00p,216,Philadelphia 76ers,118
Mar 22 2018,1,Sacramento Kings,15,105,10:00p,195,Atlanta Hawks,90
Mar 23 2018,0,Chicago Bulls,-13,105,8:00p,223,Milwaukee Bucks,118
Mar 23 2018,1,Cleveland Cavaliers,25,120,7:30p,215,Phoenix Suns,95
Mar 23 2018,1,Golden State Warriors,12,106,10:30p,200,Atlanta Hawks,94
Mar 23 2018,1,Indiana Pacers,5,109,7:00p,213,Los Angeles Clippers,104
Mar 23 2018,0,New York Knicks,-4,104,7:30p,212,Minnesota Timberwolves,108
Mar 23 2018,1,Oklahoma City Thunder,6,105,8:00p,204,Miami Heat,99
Mar 23 2018,0,Portland Trail Blazers,-5,100,10:00p,205,Boston Celtics,105
Mar 23 2018,1,San Antonio Spurs,4,124,8:30p,244,Utah Jazz,120
Mar 23 2018,1,Toronto Raptors,4,116,7:30p,228,Brooklyn Nets,112
Mar 23 2018,0,Washington Wizards,-8,100,7:00p,208,Denver Nuggets,108
Mar 24 2018,0,Dallas Mavericks,-4,98,8:30p,200,Charlotte Hornets,102
Mar 24 2018,1,Detroit Pistons,22,117,7:00p,212,Chicago Bulls,95
Mar 24 2018,1,Houston Rockets,23,114,8:00p,205,New Orleans Pelicans,91
Mar 24 2018,0,Memphis Grizzlies,-7,93,8:00p,193,Los Angeles Lakers,100
Mar 24 2018,1,Orlando Magic,6,105,7:00p,204,Phoenix Suns,99
Mar 24 2018,1,Philadelphia 76ers,12,120,6:00p,228,Minnesota Timberwolves,108
Mar 25 2018,0,Brooklyn Nets,-7,114,1:00p,235,Cleveland Cavaliers,121
Mar 25 2018,0,Golden State Warriors,-19,91,8:30p,201,Utah Jazz,110
Mar 25 2018,1,Houston Rockets,19,118,8:00p,217,Atlanta Hawks,99
Mar 25 2018,1,Indiana Pacers,6,113,5:00p,220,Miami Heat,107
Mar 25 2018,1,Milwaukee Bucks,3,106,3:30p,209,San Antonio Spurs,103
Mar 25 2018,0,Oklahoma City Thunder,-3,105,7:00p,213,Portland Trail Blazers,108
Mar 25 2018,0,Sacramento Kings,-11,93,6:00p,197,Boston Celtics,104
Mar 25 2018,0,Toronto Raptors,-11,106,6:00p,223,Los Angeles Clippers,117
Mar 25 2018,0,Washington Wizards,-4,97,6:00p,198,New York Knicks,101
Mar 26 2018,1,Charlotte Hornets,9,137,7:00p,265,New York Knicks,128
Mar 26 2018,1,Detroit Pistons,6,112,7:00p,218,Los Angeles Lakers,106
Mar 26 2018,0,Minnesota Timberwolves,-8,93,8:00p,194,Memphis Grizzlies,101
Mar 26 2018,1,Philadelphia 76ers,19,123,7:00p,227,Denver Nuggets,104
Mar 26 2018,0,Phoenix Suns,-8,94,10:00p,196,Boston Celtics,102
Mar 27 2018,0,Golden State Warriors,-11,81,10:30p,173,Indiana Pacers,92
Mar 27 2018,1,Houston Rockets,32,118,8:00p,204,Chicago Bulls,86
Mar 27 2018,1,Los Angeles Clippers,7,105,10:30p,203,Milwaukee Bucks,98
Mar 27 2018,1,Miami Heat,19,98,8:00p,177,Cleveland Cavaliers,79
Mar 27 2018,0,New Orleans Pelicans,-4,103,8:00p,210,Portland Trail Blazers,107
Mar 27 2018,0,Sacramento Kings,-6,97,10:00p,200,Dallas Mavericks,103
Mar 27 2018,1,Toronto Raptors,4,114,7:30p,224,Denver Nuggets,110
Mar 27 2018,1,Washington Wizards,10,116,7:00p,222,San Antonio Spurs,106
Mar 28 2018,0,Charlotte Hornets,-13,105,7:00p,223,Cleveland Cavaliers,118
Mar 28 2018,1,Los Angeles Lakers,10,103,10:30p,196,Dallas Mavericks,93
Mar 28 2018,1,Memphis Grizzlies,5,108,8:00p,211,Portland Trail Blazers,103
Mar 28 2018,1,Minnesota Timberwolves,12,126,8:00p,240,Atlanta Hawks,114
Mar 28 2018,0,Orlando Magic,-7,104,7:00p,215,Brooklyn Nets,111
Mar 28 2018,1,Philadelphia 76ers,17,118,7:00p,219,New York Knicks,101
Mar 28 2018,0,Phoenix Suns,-12,99,10:00p,210,Los Angeles Clippers,111
Mar 28 2018,0,Utah Jazz,-3,94,9:30p,191,Boston Celtics,97
Mar 29 2018,1,Detroit Pistons,11,103,7:00p,195,Washington Wizards,92
Mar 29 2018,0,Golden State Warriors,-9,107,10:30p,223,Milwaukee Bucks,116
Mar 29 2018,1,Miami Heat,11,103,7:30p,195,Chicago Bulls,92
Mar 29 2018,0,Sacramento Kings,-3,103,10:00p,209,Indiana Pacers,106
Mar 29 2018,1,San Antonio Spurs,4,103,8:00p,202,Oklahoma City Thunder,99
Mar 30 2018,0,Atlanta Hawks,-10,91,7:30p,192,Philadelphia 76ers,101
Mar 30 2018,1,Cleveland Cavaliers,5,107,8:00p,209,New Orleans Pelicans,102
Mar 30 2018,0,Dallas Mavericks,-1,92,8:30p,185,Minnesota Timberwolves,93
Mar 30 2018,1,Houston Rockets,1,104,8:00p,207,Phoenix Suns,103
Mar 30 2018,0,Los Angeles Lakers,-2,122,10:30p,246,Milwaukee Bucks,124
Mar 30 2018,0,Oklahoma City Thunder,-1,125,8:00p,251,Denver Nuggets,126
Mar 30 2018,0,Orlando Magic,-8,82,7:00p,172,Chicago Bulls,90
Mar 30 2018,1,Portland Trail Blazers,9,105,10:30p,201,Los Angeles Clippers,96
Mar 30 2018,1,Utah Jazz,10,107,9:00p,204,Memphis Grizzlies,97
Mar 31 2018,1,Boston Celtics,11,110,7:30p,209,Toronto Raptors,99
Mar 31 2018,0,Miami Heat,-1,109,8:00p,219,Brooklyn Nets,110
Mar 31 2018,0,New York Knicks,-6,109,5:00p,224,Detroit Pistons,115
Mar 31 2018,0,Sacramento Kings,-16,96,10:00p,208,Golden State Warriors,112
Mar 31 2018,1,Washington Wizards,14,107,3:00p,200,Charlotte Hornets,93
Oct 25 2016,1,Cleveland Cavaliers,29,117,7:30p,205,New York Knicks,88
Oct 25 2016,0,Golden State Warriors,-29,100,10:30p,229,San Antonio Spurs,129
Oct 25 2016,1,Portland Trail Blazers,9,113,10:00p,217,Utah Jazz,104
Oct 26 2016,1,Boston Celtics,5,122,7:30p,239,Brooklyn Nets,117
Oct 26 2016,1,Indiana Pacers,9,130,7:00p,251,Dallas Mavericks,121
Oct 26 2016,1,Los Angeles Lakers,6,120,10:30p,234,Houston Rockets,114
Oct 26 2016,1,Memphis Grizzlies,4,102,8:00p,200,Minnesota Timberwolves,98
Oct 26 2016,0,Milwaukee Bucks,-11,96,8:00p,203,Charlotte Hornets,107
Oct 26 2016,0,New Orleans Pelicans,-5,102,8:00p,209,Denver Nuggets,107
Oct 26 2016,0,Orlando Magic,-12,96,7:00p,204,Miami Heat,108
Oct 26 2016,0,Philadelphia 76ers,-6,97,8:00p,200,Oklahoma City Thunder,103
Oct 26 2016,0,Phoenix Suns,-19,94,10:00p,207,Sacramento Kings,113
Oct 26 2016,1,Toronto Raptors,18,109,7:30p,200,Detroit Pistons,91
Oct 27 2016,1,Atlanta Hawks,15,114,7:30p,213,Washington Wizards,99
Oct 27 2016,1,Chicago Bulls,6,105,8:00p,204,Boston Celtics,99
Oct 27 2016,0,Portland Trail Blazers,-8,106,10:30p,220,Los Angeles Clippers,114
Oct 27 2016,0,Sacramento Kings,-8,94,10:30p,196,San Antonio Spurs,102
Oct 28 2016,1,Brooklyn Nets,9,103,7:30p,197,Indiana Pacers,94
Oct 28 2016,0,Dallas Mavericks,-8,98,8:30p,204,Houston Rockets,106
Oct 28 2016,1,Detroit Pistons,26,108,7:30p,190,Orlando Magic,82
Oct 28 2016,0,Miami Heat,-6,91,8:00p,188,Charlotte Hornets,97
Oct 28 2016,0,New Orleans Pelicans,-8,114,9:30p,236,Golden State Warriors,122
Oct 28 2016,1,Oklahoma City Thunder,3,113,8:00p,223,Phoenix Suns,110
Oct 28 2016,0,Toronto Raptors,-3,91,7:00p,185,Cleveland Cavaliers,94
Oct 28 2016,1,Utah Jazz,7,96,9:00p,185,Los Angeles Lakers,89
Oct 29 2016,1,Chicago Bulls,17,118,8:00p,219,Indiana Pacers,101
Oct 29 2016,0,Charlotte Hornets,-6,98,7:00p,202,Boston Celtics,104
Oct 29 2016,1,Cleveland Cavaliers,6,105,7:30p,204,Orlando Magic,99
Oct 29 2016,0,Denver Nuggets,-2,113,9:00p,228,Portland Trail Blazers,115
Oct 29 2016,1,Milwaukee Bucks,2,110,8:00p,218,Brooklyn Nets,108
Oct 29 2016,1,New York Knicks,7,111,7:30p,215,Memphis Grizzlies,104
Oct 29 2016,0,Philadelphia 76ers,-32,72,12:30p,176,Atlanta Hawks,104
Oct 29 2016,1,Sacramento Kings,3,106,10:30p,209,Minnesota Timberwolves,103
Oct 29 2016,1,San Antonio Spurs,19,98,8:00p,177,New Orleans Pelicans,79
Oct 30 2016,1,Detroit Pistons,15,98,6:00p,181,Milwaukee Bucks,83
Oct 30 2016,1,Houston Rockets,1,93,8:00p,185,Dallas Mavericks,92
Oct 30 2016,1,Los Angeles Clippers,13,88,4:30p,163,Utah Jazz,75
Oct 30 2016,1,Memphis Grizzlies,9,112,8:00p,215,Washington Wizards,103
Oct 30 2016,0,Miami Heat,-7,99,6:00p,205,San Antonio Spurs,106
Oct 30 2016,1,Oklahoma City Thunder,17,113,7:00p,209,Los Angeles Lakers,96
Oct 30 2016,0,Phoenix Suns,-6,100,6:00p,206,Golden State Warriors,106
Oct 31 2016,1,Atlanta Hawks,11,106,7:30p,201,Sacramento Kings,95
Oct 31 2016,0,Brooklyn Nets,-30,88,7:30p,206,Chicago Bulls,118
Oct 31 2016,1,Los Angeles Clippers,18,116,10:30p,214,Phoenix Suns,98
Oct 31 2016,1,Toronto Raptors,3,105,7:30p,207,Denver Nuggets,102
Nov 1 2016,1,Cleveland Cavaliers,8,128,6:00p,248,Houston Rockets,120
Nov 1 2016,1,Detroit Pistons,13,102,7:30p,191,New York Knicks,89
Nov 1 2016,1,Indiana Pacers,7,115,7:00p,223,Los Angeles Lakers,108
Nov 1 2016,1,Miami Heat,12,108,7:30p,204,Sacramento Kings,96
Nov 1 2016,1,Minnesota Timberwolves,36,116,8:00p,196,Memphis Grizzlies,80
Nov 1 2016,0,New Orleans Pelicans,-4,113,8:00p,230,Milwaukee Bucks,117
Nov 1 2016,0,Philadelphia 76ers,-2,101,7:00p,204,Orlando Magic,103
Nov 1 2016,0,Portland Trail Blazers,-23,104,10:00p,231,Golden State Warriors,127
Nov 1 2016,0,San Antonio Spurs,-15,91,8:30p,197,Utah Jazz,106
Nov 2 2016,0,Atlanta Hawks,-7,116,7:30p,239,Los Angeles Lakers,123
Nov 2 2016,1,Boston Celtics,7,107,8:00p,207,Chicago Bulls,100
Nov 2 2016,1,Brooklyn Nets,8,109,7:30p,210,Detroit Pistons,101
Nov 2 2016,1,Charlotte Hornets,16,109,7:00p,202,Philadelphia 76ers,93
Nov 2 2016,0,Los Angeles Clippers,-2,83,10:30p,168,Oklahoma City Thunder,85
Nov 2 2016,1,Memphis Grizzlies,6,89,8:00p,172,New Orleans Pelicans,83
Nov 2 2016,0,New York Knicks,-19,99,7:30p,217,Houston Rockets,118
Nov 2 2016,1,Phoenix Suns,3,118,10:00p,233,Portland Trail Blazers,115
Nov 2 2016,1,Utah Jazz,16,97,9:00p,178,Dallas Mavericks,81
Nov 2 2016,0,Washington Wizards,-10,103,7:00p,216,Toronto Raptors,113
Nov 3 2016,1,Cleveland Cavaliers,6,128,8:00p,250,Boston Celtics,122
Nov 3 2016,1,Golden State Warriors,26,122,10:30p,218,Oklahoma City Thunder,96
Nov 3 2016,1,Milwaukee Bucks,18,125,8:00p,232,Indiana Pacers,107
Nov 3 2016,0,Minnesota Timberwolves,-3,99,8:00p,201,Denver Nuggets,102
Nov 3 2016,1,Orlando Magic,8,102,7:00p,196,Sacramento Kings,94
Nov 4 2016,0,Brooklyn Nets,-4,95,7:30p,194,Charlotte Hornets,99
Nov 4 2016,0,Chicago Bulls,-13,104,8:00p,221,New York Knicks,117
Nov 4 2016,0,Dallas Mavericks,-10,95,8:30p,200,Portland Trail Blazers,105
Nov 4 2016,1,Los Angeles Lakers,20,117,10:30p,214,Golden State Warriors,97
Nov 4 2016,0,Memphis Grizzlies,-11,88,8:00p,187,Los Angeles Clippers,99
Nov 4 2016,0,New Orleans Pelicans,-1,111,8:00p,223,Phoenix Suns,112
Nov 4 2016,1,Toronto Raptors,9,96,7:30p,183,Miami Heat,87
Nov 4 2016,0,Utah Jazz,-14,86,9:00p,186,San Antonio Spurs,100
Nov 4 2016,1,Washington Wizards,3,95,7:00p,187,Atlanta Hawks,92
Nov 5 2016,1,Atlanta Hawks,15,112,7:30p,209,Houston Rockets,97
Nov 5 2016,1,Detroit Pistons,17,103,7:00p,189,Denver Nuggets,86
Nov 5 2016,1,Indiana Pacers,17,111,7:00p,205,Chicago Bulls,94
Nov 5 2016,1,Milwaukee Bucks,26,117,8:00p,208,Sacramento Kings,91
Nov 5 2016,1,Oklahoma City Thunder,20,112,6:00p,204,Minnesota Timberwolves,92
Nov 5 2016,1,Orlando Magic,2,88,7:00p,174,Washington Wizards,86
Nov 5 2016,0,Philadelphia 76ers,-1,101,7:00p,203,Cleveland Cavaliers,102
Nov 5 2016,0,San Antonio Spurs,-24,92,8:30p,208,Los Angeles Clippers,116
Nov 6 2016,0,Boston Celtics,-16,107,7:30p,230,Denver Nuggets,123
Nov 6 2016,1,Dallas Mavericks,11,86,7:00p,161,Milwaukee Bucks,75
Nov 6 2016,1,Los Angeles Lakers,11,119,9:30p,227,Phoenix Suns,108
Nov 6 2016,0,Memphis Grizzlies,-6,94,3:30p,194,Portland Trail Blazers,100
Nov 6 2016,0,New York Knicks,-5,109,12:00p,223,Utah Jazz,114
Nov 6 2016,0,Toronto Raptors,-5,91,6:00p,187,Sacramento Kings,96
Nov 7 2016,1,Chicago Bulls,32,112,8:00p,192,Orlando Magic,80
Nov 7 2016,1,Charlotte Hornets,22,122,7:00p,222,Indiana Pacers,100
Nov 7 2016,1,Golden State Warriors,10,116,10:30p,222,New Orleans Pelicans,106
Nov 7 2016,1,Los Angeles Clippers,32,114,10:30p,196,Detroit Pistons,82
Nov 7 2016,1,Oklahoma City Thunder,12,97,8:00p,182,Miami Heat,85
Nov 7 2016,0,Philadelphia 76ers,-25,84,7:00p,193,Utah Jazz,109
Nov 7 2016,0,Washington Wizards,-8,106,7:00p,220,Houston Rockets,114
Nov 8 2016,1,Brooklyn Nets,9,119,7:30p,229,Minnesota Timberwolves,110
Nov 8 2016,0,Cleveland Cavaliers,-4,106,7:00p,216,Atlanta Hawks,110
Nov 8 2016,0,Los Angeles Lakers,-12,97,10:30p,206,Dallas Mavericks,109
Nov 8 2016,1,Memphis Grizzlies,1,108,8:00p,215,Denver Nuggets,107
Nov 8 2016,1,Portland Trail Blazers,3,124,10:00p,245,Phoenix Suns,121
Nov 8 2016,1,Sacramento Kings,8,102,10:30p,196,New Orleans Pelicans,94
Nov 9 2016,1,Atlanta Hawks,8,115,7:30p,222,Chicago Bulls,107
Nov 9 2016,1,Charlotte Hornets,6,104,7:00p,202,Utah Jazz,98
Nov 9 2016,1,Golden State Warriors,21,116,10:30p,211,Dallas Mavericks,95
Nov 9 2016,1,Indiana Pacers,7,122,7:00p,237,Philadelphia 76ers,115
Nov 9 2016,1,Los Angeles Clippers,31,111,10:30p,191,Portland Trail Blazers,80
Nov 9 2016,1,New York Knicks,14,110,7:00p,206,Brooklyn Nets,96
Nov 9 2016,0,Oklahoma City Thunder,-10,102,8:00p,214,Toronto Raptors,112
Nov 9 2016,0,Orlando Magic,-16,107,7:00p,230,Minnesota Timberwolves,123
Nov 9 2016,1,Phoenix Suns,7,107,9:00p,207,Detroit Pistons,100
Nov 9 2016,0,San Antonio Spurs,-2,99,9:30p,200,Houston Rockets,101
Nov 9 2016,1,Washington Wizards,25,118,7:00p,211,Boston Celtics,93
Nov 10 2016,0,Denver Nuggets,-24,101,9:00p,226,Golden State Warriors,125
Nov 10 2016,0,Miami Heat,-3,95,8:00p,193,Chicago Bulls,98
Nov 10 2016,0,Milwaukee Bucks,-6,106,8:00p,218,New Orleans Pelicans,112
Nov 10 2016,0,Sacramento Kings,-10,91,10:30p,192,Los Angeles Lakers,101
Nov 11 2016,1,Boston Celtics,28,115,7:30p,202,New York Knicks,87
Nov 11 2016,0,Charlotte Hornets,-2,111,7:00p,224,Toronto Raptors,113
Nov 11 2016,0,Oklahoma City Thunder,-2,108,8:00p,218,Los Angeles Clippers,110
Nov 11 2016,0,Orlando Magic,-13,74,7:00p,161,Utah Jazz,87
Nov 11 2016,1,Philadelphia 76ers,4,109,7:00p,214,Indiana Pacers,105
Nov 11 2016,1,Portland Trail Blazers,2,122,10:00p,242,Sacramento Kings,120
Nov 11 2016,1,San Antonio Spurs,10,96,8:30p,182,Detroit Pistons,86
Nov 11 2016,0,Washington Wizards,-11,94,7:00p,199,Cleveland Cavaliers,105
Nov 12 2016,1,Atlanta Hawks,21,117,7:30p,213,Philadelphia 76ers,96
Nov 12 2016,1,Chicago Bulls,11,106,8:00p,201,Washington Wizards,95
Nov 12 2016,0,Denver Nuggets,-11,95,9:00p,201,Detroit Pistons,106
Nov 12 2016,0,Houston Rockets,-6,100,8:00p,206,San Antonio Spurs,106
Nov 12 2016,0,Indiana Pacers,-6,99,7:00p,204,Boston Celtics,105
Nov 12 2016,0,Miami Heat,-11,91,8:00p,193,Utah Jazz,102
Nov 12 2016,1,Milwaukee Bucks,10,106,8:30p,202,Memphis Grizzlies,96
Nov 12 2016,0,Minnesota Timberwolves,-14,105,8:00p,224,Los Angeles Clippers,119
Nov 12 2016,0,New Orleans Pelicans,-27,99,7:00p,225,Los Angeles Lakers,126
Nov 12 2016,0,Phoenix Suns,-18,104,9:00p,226,Brooklyn Nets,122
Nov 12 2016,1,Toronto Raptors,11,118,7:30p,225,New York Knicks,107
Nov 13 2016,1,Cleveland Cavaliers,7,100,3:30p,193,Charlotte Hornets,93
Nov 13 2016,1,Golden State Warriors,13,133,8:00p,253,Phoenix Suns,120
Nov 13 2016,1,Minnesota Timberwolves,26,125,7:00p,224,Los Angeles Lakers,99
Nov 13 2016,0,Oklahoma City Thunder,-2,117,7:00p,236,Orlando Magic,119
Nov 13 2016,1,Portland Trail Blazers,7,112,9:00p,217,Denver Nuggets,105
Nov 14 2016,1,Detroit Pistons,16,104,7:30p,192,Oklahoma City Thunder,88
Nov 14 2016,1,Houston Rockets,27,115,8:00p,203,Philadelphia 76ers,88
Nov 14 2016,1,Indiana Pacers,19,88,7:00p,157,Orlando Magic,69
Nov 14 2016,1,Los Angeles Clippers,32,127,10:30p,222,Brooklyn Nets,95
Nov 14 2016,1,New Orleans Pelicans,1,106,8:00p,211,Boston Celtics,105
Nov 14 2016,1,New York Knicks,16,93,7:30p,170,Dallas Mavericks,77
Nov 14 2016,1,San Antonio Spurs,4,94,8:30p,184,Miami Heat,90
Nov 14 2016,0,Utah Jazz,-6,96,9:00p,198,Memphis Grizzlies,102
Nov 15 2016,1,Cleveland Cavaliers,4,121,7:00p,238,Toronto Raptors,117
Nov 15 2016,1,Los Angeles Lakers,7,125,10:30p,243,Brooklyn Nets,118
Nov 15 2016,0,Miami Heat,-3,90,7:30p,183,Atlanta Hawks,93
Nov 15 2016,0,Minnesota Timberwolves,-7,108,8:00p,223,Charlotte Hornets,115
Nov 15 2016,0,Portland Trail Blazers,-25,88,10:00p,201,Chicago Bulls,113
Nov 16 2016,1,Atlanta Hawks,7,107,7:30p,207,Milwaukee Bucks,100
Nov 16 2016,1,Boston Celtics,7,90,7:30p,173,Dallas Mavericks,83
Nov 16 2016,1,Denver Nuggets,16,120,9:00p,224,Phoenix Suns,104
Nov 16 2016,1,Indiana Pacers,10,103,7:00p,196,Cleveland Cavaliers,93
Nov 16 2016,0,Los Angeles Clippers,-4,107,10:30p,218,Memphis Grizzlies,111
Nov 16 2016,1,New York Knicks,3,105,7:30p,207,Detroit Pistons,102
Nov 16 2016,1,Oklahoma City Thunder,2,105,8:00p,208,Houston Rockets,103
Nov 16 2016,1,Orlando Magic,7,89,7:00p,171,New Orleans Pelicans,82
Nov 16 2016,1,Philadelphia 76ers,7,109,7:00p,211,Washington Wizards,102
Nov 16 2016,0,Sacramento Kings,-5,105,10:30p,215,San Antonio Spurs,110
Nov 16 2016,0,Toronto Raptors,-6,121,8:00p,248,Golden State Warriors,127
Nov 17 2016,1,Houston Rockets,17,126,8:00p,235,Portland Trail Blazers,109
Nov 17 2016,1,Miami Heat,23,96,7:30p,169,Milwaukee Bucks,73
Nov 17 2016,1,Minnesota Timberwolves,24,110,8:00p,196,Philadelphia 76ers,86
Nov 17 2016,0,Utah Jazz,-8,77,10:30p,162,Chicago Bulls,85
Nov 17 2016,1,Washington Wizards,7,119,7:00p,231,New York Knicks,112
Nov 18 2016,0,Boston Celtics,-16,88,8:00p,192,Golden State Warriors,104
Nov 18 2016,1,Charlotte Hornets,4,100,7:00p,196,Atlanta Hawks,96
Nov 18 2016,1,Cleveland Cavaliers,23,104,7:30p,185,Detroit Pistons,81
Nov 18 2016,0,Dallas Mavericks,-16,64,8:30p,144,Memphis Grizzlies,80
Nov 18 2016,0,Denver Nuggets,-2,111,9:00p,224,Toronto Raptors,113
Nov 18 2016,0,Indiana Pacers,-20,96,7:00p,212,Phoenix Suns,116
Nov 18 2016,0,Los Angeles Lakers,-9,107,10:30p,223,San Antonio Spurs,116
Nov 18 2016,1,New Orleans Pelicans,12,113,8:00p,214,Portland Trail Blazers,101
Nov 18 2016,1,Oklahoma City Thunder,19,124,8:00p,229,Brooklyn Nets,105
Nov 18 2016,0,Sacramento Kings,-6,115,10:30p,236,Los Angeles Clippers,121
Nov 19 2016,0,Detroit Pistons,-2,92,7:00p,186,Boston Celtics,94
Nov 19 2016,1,Houston Rockets,9,111,5:00p,213,Utah Jazz,102
Nov 19 2016,1,Los Angeles Clippers,7,102,10:30p,197,Chicago Bulls,95
Nov 19 2016,1,Memphis Grizzlies,22,93,8:00p,164,Minnesota Timberwolves,71
Nov 19 2016,0,Milwaukee Bucks,-3,121,8:30p,245,Golden State Warriors,124
Nov 19 2016,1,New Orleans Pelicans,5,121,7:00p,237,Charlotte Hornets,116
Nov 19 2016,1,Orlando Magic,8,95,7:00p,182,Dallas Mavericks,87
Nov 19 2016,1,Philadelphia 76ers,15,120,7:30p,225,Phoenix Suns,105
Nov 19 2016,0,Washington Wizards,-3,111,7:00p,225,Miami Heat,114
Nov 20 2016,0,Brooklyn Nets,-20,109,3:30p,238,Portland Trail Blazers,129
Nov 20 2016,1,Denver Nuggets,14,105,9:00p,196,Utah Jazz,91
Nov 20 2016,0,Los Angeles Lakers,-8,110,9:30p,228,Chicago Bulls,118
Nov 20 2016,1,New York Knicks,10,104,12:00p,198,Atlanta Hawks,94
Nov 20 2016,0,Oklahoma City Thunder,-4,111,7:00p,226,Indiana Pacers,115
Nov 20 2016,1,Sacramento Kings,3,102,9:00p,201,Toronto Raptors,99
Nov 21 2016,0,Charlotte Hornets,-15,90,7:00p,195,Memphis Grizzlies,105
Nov 21 2016,0,Detroit Pistons,-3,96,7:30p,195,Houston Rockets,99
Nov 21 2016,0,Indiana Pacers,-37,83,7:00p,203,Golden State Warriors,120
Nov 21 2016,1,Los Angeles Clippers,8,123,10:30p,238,Toronto Raptors,115
Nov 21 2016,1,Milwaukee Bucks,4,93,8:00p,182,Orlando Magic,89
Nov 21 2016,0,Minnesota Timberwolves,-6,93,8:00p,192,Boston Celtics,99
Nov 21 2016,1,Philadelphia 76ers,7,101,7:00p,195,Miami Heat,94
Nov 21 2016,1,San Antonio Spurs,5,96,8:30p,187,Dallas Mavericks,91
Nov 21 2016,1,Washington Wizards,5,106,7:00p,207,Phoenix Suns,101
Nov 22 2016,0,Atlanta Hawks,-18,94,7:30p,206,New Orleans Pelicans,112
Nov 22 2016,1,Denver Nuggets,3,110,9:00p,217,Chicago Bulls,107
Nov 22 2016,1,Los Angeles Lakers,2,111,10:30p,220,Oklahoma City Thunder,109
Nov 22 2016,1,New York Knicks,4,107,7:30p,210,Portland Trail Blazers,103
Nov 23 2016,0,Brooklyn Nets,-19,92,7:30p,203,Boston Celtics,111
Nov 23 2016,0,Charlotte Hornets,-5,114,7:00p,233,San Antonio Spurs,119
Nov 23 2016,1,Cleveland Cavaliers,12,137,7:00p,262,Portland Trail Blazers,125
Nov 23 2016,0,Dallas Mavericks,-20,104,8:30p,228,Los Angeles Clippers,124
Nov 23 2016,1,Detroit Pistons,23,107,7:30p,191,Miami Heat,84
Nov 23 2016,1,Golden State Warriors,43,149,10:30p,255,Los Angeles Lakers,106
Nov 23 2016,0,Houston Rockets,-13,102,8:00p,217,Toronto Raptors,115
Nov 23 2016,0,Indiana Pacers,-11,85,7:00p,181,Atlanta Hawks,96
Nov 23 2016,1,New Orleans Pelicans,21,117,9:30p,213,Minnesota Timberwolves,96
Nov 23 2016,0,Orlando Magic,-5,87,7:00p,179,Phoenix Suns,92
Nov 23 2016,0,Philadelphia 76ers,-5,99,7:00p,203,Memphis Grizzlies,104
Nov 23 2016,1,Sacramento Kings,15,116,10:30p,217,Oklahoma City Thunder,101
Nov 23 2016,1,Utah Jazz,25,108,9:00p,191,Denver Nuggets,83
Nov 25 2016,0,Boston Celtics,-6,103,1:00p,212,San Antonio Spurs,109
Nov 25 2016,1,Cleveland Cavaliers,38,128,7:30p,218,Dallas Mavericks,90
Nov 25 2016,0,Denver Nuggets,-3,129,9:00p,261,Oklahoma City Thunder,132
Nov 25 2016,1,Detroit Pistons,11,108,7:30p,205,Los Angeles Clippers,97
Nov 25 2016,1,Indiana Pacers,21,118,8:00p,215,Brooklyn Nets,97
Nov 25 2016,0,Los Angeles Lakers,-24,85,10:30p,194,Golden State Warriors,109
Nov 25 2016,0,Memphis Grizzlies,-9,81,8:00p,171,Miami Heat,90
Nov 25 2016,0,Milwaukee Bucks,-6,99,8:00p,204,Toronto Raptors,105
Nov 25 2016,1,New York Knicks,2,113,7:30p,224,Charlotte Hornets,111
Nov 25 2016,0,Orlando Magic,-3,91,7:00p,185,Washington Wizards,94
Nov 25 2016,0,Philadelphia 76ers,-16,89,7:30p,194,Chicago Bulls,105
Nov 25 2016,0,Phoenix Suns,-13,85,9:00p,183,Minnesota Timberwolves,98
Nov 25 2016,1,Portland Trail Blazers,15,119,10:00p,223,New Orleans Pelicans,104
Nov 25 2016,0,Sacramento Kings,-13,104,10:30p,221,Houston Rockets,117
Nov 25 2016,1,Utah Jazz,27,95,8:00p,163,Atlanta Hawks,68
Nov 26 2016,1,Charlotte Hornets,5,107,7:00p,209,New York Knicks,102
Nov 26 2016,1,Golden State Warriors,13,115,10:30p,217,Minnesota Timberwolves,102
Nov 26 2016,0,Miami Heat,-3,107,8:00p,217,Memphis Grizzlies,110
Nov 26 2016,1,Oklahoma City Thunder,18,106,8:00p,194,Detroit Pistons,88
Nov 26 2016,0,Washington Wizards,-12,100,7:00p,212,San Antonio Spurs,112
Nov 27 2016,0,Brooklyn Nets,-17,105,6:00p,227,Sacramento Kings,122
Nov 27 2016,1,Dallas Mavericks,10,91,7:00p,172,New Orleans Pelicans,81
Nov 27 2016,1,Indiana Pacers,21,91,6:00p,161,Los Angeles Clippers,70
Nov 27 2016,1,Los Angeles Lakers,15,109,9:30p,203,Atlanta Hawks,94
Nov 27 2016,0,Orlando Magic,-8,96,6:00p,200,Milwaukee Bucks,104
Nov 27 2016,0,Philadelphia 76ers,-4,108,1:00p,220,Cleveland Cavaliers,112
Nov 27 2016,0,Phoenix Suns,-6,114,3:30p,234,Denver Nuggets,120
Nov 27 2016,0,Portland Trail Blazers,-16,114,9:00p,244,Houston Rockets,130
Nov 28 2016,1,Golden State Warriors,5,105,10:30p,205,Atlanta Hawks,100
Nov 28 2016,0,Memphis Grizzlies,-19,85,8:00p,189,Charlotte Hornets,104
Nov 28 2016,0,Miami Heat,-8,104,7:30p,216,Boston Celtics,112
Nov 28 2016,0,Minnesota Timberwolves,-9,103,8:00p,215,Utah Jazz,112
Nov 28 2016,0,New York Knicks,-9,103,7:30p,215,Oklahoma City Thunder,112
Nov 28 2016,1,Toronto Raptors,27,122,7:30p,217,Philadelphia 76ers,95
Nov 28 2016,1,Washington Wizards,6,101,7:00p,196,Sacramento Kings,95
Nov 29 2016,1,Brooklyn Nets,5,127,7:30p,249,Los Angeles Clippers,122
Nov 29 2016,0,Charlotte Hornets,-23,89,7:00p,201,Detroit Pistons,112
Nov 29 2016,1,Milwaukee Bucks,17,118,8:00p,219,Cleveland Cavaliers,101
Nov 29 2016,1,New Orleans Pelicans,17,105,8:00p,193,Los Angeles Lakers,88
Nov 29 2016,0,San Antonio Spurs,-12,83,8:30p,178,Orlando Magic,95
Nov 29 2016,1,Utah Jazz,19,120,9:00p,221,Houston Rockets,101
Nov 30 2016,0,Boston Celtics,-7,114,7:30p,235,Detroit Pistons,121
Nov 30 2016,0,Chicago Bulls,-6,90,8:00p,186,Los Angeles Lakers,96
Nov 30 2016,0,Dallas Mavericks,-7,87,8:30p,181,San Antonio Spurs,94
Nov 30 2016,0,Denver Nuggets,-8,98,9:00p,204,Miami Heat,106
Nov 30 2016,0,Minnesota Timberwolves,-2,104,8:00p,210,New York Knicks,106
Nov 30 2016,1,Oklahoma City Thunder,11,126,8:00p,241,Washington Wizards,115
Nov 30 2016,1,Phoenix Suns,2,109,9:00p,216,Atlanta Hawks,107
Nov 30 2016,1,Portland Trail Blazers,22,131,10:00p,240,Indiana Pacers,109
Nov 30 2016,1,Toronto Raptors,15,120,7:30p,225,Memphis Grizzlies,105
Dec 1 2016,0,Brooklyn Nets,-18,93,7:30p,204,Milwaukee Bucks,111
Dec 1 2016,1,Charlotte Hornets,10,97,7:00p,184,Dallas Mavericks,87
Dec 1 2016,0,Cleveland Cavaliers,-19,94,8:00p,207,Los Angeles Clippers,113
Dec 1 2016,0,Golden State Warriors,-5,127,10:30p,259,Houston Rockets,132
Dec 1 2016,1,Memphis Grizzlies,1,95,8:00p,189,Orlando Magic,94
Dec 1 2016,0,Utah Jazz,-1,110,9:00p,221,Miami Heat,111
Dec 2 2016,0,Atlanta Hawks,-36,85,8:00p,206,Detroit Pistons,121
Dec 2 2016,1,Boston Celtics,5,97,7:30p,189,Sacramento Kings,92
Dec 2 2016,1,Chicago Bulls,6,111,8:00p,216,Cleveland Cavaliers,105
Dec 2 2016,0,Denver Nuggets,-18,110,10:30p,238,Houston Rockets,128
Dec 2 2016,0,New Orleans Pelicans,-18,96,8:00p,210,Los Angeles Clippers,114
Dec 2 2016,1,New York Knicks,4,118,7:30p,232,Minnesota Timberwolves,114
Dec 2 2016,0,Philadelphia 76ers,-17,88,7:00p,193,Orlando Magic,105
Dec 2 2016,1,San Antonio Spurs,2,107,8:30p,212,Washington Wizards,105
Dec 2 2016,1,Toronto Raptors,33,113,7:30p,193,Los Angeles Lakers,80
Dec 3 2016,0,Charlotte Hornets,-5,120,7:00p,245,Minnesota Timberwolves,125
Dec 3 2016,1,Dallas Mavericks,25,107,8:30p,189,Chicago Bulls,82
Dec 3 2016,1,Golden State Warriors,29,138,10:30p,247,Phoenix Suns,109
Dec 3 2016,1,Memphis Grizzlies,3,103,8:00p,203,Los Angeles Lakers,100
Dec 3 2016,1,Milwaukee Bucks,9,112,5:00p,215,Brooklyn Nets,103
Dec 3 2016,0,Philadelphia 76ers,-1,106,7:30p,213,Boston Celtics,107
Dec 3 2016,1,Portland Trail Blazers,7,99,10:00p,191,Miami Heat,92
Dec 3 2016,1,Toronto Raptors,44,128,7:30p,212,Atlanta Hawks,84
Dec 3 2016,1,Utah Jazz,7,105,9:00p,203,Denver Nuggets,98
Dec 4 2016,0,Detroit Pistons,-6,92,6:00p,190,Orlando Magic,98
Dec 4 2016,0,Los Angeles Clippers,-9,102,9:30p,213,Indiana Pacers,111
Dec 4 2016,1,New York Knicks,8,106,7:30p,204,Sacramento Kings,98
Dec 4 2016,1,Oklahoma City Thunder,9,101,7:00p,193,New Orleans Pelicans,92
Dec 5 2016,0,Atlanta Hawks,-3,99,7:30p,201,Oklahoma City Thunder,102
Dec 5 2016,0,Brooklyn Nets,-5,113,7:30p,231,Washington Wizards,118
Dec 5 2016,0,Chicago Bulls,-2,110,8:00p,222,Portland Trail Blazers,112
Dec 5 2016,0,Dallas Mavericks,-8,101,8:30p,210,Charlotte Hornets,109
Dec 5 2016,1,Golden State Warriors,36,142,10:30p,248,Indiana Pacers,106
Dec 5 2016,1,Houston Rockets,1,107,8:00p,213,Boston Celtics,106
Dec 5 2016,0,Los Angeles Lakers,-6,101,10:30p,208,Utah Jazz,107
Dec 5 2016,0,Milwaukee Bucks,-1,96,8:00p,193,San Antonio Spurs,97
Dec 5 2016,0,New Orleans Pelicans,-2,108,8:00p,218,Memphis Grizzlies,110
Dec 5 2016,0,Philadelphia 76ers,-8,98,7:00p,204,Denver Nuggets,106
Dec 5 2016,0,Toronto Raptors,-4,112,7:30p,228,Cleveland Cavaliers,116
Dec 6 2016,1,Detroit Pistons,11,102,7:30p,193,Chicago Bulls,91
Dec 6 2016,1,Memphis Grizzlies,5,96,8:00p,187,Philadelphia 76ers,91
Dec 6 2016,0,Miami Heat,-11,103,7:30p,217,New York Knicks,114
Dec 6 2016,0,Minnesota Timberwolves,-14,91,8:00p,196,San Antonio Spurs,105
Dec 6 2016,1,Utah Jazz,7,112,9:00p,217,Phoenix Suns,105
Dec 6 2016,0,Washington Wizards,-8,116,7:00p,240,Orlando Magic,124
Dec 7 2016,1,Atlanta Hawks,8,103,7:30p,198,Miami Heat,95
Dec 7 2016,1,Brooklyn Nets,5,116,7:30p,227,Denver Nuggets,111
Dec 7 2016,1,Charlotte Hornets,10,87,7:00p,164,Detroit Pistons,77
Dec 7 2016,0,Dallas Mavericks,-31,89,8:30p,209,Sacramento Kings,120
Dec 7 2016,1,Houston Rockets,39,134,8:00p,229,Los Angeles Lakers,95
Dec 7 2016,0,Los Angeles Clippers,-17,98,10:30p,213,Golden State Warriors,115
Dec 7 2016,1,Milwaukee Bucks,8,115,8:00p,222,Portland Trail Blazers,107
Dec 7 2016,0,New York Knicks,-32,94,8:00p,220,Cleveland Cavaliers,126
Dec 7 2016,0,Orlando Magic,-30,87,7:00p,204,Boston Celtics,117
Dec 7 2016,0,Phoenix Suns,-15,94,9:00p,203,Indiana Pacers,109
Dec 8 2016,1,Chicago Bulls,4,95,9:30p,186,San Antonio Spurs,91
Dec 8 2016,1,Memphis Grizzlies,2,88,8:00p,174,Portland Trail Blazers,86
Dec 8 2016,0,New Orleans Pelicans,-11,88,8:00p,187,Philadelphia 76ers,99
Dec 8 2016,1,Toronto Raptors,14,124,7:00p,234,Minnesota Timberwolves,110
Dec 8 2016,0,Utah Jazz,-7,99,9:00p,205,Golden State Warriors,106
Dec 8 2016,1,Washington Wizards,7,92,7:00p,177,Denver Nuggets,85
Dec 9 2016,0,Boston Celtics,-7,94,7:30p,195,Toronto Raptors,101
Dec 9 2016,1,Charlotte Hornets,21,109,7:00p,197,Orlando Magic,88
Dec 9 2016,1,Cleveland Cavaliers,30,114,7:30p,198,Miami Heat,84
Dec 9 2016,1,Dallas Mavericks,8,111,8:30p,214,Indiana Pacers,103
Dec 9 2016,0,Los Angeles Lakers,-4,115,10:30p,234,Phoenix Suns,119
Dec 9 2016,0,Milwaukee Bucks,-4,110,8:00p,224,Atlanta Hawks,114
Dec 9 2016,0,Minnesota Timberwolves,-27,90,8:00p,207,Detroit Pistons,117
Dec 9 2016,0,Oklahoma City Thunder,-3,99,8:00p,201,Houston Rockets,102
Dec 9 2016,0,Sacramento Kings,-3,100,10:30p,203,New York Knicks,103
Dec 10 2016,1,Chicago Bulls,5,105,8:00p,205,Miami Heat,100
Dec 10 2016,1,Cleveland Cavaliers,11,116,7:30p,221,Charlotte Hornets,105
Dec 10 2016,1,Houston Rockets,22,109,8:00p,196,Dallas Mavericks,87
Dec 10 2016,1,Indiana Pacers,7,118,7:00p,229,Portland Trail Blazers,111
Dec 10 2016,1,Los Angeles Clippers,28,133,10:30p,238,New Orleans Pelicans,105
Dec 10 2016,1,Memphis Grizzlies,21,110,8:00p,199,Golden State Warriors,89
Dec 10 2016,0,Orlando Magic,-8,113,7:00p,234,Denver Nuggets,121
Dec 10 2016,1,San Antonio Spurs,29,130,8:30p,231,Brooklyn Nets,101
Dec 10 2016,1,Utah Jazz,20,104,9:00p,188,Sacramento Kings,84
Dec 10 2016,1,Washington Wizards,5,110,7:00p,215,Milwaukee Bucks,105
Dec 11 2016,0,Detroit Pistons,-18,79,6:00p,176,Philadelphia 76ers,97
Dec 11 2016,0,Los Angeles Lakers,-6,112,9:30p,230,New York Knicks,118
Dec 11 2016,0,Minnesota Timberwolves,-8,108,7:00p,224,Golden State Warriors,116
Dec 11 2016,1,Oklahoma City Thunder,3,99,7:00p,195,Boston Celtics,96
Dec 11 2016,0,Phoenix Suns,-1,119,8:30p,239,New Orleans Pelicans,120
Dec 12 2016,1,Dallas Mavericks,20,112,8:30p,204,Denver Nuggets,92
Dec 12 2016,1,Houston Rockets,4,122,8:00p,240,Brooklyn Nets,118
Dec 12 2016,1,Indiana Pacers,16,110,7:00p,204,Charlotte Hornets,94
Dec 12 2016,1,Los Angeles Clippers,1,121,10:30p,241,Portland Trail Blazers,120
Dec 12 2016,1,Miami Heat,11,112,7:30p,213,Washington Wizards,101
Dec 12 2016,1,Sacramento Kings,24,116,10:30p,208,Los Angeles Lakers,92
Dec 12 2016,1,Toronto Raptors,22,122,7:30p,222,Milwaukee Bucks,100
Dec 13 2016,0,Atlanta Hawks,-11,120,7:30p,251,Orlando Magic,131
Dec 13 2016,0,Chicago Bulls,-5,94,8:00p,193,Minnesota Timberwolves,99
Dec 13 2016,1,Cleveland Cavaliers,17,103,7:00p,189,Memphis Grizzlies,86
Dec 13 2016,0,New Orleans Pelicans,-4,109,8:00p,222,Golden State Warriors,113
Dec 13 2016,1,Phoenix Suns,2,113,9:00p,224,New York Knicks,111
Dec 13 2016,1,Portland Trail Blazers,19,114,10:30p,209,Oklahoma City Thunder,95
Dec 14 2016,1,Brooklyn Nets,10,107,7:30p,204,Los Angeles Lakers,97
Dec 14 2016,0,Dallas Mavericks,-10,85,8:30p,180,Detroit Pistons,95
Dec 14 2016,1,Houston Rockets,34,132,8:00p,230,Sacramento Kings,98
Dec 14 2016,1,Memphis Grizzlies,8,93,8:00p,178,Cleveland Cavaliers,85
Dec 14 2016,1,Miami Heat,6,95,7:00p,184,Indiana Pacers,89
Dec 14 2016,0,Orlando Magic,-5,108,7:00p,221,Los Angeles Clippers,113
Dec 14 2016,0,Philadelphia 76ers,-9,114,7:00p,237,Toronto Raptors,123
Dec 14 2016,1,San Antonio Spurs,7,108,9:30p,209,Boston Celtics,101
Dec 14 2016,1,Utah Jazz,20,109,9:00p,198,Oklahoma City Thunder,89
Dec 14 2016,1,Washington Wizards,3,109,7:00p,215,Charlotte Hornets,106
Dec 15 2016,1,Denver Nuggets,12,132,9:00p,252,Portland Trail Blazers,120
Dec 15 2016,1,Golden State Warriors,13,103,10:30p,193,New York Knicks,90
Dec 15 2016,1,Milwaukee Bucks,11,108,8:00p,205,Chicago Bulls,97
Dec 15 2016,1,New Orleans Pelicans,7,102,8:00p,197,Indiana Pacers,95
Dec 15 2016,0,Phoenix Suns,-15,92,9:00p,199,San Antonio Spurs,107
Dec 16 2016,1,Boston Celtics,8,96,7:30p,184,Charlotte Hornets,88
Dec 16 2016,0,Chicago Bulls,-26,69,8:00p,164,Milwaukee Bucks,95
Dec 16 2016,1,Houston Rockets,22,122,8:00p,222,New Orleans Pelicans,100
Dec 16 2016,0,Memphis Grizzlies,-4,92,8:00p,188,Sacramento Kings,96
Dec 16 2016,0,Miami Heat,-4,98,8:00p,200,Los Angeles Clippers,102
Dec 16 2016,1,Orlando Magic,7,118,7:00p,229,Brooklyn Nets,111
Dec 16 2016,0,Philadelphia 76ers,-11,89,8:00p,189,Los Angeles Lakers,100
Dec 16 2016,0,Toronto Raptors,-4,121,7:30p,246,Atlanta Hawks,125
Dec 16 2016,1,Utah Jazz,3,103,10:30p,203,Dallas Mavericks,100
Dec 16 2016,1,Washington Wizards,14,122,7:00p,230,Detroit Pistons,108
Dec 17 2016,0,Atlanta Hawks,-8,99,7:30p,206,Charlotte Hornets,107
Dec 17 2016,1,Cleveland Cavaliers,11,119,7:30p,227,Los Angeles Lakers,108
Dec 17 2016,1,Denver Nuggets,13,127,9:00p,241,New York Knicks,114
Dec 17 2016,0,Detroit Pistons,-15,90,7:00p,195,Indiana Pacers,105
Dec 17 2016,1,Golden State Warriors,45,135,10:30p,225,Portland Trail Blazers,90
Dec 17 2016,0,Minnesota Timberwolves,-2,109,8:00p,220,Houston Rockets,111
Dec 17 2016,1,Oklahoma City Thunder,13,114,5:00p,215,Phoenix Suns,101
Dec 18 2016,1,Dallas Mavericks,20,99,4:00p,178,Sacramento Kings,79
Dec 18 2016,0,Memphis Grizzlies,-9,73,6:00p,155,Utah Jazz,82
Dec 18 2016,0,Miami Heat,-10,95,6:00p,200,Boston Celtics,105
Dec 18 2016,0,Orlando Magic,-30,79,6:00p,188,Toronto Raptors,109
Dec 18 2016,1,Philadelphia 76ers,1,108,6:00p,215,Brooklyn Nets,107
Dec 18 2016,1,San Antonio Spurs,13,113,7:00p,213,New Orleans Pelicans,100
Dec 18 2016,1,Washington Wizards,7,117,3:30p,227,Los Angeles Clippers,110
Dec 19 2016,1,Chicago Bulls,31,113,8:00p,195,Detroit Pistons,82
Dec 19 2016,1,Denver Nuggets,10,117,9:00p,224,Dallas Mavericks,107
Dec 19 2016,1,Indiana Pacers,2,107,7:00p,212,Washington Wizards,105
Dec 19 2016,1,Minnesota Timberwolves,7,115,8:00p,223,Phoenix Suns,108
Dec 19 2016,0,Oklahoma City Thunder,-2,108,8:00p,218,Atlanta Hawks,110
Dec 20 2016,1,Charlotte Hornets,4,117,7:00p,230,Los Angeles Lakers,113
Dec 20 2016,1,Golden State Warriors,30,104,10:30p,178,Utah Jazz,74
Dec 20 2016,0,Houston Rockets,-2,100,8:00p,202,San Antonio Spurs,102
Dec 20 2016,1,Los Angeles Clippers,17,119,10:30p,221,Denver Nuggets,102
Dec 20 2016,0,Memphis Grizzlies,-3,109,8:00p,221,Boston Celtics,112
Dec 20 2016,0,Miami Heat,-6,130,7:30p,266,Orlando Magic,136
Dec 20 2016,0,Milwaukee Bucks,-6,108,8:00p,222,Cleveland Cavaliers,114
Dec 20 2016,1,New York Knicks,7,118,7:30p,229,Indiana Pacers,111
Dec 20 2016,0,Philadelphia 76ers,-15,93,7:00p,201,New Orleans Pelicans,108
Dec 20 2016,1,Sacramento Kings,5,126,10:30p,247,Portland Trail Blazers,121
Dec 20 2016,1,Toronto Raptors,12,116,7:30p,220,Brooklyn Nets,104
Dec 21 2016,0,Atlanta Hawks,-8,84,7:30p,176,Minnesota Timberwolves,92
Dec 21 2016,0,Chicago Bulls,-10,97,8:00p,204,Washington Wizards,107
Dec 21 2016,1,Cleveland Cavaliers,11,113,7:00p,215,Milwaukee Bucks,102
Dec 21 2016,0,Detroit Pistons,-12,86,7:30p,184,Memphis Grizzlies,98
Dec 21 2016,0,New Orleans Pelicans,-11,110,8:00p,231,Oklahoma City Thunder,121
Dec 21 2016,0,Phoenix Suns,-14,111,9:00p,236,Houston Rockets,125
Dec 21 2016,0,Portland Trail Blazers,-1,95,10:00p,191,Dallas Mavericks,96
Dec 21 2016,0,Utah Jazz,-1,93,9:00p,187,Sacramento Kings,94
Dec 22 2016,0,Brooklyn Nets,-16,101,7:30p,218,Golden State Warriors,117
Dec 22 2016,0,Indiana Pacers,-7,102,7:00p,211,Boston Celtics,109
Dec 22 2016,1,Los Angeles Clippers,5,106,10:30p,207,San Antonio Spurs,101
Dec 22 2016,1,Miami Heat,8,115,8:00p,222,Los Angeles Lakers,107
Dec 22 2016,1,New York Knicks,11,106,7:30p,201,Orlando Magic,95
Dec 23 2016,0,Boston Celtics,-5,112,7:30p,229,Oklahoma City Thunder,117
Dec 23 2016,1,Charlotte Hornets,12,103,7:00p,194,Chicago Bulls,91
Dec 23 2016,1,Cleveland Cavaliers,20,119,7:30p,218,Brooklyn Nets,99
Dec 23 2016,0,Denver Nuggets,-1,108,9:00p,217,Atlanta Hawks,109
Dec 23 2016,0,Detroit Pistons,-6,113,7:30p,232,Golden State Warriors,119
Dec 23 2016,0,Los Angeles Clippers,-2,88,10:30p,178,Dallas Mavericks,90
Dec 23 2016,1,Memphis Grizzlies,6,115,8:00p,224,Houston Rockets,109
Dec 23 2016,1,Milwaukee Bucks,27,123,8:00p,219,Washington Wizards,96
Dec 23 2016,0,Minnesota Timberwolves,-4,105,8:00p,214,Sacramento Kings,109
Dec 23 2016,1,New Orleans Pelicans,4,91,8:00p,178,Miami Heat,87
Dec 23 2016,1,Orlando Magic,19,109,7:00p,199,Los Angeles Lakers,90
Dec 23 2016,1,Phoenix Suns,7,123,9:00p,239,Philadelphia 76ers,116
Dec 23 2016,0,Portland Trail Blazers,-20,90,10:00p,200,San Antonio Spurs,110
Dec 23 2016,0,Utah Jazz,-6,98,9:00p,202,Toronto Raptors,104
Dec 25 2016,1,Cleveland Cavaliers,1,109,2:30p,217,Golden State Warriors,108
Dec 25 2016,1,Los Angeles Lakers,9,111,10:30p,213,Los Angeles Clippers,102
Dec 25 2016,0,New York Knicks,-5,114,12:00p,233,Boston Celtics,119
Dec 25 2016,1,Oklahoma City Thunder,12,112,8:00p,212,Minnesota Timberwolves,100
Dec 25 2016,1,San Antonio Spurs,19,119,5:00p,219,Chicago Bulls,100
Dec 26 2016,1,Brooklyn Nets,2,120,7:30p,238,Charlotte Hornets,118
Dec 26 2016,1,Chicago Bulls,5,90,8:00p,175,Indiana Pacers,85
Dec 26 2016,1,Detroit Pistons,16,106,7:30p,196,Cleveland Cavaliers,90
Dec 26 2016,1,Houston Rockets,16,131,8:00p,246,Phoenix Suns,115
Dec 26 2016,0,Los Angeles Clippers,-4,102,10:30p,208,Denver Nuggets,106
Dec 26 2016,1,Minnesota Timberwolves,14,104,8:00p,194,Atlanta Hawks,90
Dec 26 2016,1,New Orleans Pelicans,7,111,8:00p,215,Dallas Mavericks,104
Dec 26 2016,1,Orlando Magic,10,112,7:00p,214,Memphis Grizzlies,102
Dec 26 2016,0,Portland Trail Blazers,-4,91,10:00p,186,Toronto Raptors,95
Dec 26 2016,1,Sacramento Kings,2,102,10:30p,202,Philadelphia 76ers,100
Dec 26 2016,1,Washington Wizards,5,107,7:00p,209,Milwaukee Bucks,102
Dec 27 2016,1,Boston Celtics,10,113,7:30p,216,Memphis Grizzlies,103
Dec 27 2016,0,Dallas Mavericks,-16,107,8:30p,230,Houston Rockets,123
Dec 27 2016,0,Los Angeles Lakers,-2,100,10:30p,202,Utah Jazz,102
Dec 27 2016,0,Miami Heat,-12,94,7:30p,200,Oklahoma City Thunder,106
Dec 28 2016,1,Atlanta Hawks,4,102,7:30p,200,New York Knicks,98
Dec 28 2016,1,Chicago Bulls,2,101,8:00p,200,Brooklyn Nets,99
Dec 28 2016,1,Denver Nuggets,2,105,9:00p,208,Minnesota Timberwolves,103
Dec 28 2016,0,Detroit Pistons,-25,94,7:30p,213,Milwaukee Bucks,119
Dec 28 2016,1,Golden State Warriors,10,121,10:30p,232,Toronto Raptors,111
Dec 28 2016,1,New Orleans Pelicans,4,102,8:00p,200,Los Angeles Clippers,98
Dec 28 2016,0,Orlando Magic,-19,101,7:00p,221,Charlotte Hornets,120
Dec 28 2016,1,Portland Trail Blazers,13,102,10:00p,191,Sacramento Kings,89
Dec 28 2016,1,San Antonio Spurs,21,119,8:30p,217,Phoenix Suns,98
Dec 28 2016,1,Washington Wizards,6,111,7:00p,216,Indiana Pacers,105
Dec 29 2016,1,Charlotte Hornets,9,91,7:00p,173,Miami Heat,82
Dec 29 2016,1,Cleveland Cavaliers,6,124,8:00p,242,Boston Celtics,118
Dec 29 2016,0,Los Angeles Lakers,-12,89,10:30p,190,Dallas Mavericks,101
Dec 29 2016,1,Memphis Grizzlies,34,114,8:00p,194,Oklahoma City Thunder,80
Dec 29 2016,1,Phoenix Suns,8,99,9:00p,190,Toronto Raptors,91
Dec 29 2016,1,Utah Jazz,17,100,9:00p,183,Philadelphia 76ers,83
Dec 30 2016,1,Atlanta Hawks,7,105,8:00p,203,Detroit Pistons,98
Dec 30 2016,1,Boston Celtics,3,117,7:30p,231,Miami Heat,114
Dec 30 2016,0,Denver Nuggets,-2,122,9:00p,246,Philadelphia 76ers,124
Dec 30 2016,1,Golden State Warriors,9,108,10:30p,207,Dallas Mavericks,99
Dec 30 2016,1,Houston Rockets,24,140,8:00p,256,Los Angeles Clippers,116
Dec 30 2016,1,Indiana Pacers,10,111,4:00p,212,Chicago Bulls,101
Dec 30 2016,1,Minnesota Timberwolves,17,116,8:00p,215,Milwaukee Bucks,99
Dec 30 2016,1,New Orleans Pelicans,12,104,8:00p,196,New York Knicks,92
Dec 30 2016,1,San Antonio Spurs,16,110,8:30p,204,Portland Trail Blazers,94
Dec 30 2016,1,Washington Wizards,23,118,7:00p,213,Brooklyn Nets,95
Dec 31 2016,0,Chicago Bulls,-20,96,7:00p,212,Milwaukee Bucks,116
Dec 31 2016,0,Charlotte Hornets,-12,109,7:00p,230,Cleveland Cavaliers,121
Dec 31 2016,1,Houston Rockets,7,129,8:00p,251,New York Knicks,122
Dec 31 2016,1,Oklahoma City Thunder,26,114,8:00p,202,Los Angeles Clippers,88
Dec 31 2016,0,Sacramento Kings,-14,98,5:00p,210,Memphis Grizzlies,112
Dec 31 2016,1,Utah Jazz,5,91,8:00p,177,Phoenix Suns,86
Jan 1 2017,1,Atlanta Hawks,2,114,6:00p,226,San Antonio Spurs,112
Jan 1 2017,1,Indiana Pacers,13,117,6:00p,221,Orlando Magic,104
Jan 1 2017,0,Los Angeles Lakers,-9,114,9:30p,237,Toronto Raptors,123
Jan 1 2017,0,Miami Heat,-9,98,6:00p,205,Detroit Pistons,107
Jan 1 2017,0,Minnesota Timberwolves,-6,89,7:00p,184,Portland Trail Blazers,95
Jan 2 2017,0,Brooklyn Nets,-12,89,7:30p,190,Utah Jazz,101
Jan 2 2017,1,Chicago Bulls,7,118,8:00p,229,Charlotte Hornets,111
Jan 2 2017,1,Cleveland Cavaliers,8,90,7:00p,172,New Orleans Pelicans,82
Jan 2 2017,1,Golden State Warriors,8,127,10:30p,246,Denver Nuggets,119
Jan 2 2017,1,Houston Rockets,10,101,8:00p,192,Washington Wizards,91
Jan 2 2017,1,Los Angeles Clippers,11,109,10:30p,207,Phoenix Suns,98
Jan 2 2017,1,Milwaukee Bucks,4,98,7:00p,192,Oklahoma City Thunder,94
Jan 2 2017,0,New York Knicks,-12,103,7:30p,218,Orlando Magic,115
Jan 3 2017,1,Boston Celtics,11,115,7:30p,219,Utah Jazz,104
Jan 3 2017,1,Dallas Mavericks,8,113,8:30p,218,Washington Wizards,105
Jan 3 2017,0,Denver Nuggets,-7,113,9:00p,233,Sacramento Kings,120
Jan 3 2017,0,Detroit Pistons,-5,116,7:30p,237,Indiana Pacers,121
Jan 3 2017,1,Los Angeles Lakers,14,116,10:30p,218,Memphis Grizzlies,102
Jan 3 2017,1,Philadelphia 76ers,2,93,7:00p,184,Minnesota Timberwolves,91
Jan 3 2017,1,Phoenix Suns,9,99,9:00p,189,Miami Heat,90
Jan 3 2017,1,San Antonio Spurs,28,110,8:30p,192,Toronto Raptors,82
Jan 4 2017,1,Charlotte Hornets,11,123,7:00p,235,Oklahoma City Thunder,112
Jan 4 2017,0,Cleveland Cavaliers,-12,94,8:00p,200,Chicago Bulls,106
Jan 4 2017,1,Golden State Warriors,8,125,10:30p,242,Portland Trail Blazers,117
Jan 4 2017,1,Los Angeles Clippers,9,115,10:30p,221,Memphis Grizzlies,106
Jan 4 2017,0,New York Knicks,-1,104,7:30p,209,Milwaukee Bucks,105
Jan 4 2017,0,Orlando Magic,-19,92,7:00p,203,Atlanta Hawks,111
Jan 4 2017,0,Sacramento Kings,-5,102,10:30p,209,Miami Heat,107
Jan 5 2017,0,Dallas Mavericks,-7,95,8:30p,197,Phoenix Suns,102
Jan 5 2017,0,Denver Nuggets,-28,99,9:00p,226,San Antonio Spurs,127
Jan 5 2017,1,Detroit Pistons,1,115,7:30p,229,Charlotte Hornets,114
Jan 5 2017,1,Houston Rockets,2,118,8:00p,234,Oklahoma City Thunder,116
Jan 5 2017,1,Indiana Pacers,12,121,7:00p,230,Brooklyn Nets,109
Jan 5 2017,0,New Orleans Pelicans,-5,94,8:00p,193,Atlanta Hawks,99
Jan 5 2017,1,Portland Trail Blazers,9,118,10:30p,227,Los Angeles Lakers,109
Jan 5 2017,1,Toronto Raptors,8,101,7:30p,194,Utah Jazz,93
Jan 6 2017,1,Boston Celtics,4,110,7:30p,216,Philadelphia 76ers,106
Jan 6 2017,0,Brooklyn Nets,-8,108,7:30p,224,Cleveland Cavaliers,116
Jan 6 2017,0,Golden State Warriors,-9,119,10:30p,247,Memphis Grizzlies,128
Jan 6 2017,1,Los Angeles Lakers,27,127,10:30p,227,Miami Heat,100
Jan 6 2017,0,Milwaukee Bucks,-5,111,8:00p,227,New York Knicks,116
Jan 6 2017,0,Orlando Magic,-7,93,7:00p,193,Houston Rockets,100
Jan 6 2017,0,Sacramento Kings,-8,98,10:30p,204,Los Angeles Clippers,106
Jan 6 2017,1,Washington Wizards,7,112,7:00p,217,Minnesota Timberwolves,105
Jan 7 2017,1,Boston Celtics,9,117,7:30p,225,New Orleans Pelicans,108
Jan 7 2017,1,Chicago Bulls,5,123,8:00p,241,Toronto Raptors,118
Jan 7 2017,0,Dallas Mavericks,-15,82,8:30p,179,Atlanta Hawks,97
Jan 7 2017,1,Indiana Pacers,14,123,7:00p,232,New York Knicks,109
Jan 7 2017,0,Minnesota Timberwolves,-2,92,8:00p,186,Utah Jazz,94
Jan 7 2017,1,Oklahoma City Thunder,15,121,8:00p,227,Denver Nuggets,106
Jan 7 2017,1,San Antonio Spurs,17,102,8:30p,187,Charlotte Hornets,85
Jan 8 2017,0,Brooklyn Nets,-10,95,12:00p,200,Philadelphia 76ers,105
Jan 8 2017,1,Los Angeles Clippers,12,98,3:30p,184,Miami Heat,86
Jan 8 2017,1,Los Angeles Lakers,16,111,9:30p,206,Orlando Magic,95
Jan 8 2017,1,Memphis Grizzlies,9,88,8:00p,167,Utah Jazz,79
Jan 8 2017,0,Milwaukee Bucks,-6,101,2:00p,208,Washington Wizards,107
Jan 8 2017,0,Phoenix Suns,-4,116,8:30p,236,Cleveland Cavaliers,120
Jan 8 2017,0,Portland Trail Blazers,-1,124,9:00p,249,Detroit Pistons,125
Jan 8 2017,0,Sacramento Kings,-11,106,9:00p,223,Golden State Warriors,117
Jan 8 2017,0,Toronto Raptors,-7,122,6:00p,251,Houston Rockets,129
Jan 9 2017,0,Chicago Bulls,-15,94,8:00p,203,Oklahoma City Thunder,109
Jan 9 2017,1,Minnesota Timberwolves,9,101,8:00p,193,Dallas Mavericks,92
Jan 9 2017,0,New York Knicks,-14,96,7:30p,206,New Orleans Pelicans,110
Jan 10 2017,0,Brooklyn Nets,-20,97,7:30p,214,Atlanta Hawks,117
Jan 10 2017,1,Golden State Warriors,12,107,10:30p,202,Miami Heat,95
Jan 10 2017,1,Houston Rockets,7,121,8:00p,235,Charlotte Hornets,114
Jan 10 2017,0,Los Angeles Lakers,-21,87,10:30p,195,Portland Trail Blazers,108
Jan 10 2017,1,Sacramento Kings,6,100,10:30p,194,Detroit Pistons,94
Jan 10 2017,0,San Antonio Spurs,-2,107,8:30p,216,Milwaukee Bucks,109
Jan 10 2017,1,Toronto Raptors,8,114,7:30p,220,Boston Celtics,106
Jan 10 2017,1,Utah Jazz,8,100,9:00p,192,Cleveland Cavaliers,92
Jan 10 2017,1,Washington Wizards,2,101,7:00p,200,Chicago Bulls,99
Jan 11 2017,1,Boston Celtics,9,117,8:00p,225,Washington Wizards,108
Jan 11 2017,1,Los Angeles Clippers,9,105,10:30p,201,Orlando Magic,96
Jan 11 2017,1,Minnesota Timberwolves,14,119,8:00p,224,Houston Rockets,105
Jan 11 2017,1,Oklahoma City Thunder,8,103,8:00p,198,Memphis Grizzlies,95
Jan 11 2017,1,Philadelphia 76ers,1,98,7:00p,195,New York Knicks,97
Jan 11 2017,1,Portland Trail Blazers,16,102,10:30p,188,Cleveland Cavaliers,86
Jan 12 2017,0,Brooklyn Nets,-9,95,7:30p,199,New Orleans Pelicans,104
Jan 12 2017,1,Denver Nuggets,28,140,3:00p,252,Indiana Pacers,112
Jan 12 2017,1,Golden State Warriors,20,127,10:30p,234,Detroit Pistons,107
Jan 12 2017,1,New York Knicks,15,104,8:00p,193,Chicago Bulls,89
Jan 12 2017,0,Phoenix Suns,-5,108,10:00p,221,Dallas Mavericks,113
Jan 12 2017,1,San Antonio Spurs,40,134,8:30p,228,Los Angeles Lakers,94
Jan 13 2017,0,Atlanta Hawks,-2,101,8:00p,204,Boston Celtics,103
Jan 13 2017,0,Houston Rockets,-5,105,8:00p,215,Memphis Grizzlies,110
Jan 13 2017,1,Milwaukee Bucks,8,116,8:00p,224,Miami Heat,108
Jan 13 2017,1,Minnesota Timberwolves,10,96,8:00p,182,Oklahoma City Thunder,86
Jan 13 2017,1,Philadelphia 76ers,9,102,7:00p,195,Charlotte Hornets,93
Jan 13 2017,0,Portland Trail Blazers,-6,109,10:00p,224,Orlando Magic,115
Jan 13 2017,0,Sacramento Kings,-12,108,10:30p,228,Cleveland Cavaliers,120
Jan 13 2017,1,Toronto Raptors,19,132,7:30p,245,Brooklyn Nets,113
Jan 13 2017,1,Utah Jazz,33,110,10:30p,187,Detroit Pistons,77
Jan 14 2017,1,Chicago Bulls,8,107,5:00p,206,New Orleans Pelicans,99
Jan 14 2017,1,Los Angeles Clippers,16,113,3:30p,210,Los Angeles Lakers,97
Jan 14 2017,1,Phoenix Suns,3,108,6:00p,213,San Antonio Spurs,105
Jan 14 2017,1,Utah Jazz,7,114,9:00p,221,Orlando Magic,107
Jan 14 2017,1,Washington Wizards,16,109,8:00p,202,Philadelphia 76ers,93
Jan 15 2017,1,Atlanta Hawks,13,111,3:00p,209,Milwaukee Bucks,98
Jan 15 2017,0,Brooklyn Nets,-25,112,6:00p,249,Houston Rockets,137
Jan 15 2017,1,Dallas Mavericks,11,98,2:00p,185,Minnesota Timberwolves,87
Jan 15 2017,0,Los Angeles Lakers,-5,97,9:30p,199,Detroit Pistons,102
Jan 15 2017,0,Memphis Grizzlies,-4,104,9:00p,212,Chicago Bulls,108
Jan 15 2017,0,Sacramento Kings,-4,118,9:00p,240,Oklahoma City Thunder,122
Jan 15 2017,1,Toronto Raptors,15,116,3:00p,217,New York Knicks,101
Jan 16 2017,1,Boston Celtics,10,108,7:30p,206,Charlotte Hornets,98
Jan 16 2017,1,Denver Nuggets,13,125,5:00p,237,Orlando Magic,112
Jan 16 2017,1,Golden State Warriors,35,126,8:00p,217,Cleveland Cavaliers,91
Jan 16 2017,1,Indiana Pacers,3,98,4:00p,193,New Orleans Pelicans,95
Jan 16 2017,1,Los Angeles Clippers,22,120,10:30p,218,Oklahoma City Thunder,98
Jan 16 2017,0,Milwaukee Bucks,-9,104,3:30p,217,Philadelphia 76ers,113
Jan 16 2017,0,New York Knicks,-1,107,1:00p,215,Atlanta Hawks,108
Jan 16 2017,0,Phoenix Suns,-5,101,9:00p,207,Utah Jazz,106
Jan 16 2017,1,Washington Wizards,19,120,2:00p,221,Portland Trail Blazers,101
Jan 17 2017,0,Brooklyn Nets,-10,109,7:30p,228,Toronto Raptors,119
Jan 17 2017,0,Chicago Bulls,-1,98,8:00p,197,Dallas Mavericks,99
Jan 17 2017,0,Los Angeles Lakers,-6,121,10:30p,248,Denver Nuggets,127
Jan 17 2017,1,Miami Heat,6,109,7:30p,212,Houston Rockets,103
Jan 17 2017,1,San Antonio Spurs,8,122,8:30p,236,Minnesota Timberwolves,114
Jan 18 2017,0,Boston Celtics,-11,106,7:30p,223,New York Knicks,117
Jan 18 2017,1,Charlotte Hornets,22,107,7:00p,192,Portland Trail Blazers,85
Jan 18 2017,1,Detroit Pistons,23,118,8:00p,213,Atlanta Hawks,95
Jan 18 2017,1,Golden State Warriors,21,121,10:30p,221,Oklahoma City Thunder,100
Jan 18 2017,1,Houston Rockets,19,111,8:00p,203,Milwaukee Bucks,92
Jan 18 2017,1,New Orleans Pelicans,20,118,8:00p,216,Orlando Magic,98
Jan 18 2017,1,Philadelphia 76ers,5,94,7:00p,183,Toronto Raptors,89
Jan 18 2017,0,Sacramento Kings,-6,100,10:30p,206,Indiana Pacers,106
Jan 18 2017,1,Washington Wizards,3,104,7:00p,205,Memphis Grizzlies,101
Jan 19 2017,1,Cleveland Cavaliers,15,118,7:00p,221,Phoenix Suns,103
Jan 19 2017,0,Los Angeles Clippers,-3,101,10:30p,205,Minnesota Timberwolves,104
Jan 19 2017,1,Miami Heat,4,99,7:30p,194,Dallas Mavericks,95
Jan 19 2017,0,New York Knicks,-3,110,8:00p,223,Washington Wizards,113
Jan 19 2017,1,San Antonio Spurs,14,118,8:30p,222,Denver Nuggets,104
Jan 20 2017,1,Atlanta Hawks,9,102,8:00p,195,Chicago Bulls,93
Jan 20 2017,1,Charlotte Hornets,35,113,7:00p,191,Toronto Raptors,78
Jan 20 2017,0,Dallas Mavericks,-5,107,8:30p,219,Utah Jazz,112
Jan 20 2017,0,Houston Rockets,-17,108,8:00p,233,Golden State Warriors,125
Jan 20 2017,1,Los Angeles Lakers,13,108,10:30p,203,Indiana Pacers,95
Jan 20 2017,1,Memphis Grizzlies,16,107,8:00p,198,Sacramento Kings,91
Jan 20 2017,0,New Orleans Pelicans,-29,114,8:00p,257,Brooklyn Nets,143
Jan 20 2017,1,Orlando Magic,16,112,7:00p,208,Milwaukee Bucks,96
Jan 20 2017,1,Philadelphia 76ers,1,93,7:00p,185,Portland Trail Blazers,92
Jan 21 2017,1,Atlanta Hawks,17,110,7:00p,203,Philadelphia 76ers,93
Jan 21 2017,0,Boston Celtics,-4,123,5:00p,250,Portland Trail Blazers,127
Jan 21 2017,1,Chicago Bulls,3,102,9:00p,201,Sacramento Kings,99
Jan 21 2017,1,Charlotte Hornets,7,112,7:00p,217,Brooklyn Nets,105
Jan 21 2017,0,Cleveland Cavaliers,-3,115,8:30p,233,San Antonio Spurs,118
Jan 21 2017,1,Denver Nuggets,25,123,9:00p,221,Los Angeles Clippers,98
Jan 21 2017,1,Detroit Pistons,1,113,6:00p,225,Washington Wizards,112
Jan 21 2017,0,Memphis Grizzlies,-24,95,8:00p,214,Houston Rockets,119
Jan 21 2017,1,Miami Heat,12,109,7:30p,206,Milwaukee Bucks,97
Jan 21 2017,0,New York Knicks,-2,105,7:30p,212,Phoenix Suns,107
Jan 21 2017,1,Utah Jazz,9,109,9:00p,209,Indiana Pacers,100
Jan 22 2017,1,Dallas Mavericks,49,122,3:30p,195,Los Angeles Lakers,73
Jan 22 2017,1,Minnesota Timberwolves,3,111,7:00p,219,Denver Nuggets,108
Jan 22 2017,0,Orlando Magic,-20,98,12:00p,216,Golden State Warriors,118
Jan 22 2017,0,Toronto Raptors,-12,103,6:00p,218,Phoenix Suns,115
Jan 23 2017,0,Atlanta Hawks,-10,105,7:30p,220,Los Angeles Clippers,115
Jan 23 2017,0,Brooklyn Nets,-26,86,7:30p,198,San Antonio Spurs,112
Jan 23 2017,0,Charlotte Hornets,-10,99,7:00p,208,Washington Wizards,109
Jan 23 2017,0,Detroit Pistons,-5,104,7:30p,213,Sacramento Kings,109
Jan 23 2017,0,Indiana Pacers,-6,103,8:00p,212,New York Knicks,109
Jan 23 2017,1,Miami Heat,3,105,7:30p,207,Golden State Warriors,102
Jan 23 2017,1,Milwaukee Bucks,13,127,8:00p,241,Houston Rockets,114
Jan 23 2017,1,New Orleans Pelicans,2,124,8:00p,246,Cleveland Cavaliers,122
Jan 23 2017,0,Utah Jazz,-2,95,9:00p,192,Oklahoma City Thunder,97
Jan 24 2017,1,Denver Nuggets,10,103,9:00p,196,Utah Jazz,93
Jan 24 2017,0,Orlando Magic,-8,92,7:00p,192,Chicago Bulls,100
Jan 24 2017,1,Philadelphia 76ers,11,121,7:00p,231,Los Angeles Clippers,110
Jan 24 2017,0,Phoenix Suns,-1,111,9:00p,223,Minnesota Timberwolves,112
Jan 24 2017,0,Toronto Raptors,-2,106,7:00p,214,San Antonio Spurs,108
Jan 24 2017,1,Washington Wizards,15,123,7:00p,231,Boston Celtics,108
Jan 25 2017,1,Boston Celtics,11,120,7:30p,229,Houston Rockets,109
Jan 25 2017,0,Brooklyn Nets,-3,106,7:30p,215,Miami Heat,109
Jan 25 2017,0,Chicago Bulls,-5,114,8:00p,233,Atlanta Hawks,119
Jan 25 2017,0,Charlotte Hornets,-10,103,8:00p,216,Golden State Warriors,113
Jan 25 2017,0,Cleveland Cavaliers,-4,112,7:00p,228,Sacramento Kings,116
Jan 25 2017,1,Dallas Mavericks,8,103,8:30p,198,New York Knicks,95
Jan 25 2017,1,Memphis Grizzlies,2,101,8:00p,200,Toronto Raptors,99
Jan 25 2017,0,Milwaukee Bucks,-5,109,8:00p,223,Philadelphia 76ers,114
Jan 25 2017,0,New Orleans Pelicans,-9,105,8:00p,219,Oklahoma City Thunder,114
Jan 25 2017,1,Portland Trail Blazers,7,105,10:30p,203,Los Angeles Lakers,98
Jan 26 2017,1,Denver Nuggets,7,127,9:00p,247,Phoenix Suns,120
Jan 26 2017,0,Minnesota Timberwolves,-6,103,8:00p,212,Indiana Pacers,109
Jan 26 2017,1,Oklahoma City Thunder,11,109,8:00p,207,Dallas Mavericks,98
Jan 26 2017,1,Utah Jazz,8,96,10:30p,184,Los Angeles Lakers,88
Jan 27 2017,0,Atlanta Hawks,-26,86,8:00p,198,Washington Wizards,112
Jan 27 2017,1,Boston Celtics,30,128,7:30p,226,Orlando Magic,98
Jan 27 2017,0,Chicago Bulls,-12,88,8:00p,188,Miami Heat,100
Jan 27 2017,1,Cleveland Cavaliers,8,124,7:30p,240,Brooklyn Nets,116
Jan 27 2017,1,Indiana Pacers,4,115,7:00p,226,Sacramento Kings,111
Jan 27 2017,1,New Orleans Pelicans,16,119,8:00p,222,San Antonio Spurs,103
Jan 27 2017,1,New York Knicks,3,110,7:30p,217,Charlotte Hornets,107
Jan 27 2017,0,Philadelphia 76ers,-5,118,8:00p,241,Houston Rockets,123
Jan 27 2017,1,Portland Trail Blazers,3,112,10:00p,221,Memphis Grizzlies,109
Jan 27 2017,1,Toronto Raptors,16,102,7:30p,188,Milwaukee Bucks,86
Jan 28 2017,0,Charlotte Hornets,-3,106,7:00p,215,Sacramento Kings,109
Jan 28 2017,1,Golden State Warriors,46,144,8:30p,242,Los Angeles Clippers,98
Jan 28 2017,1,Miami Heat,13,116,7:30p,219,Detroit Pistons,103
Jan 28 2017,0,Milwaukee Bucks,-4,108,8:00p,220,Boston Celtics,112
Jan 28 2017,1,Minnesota Timberwolves,20,129,9:00p,238,Brooklyn Nets,109
Jan 28 2017,0,Phoenix Suns,-11,112,9:00p,235,Denver Nuggets,123
Jan 28 2017,0,Utah Jazz,-7,95,9:00p,197,Memphis Grizzlies,102
Jan 29 2017,1,Atlanta Hawks,3,142,3:00p,281,New York Knicks,139
Jan 29 2017,1,Chicago Bulls,13,121,7:00p,229,Philadelphia 76ers,108
Jan 29 2017,1,Cleveland Cavaliers,16,107,3:30p,198,Oklahoma City Thunder,91
Jan 29 2017,1,Indiana Pacers,19,120,6:00p,221,Houston Rockets,101
Jan 29 2017,0,New Orleans Pelicans,-13,94,6:00p,201,Washington Wizards,107
Jan 29 2017,0,Portland Trail Blazers,-2,111,9:00p,224,Golden State Warriors,113
Jan 29 2017,0,San Antonio Spurs,-4,101,7:00p,206,Dallas Mavericks,105
Jan 29 2017,0,Toronto Raptors,-1,113,6:00p,227,Orlando Magic,114
Jan 30 2017,1,Boston Celtics,4,113,8:00p,222,Detroit Pistons,109
Jan 30 2017,1,Dallas Mavericks,7,104,8:30p,201,Cleveland Cavaliers,97
Jan 30 2017,1,Miami Heat,8,104,7:30p,200,Brooklyn Nets,96
Jan 30 2017,1,Minnesota Timberwolves,6,111,8:00p,216,Orlando Magic,105
Jan 30 2017,1,Philadelphia 76ers,3,122,6:00p,241,Sacramento Kings,119
Jan 30 2017,0,Phoenix Suns,-19,96,10:30p,211,Memphis Grizzlies,115
Jan 31 2017,1,Houston Rockets,22,105,8:00p,188,Sacramento Kings,83
Jan 31 2017,1,Los Angeles Lakers,4,120,10:30p,236,Denver Nuggets,116
Jan 31 2017,1,Portland Trail Blazers,17,115,10:00p,213,Charlotte Hornets,98
Jan 31 2017,1,San Antonio Spurs,14,108,8:30p,202,Oklahoma City Thunder,94
Jan 31 2017,1,Toronto Raptors,2,108,7:00p,214,New Orleans Pelicans,106
Jan 31 2017,1,Washington Wizards,16,117,7:00p,218,New York Knicks,101
Feb 1 2017,1,Boston Celtics,5,109,7:30p,213,Toronto Raptors,104
Feb 1 2017,0,Brooklyn Nets,-5,90,7:30p,185,New York Knicks,95
Feb 1 2017,1,Cleveland Cavaliers,28,125,7:00p,222,Minnesota Timberwolves,97
Feb 1 2017,1,Dallas Mavericks,18,113,8:30p,208,Philadelphia 76ers,95
Feb 1 2017,0,Denver Nuggets,-20,99,9:00p,218,Memphis Grizzlies,119
Feb 1 2017,1,Detroit Pistons,20,118,7:30p,216,New Orleans Pelicans,98
Feb 1 2017,1,Golden State Warriors,15,126,10:30p,237,Charlotte Hornets,111
Feb 1 2017,1,Miami Heat,23,116,7:30p,209,Atlanta Hawks,93
Feb 1 2017,0,Oklahoma City Thunder,-28,100,9:30p,228,Chicago Bulls,128
Feb 1 2017,0,Orlando Magic,-10,88,7:00p,186,Indiana Pacers,98
Feb 1 2017,0,Phoenix Suns,-10,114,9:00p,238,Los Angeles Clippers,124
Feb 1 2017,1,Utah Jazz,16,104,9:00p,192,Milwaukee Bucks,88
Feb 2 2017,0,Houston Rockets,-5,108,8:00p,221,Atlanta Hawks,113
Feb 2 2017,0,Los Angeles Clippers,-13,120,10:30p,253,Golden State Warriors,133
Feb 2 2017,1,San Antonio Spurs,16,102,8:30p,188,Philadelphia 76ers,86
Feb 2 2017,1,Washington Wizards,8,116,7:00p,224,Los Angeles Lakers,108
Feb 3 2017,1,Boston Celtics,6,113,8:00p,220,Los Angeles Lakers,107
Feb 3 2017,0,Brooklyn Nets,-9,97,7:30p,203,Indiana Pacers,106
Feb 3 2017,1,Denver Nuggets,4,121,9:00p,238,Milwaukee Bucks,117
Feb 3 2017,1,Detroit Pistons,8,116,7:30p,224,Minnesota Timberwolves,108
Feb 3 2017,1,Houston Rockets,4,121,8:00p,238,Chicago Bulls,117
Feb 3 2017,1,Oklahoma City Thunder,12,114,8:00p,216,Memphis Grizzlies,102
Feb 3 2017,1,Orlando Magic,8,102,7:00p,196,Toronto Raptors,94
Feb 3 2017,0,Portland Trail Blazers,-4,104,10:30p,212,Dallas Mavericks,108
Feb 3 2017,0,Sacramento Kings,-2,103,10:30p,208,Phoenix Suns,105
Feb 4 2017,1,Atlanta Hawks,27,113,7:00p,199,Orlando Magic,86
Feb 4 2017,1,Indiana Pacers,21,105,7:00p,189,Detroit Pistons,84
Feb 4 2017,1,Miami Heat,23,125,7:30p,227,Philadelphia 76ers,102
Feb 4 2017,0,Minnesota Timberwolves,-8,99,9:00p,206,Memphis Grizzlies,107
Feb 4 2017,0,New York Knicks,-7,104,8:30p,215,Cleveland Cavaliers,111
Feb 4 2017,0,Phoenix Suns,-25,112,9:00p,249,Milwaukee Bucks,137
Feb 4 2017,1,Sacramento Kings,3,109,10:30p,215,Golden State Warriors,106
Feb 4 2017,1,San Antonio Spurs,24,121,9:00p,218,Denver Nuggets,97
Feb 4 2017,1,Utah Jazz,7,105,9:00p,203,Charlotte Hornets,98
Feb 4 2017,1,Washington Wizards,14,105,7:00p,196,New Orleans Pelicans,91
Feb 5 2017,1,Boston Celtics,5,107,2:00p,209,Los Angeles Clippers,102
Feb 5 2017,0,Brooklyn Nets,-8,95,12:00p,198,Toronto Raptors,103
Feb 5 2017,1,Oklahoma City Thunder,6,105,3:00p,204,Portland Trail Blazers,99
Feb 6 2017,0,Atlanta Hawks,-25,95,7:30p,215,Utah Jazz,120
Feb 6 2017,1,Denver Nuggets,23,110,9:00p,197,Dallas Mavericks,87
Feb 6 2017,1,Detroit Pistons,17,113,7:30p,209,Philadelphia 76ers,96
Feb 6 2017,1,Indiana Pacers,3,93,7:00p,183,Oklahoma City Thunder,90
Feb 6 2017,1,Memphis Grizzlies,15,89,9:30p,163,San Antonio Spurs,74
Feb 6 2017,0,Minnesota Timberwolves,-2,113,8:00p,228,Miami Heat,115
Feb 6 2017,1,New Orleans Pelicans,5,111,8:00p,217,Phoenix Suns,106
Feb 6 2017,0,New York Knicks,-14,107,7:00p,228,Los Angeles Lakers,121
Feb 6 2017,0,Sacramento Kings,-5,107,10:30p,219,Chicago Bulls,112
Feb 6 2017,1,Toronto Raptors,9,118,7:30p,227,Los Angeles Clippers,109
Feb 6 2017,0,Washington Wizards,-5,135,7:00p,275,Cleveland Cavaliers,140
Feb 7 2017,1,Charlotte Hornets,4,111,7:00p,218,Brooklyn Nets,107
Feb 7 2017,0,Dallas Mavericks,-1,113,8:30p,227,Portland Trail Blazers,114
Feb 7 2017,1,Houston Rockets,24,128,8:00p,232,Orlando Magic,104
Feb 8 2017,1,Atlanta Hawks,11,117,7:30p,223,Denver Nuggets,106
Feb 8 2017,0,Brooklyn Nets,-4,110,7:30p,224,Washington Wizards,114
Feb 8 2017,1,Detroit Pistons,19,121,7:30p,223,Los Angeles Lakers,102
Feb 8 2017,1,Golden State Warriors,31,123,10:30p,215,Chicago Bulls,92
Feb 8 2017,0,Indiana Pacers,-15,117,7:00p,249,Cleveland Cavaliers,132
Feb 8 2017,1,Memphis Grizzlies,19,110,8:00p,201,Phoenix Suns,91
Feb 8 2017,0,Milwaukee Bucks,-18,88,8:00p,194,Miami Heat,106
Feb 8 2017,1,Minnesota Timberwolves,3,112,8:00p,221,Toronto Raptors,109
Feb 8 2017,0,New Orleans Pelicans,-33,94,8:00p,221,Utah Jazz,127
Feb 8 2017,0,New York Knicks,-4,115,8:00p,234,Los Angeles Clippers,119
Feb 8 2017,0,Philadelphia 76ers,-8,103,7:00p,214,San Antonio Spurs,111
Feb 8 2017,1,Sacramento Kings,16,108,10:30p,200,Boston Celtics,92
Feb 9 2017,0,Charlotte Hornets,-12,95,7:00p,202,Houston Rockets,107
Feb 9 2017,1,Dallas Mavericks,7,112,8:30p,217,Utah Jazz,105
Feb 9 2017,1,Oklahoma City Thunder,9,118,8:00p,227,Cleveland Cavaliers,109
Feb 9 2017,0,Orlando Magic,-1,111,7:00p,223,Philadelphia 76ers,112
Feb 9 2017,0,Portland Trail Blazers,-9,111,10:30p,231,Boston Celtics,120
Feb 10 2017,0,Brooklyn Nets,-9,99,7:30p,207,Miami Heat,108
Feb 10 2017,0,Detroit Pistons,-11,92,7:30p,195,San Antonio Spurs,103
Feb 10 2017,0,Memphis Grizzlies,-15,107,8:00p,229,Golden State Warriors,122
Feb 10 2017,0,Milwaukee Bucks,-8,114,8:00p,236,Los Angeles Lakers,122
Feb 10 2017,0,Minnesota Timberwolves,-16,106,8:00p,228,New Orleans Pelicans,122
Feb 10 2017,0,New York Knicks,-8,123,7:30p,254,Denver Nuggets,131
Feb 10 2017,1,Phoenix Suns,18,115,10:30p,212,Chicago Bulls,97
Feb 10 2017,1,Sacramento Kings,1,108,10:30p,215,Atlanta Hawks,107
Feb 10 2017,1,Washington Wizards,5,112,8:00p,219,Indiana Pacers,107
Feb 11 2017,0,Charlotte Hornets,-5,102,5:00p,209,Los Angeles Clippers,107
Feb 11 2017,1,Cleveland Cavaliers,16,125,7:30p,234,Denver Nuggets,109
Feb 11 2017,1,Dallas Mavericks,32,112,9:00p,192,Orlando Magic,80
Feb 11 2017,1,Houston Rockets,31,133,9:00p,235,Phoenix Suns,102
Feb 11 2017,0,Indiana Pacers,-16,100,7:00p,216,Milwaukee Bucks,116
Feb 11 2017,0,Oklahoma City Thunder,-16,114,8:30p,244,Golden State Warriors,130
Feb 11 2017,1,Philadelphia 76ers,8,117,7:30p,226,Miami Heat,109
Feb 11 2017,0,Utah Jazz,-8,104,10:00p,216,Boston Celtics,112
Feb 12 2017,1,Minnesota Timberwolves,28,117,3:30p,206,Chicago Bulls,89
Feb 12 2017,1,New York Knicks,4,94,3:30p,184,San Antonio Spurs,90
Feb 12 2017,1,Sacramento Kings,6,105,9:00p,204,New Orleans Pelicans,99
Feb 12 2017,0,Toronto Raptors,-1,101,6:00p,203,Detroit Pistons,102
Feb 13 2017,0,Brooklyn Nets,-9,103,7:30p,215,Memphis Grizzlies,112
Feb 13 2017,0,Charlotte Hornets,-6,99,7:00p,204,Philadelphia 76ers,105
Feb 13 2017,0,Dallas Mavericks,-13,98,8:30p,209,Boston Celtics,111
Feb 13 2017,1,Denver Nuggets,22,132,9:00p,242,Golden State Warriors,110
Feb 13 2017,0,Indiana Pacers,-4,106,7:00p,216,San Antonio Spurs,110
Feb 13 2017,0,Miami Heat,-9,107,7:30p,223,Orlando Magic,116
Feb 13 2017,1,Milwaukee Bucks,13,102,8:00p,191,Detroit Pistons,89
Feb 13 2017,0,Phoenix Suns,-2,108,9:00p,218,New Orleans Pelicans,110
Feb 13 2017,0,Portland Trail Blazers,-5,104,10:30p,213,Atlanta Hawks,109
Feb 13 2017,0,Utah Jazz,-16,72,9:00p,160,Los Angeles Clippers,88
Feb 13 2017,1,Washington Wizards,22,120,8:00p,218,Oklahoma City Thunder,98
Feb 14 2017,1,Chicago Bulls,11,105,8:00p,199,Toronto Raptors,94
Feb 14 2017,0,Los Angeles Lakers,-1,96,10:30p,193,Sacramento Kings,97
Feb 14 2017,0,Minnesota Timberwolves,-8,108,8:00p,224,Cleveland Cavaliers,116
Feb 15 2017,1,Boston Celtics,8,116,7:30p,224,Philadelphia 76ers,108
Feb 15 2017,0,Brooklyn Nets,-4,125,7:30p,254,Milwaukee Bucks,129
Feb 15 2017,1,Cleveland Cavaliers,9,113,7:00p,217,Indiana Pacers,104
Feb 15 2017,0,Denver Nuggets,-13,99,9:00p,211,Minnesota Timberwolves,112
Feb 15 2017,1,Detroit Pistons,7,98,7:30p,189,Dallas Mavericks,91
Feb 15 2017,1,Golden State Warriors,23,109,10:30p,195,Sacramento Kings,86
Feb 15 2017,0,Houston Rockets,-8,109,8:00p,226,Miami Heat,117
Feb 15 2017,1,Los Angeles Clippers,15,99,10:30p,183,Atlanta Hawks,84
Feb 15 2017,0,Memphis Grizzlies,-4,91,8:00p,186,New Orleans Pelicans,95
Feb 15 2017,1,Oklahoma City Thunder,11,116,9:30p,221,New York Knicks,105
Feb 15 2017,0,Orlando Magic,-28,79,7:00p,186,San Antonio Spurs,107
Feb 15 2017,1,Phoenix Suns,36,137,9:00p,238,Los Angeles Lakers,101
Feb 15 2017,1,Toronto Raptors,5,90,7:30p,175,Charlotte Hornets,85
Feb 15 2017,1,Utah Jazz,23,111,9:00p,199,Portland Trail Blazers,88
Feb 16 2017,1,Chicago Bulls,1,104,8:00p,207,Boston Celtics,103
Feb 16 2017,0,Indiana Pacers,-13,98,7:00p,209,Washington Wizards,111
Feb 23 2017,1,Cleveland Cavaliers,15,119,8:00p,223,New York Knicks,104
Feb 23 2017,1,Detroit Pistons,6,114,7:30p,222,Charlotte Hornets,108
Feb 23 2017,1,Golden State Warriors,10,123,10:30p,236,Los Angeles Clippers,113
Feb 23 2017,0,New Orleans Pelicans,-30,99,8:00p,228,Houston Rockets,129
Feb 23 2017,0,Orlando Magic,-9,103,7:00p,215,Portland Trail Blazers,112
Feb 23 2017,1,Sacramento Kings,16,116,10:30p,216,Denver Nuggets,100
Feb 24 2017,0,Atlanta Hawks,-18,90,8:00p,198,Miami Heat,108
Feb 24 2017,1,Chicago Bulls,7,128,8:00p,249,Phoenix Suns,121
Feb 24 2017,1,Denver Nuggets,20,129,9:00p,238,Brooklyn Nets,109
Feb 24 2017,1,Indiana Pacers,10,102,7:00p,194,Memphis Grizzlies,92
Feb 24 2017,0,Los Angeles Clippers,-8,97,10:30p,202,San Antonio Spurs,105
Feb 24 2017,0,Milwaukee Bucks,-14,95,8:00p,204,Utah Jazz,109
Feb 24 2017,1,Minnesota Timberwolves,13,97,8:00p,181,Dallas Mavericks,84
Feb 24 2017,1,Oklahoma City Thunder,17,110,8:00p,203,Los Angeles Lakers,93
Feb 24 2017,1,Philadelphia 76ers,8,120,7:00p,232,Washington Wizards,112
Feb 24 2017,1,Toronto Raptors,10,107,8:00p,204,Boston Celtics,97
Feb 25 2017,0,Cleveland Cavaliers,-18,99,8:30p,216,Chicago Bulls,117
Feb 25 2017,1,Dallas Mavericks,13,96,8:30p,179,New Orleans Pelicans,83
Feb 25 2017,1,Golden State Warriors,17,112,10:30p,207,Brooklyn Nets,95
Feb 25 2017,1,Houston Rockets,12,142,9:00p,272,Minnesota Timberwolves,130
Feb 25 2017,1,Miami Heat,18,113,8:00p,208,Indiana Pacers,95
Feb 25 2017,1,New York Knicks,1,110,7:30p,219,Philadelphia 76ers,109
Feb 25 2017,1,Orlando Magic,19,105,7:00p,191,Atlanta Hawks,86
Feb 25 2017,0,Sacramento Kings,-14,85,5:00p,184,Charlotte Hornets,99
Feb 26 2017,0,Denver Nuggets,-7,98,5:00p,203,Memphis Grizzlies,105
Feb 26 2017,0,Detroit Pistons,-6,98,6:00p,202,Boston Celtics,104
Feb 26 2017,1,Los Angeles Clippers,3,124,9:30p,245,Charlotte Hornets,121
Feb 26 2017,0,Los Angeles Lakers,-21,98,3:30p,217,San Antonio Spurs,119
Feb 26 2017,1,Milwaukee Bucks,4,100,3:30p,196,Phoenix Suns,96
Feb 26 2017,1,Oklahoma City Thunder,8,118,7:00p,228,New Orleans Pelicans,110
Feb 26 2017,1,Toronto Raptors,6,112,6:00p,218,Portland Trail Blazers,106
Feb 26 2017,0,Washington Wizards,-10,92,5:00p,194,Utah Jazz,102
Feb 27 2017,0,Boston Celtics,-16,98,7:30p,212,Atlanta Hawks,114
Feb 27 2017,1,Cleveland Cavaliers,7,102,7:00p,197,Milwaukee Bucks,95
Feb 27 2017,1,Dallas Mavericks,7,96,8:30p,185,Miami Heat,89
Feb 27 2017,0,Houston Rockets,-9,108,9:30p,225,Indiana Pacers,117
Feb 27 2017,0,New York Knicks,-1,91,7:00p,183,Toronto Raptors,92
Feb 27 2017,0,Philadelphia 76ers,-11,108,7:00p,227,Golden State Warriors,119
Feb 27 2017,0,Sacramento Kings,-14,88,10:30p,190,Minnesota Timberwolves,102
Feb 28 2017,0,Chicago Bulls,-18,107,8:00p,232,Denver Nuggets,125
Feb 28 2017,1,Detroit Pistons,7,120,7:30p,233,Portland Trail Blazers,113
Feb 28 2017,0,Los Angeles Lakers,-5,104,10:30p,213,Charlotte Hornets,109
Feb 28 2017,1,Memphis Grizzlies,18,130,8:00p,242,Phoenix Suns,112
Feb 28 2017,1,Oklahoma City Thunder,3,109,8:00p,215,Utah Jazz,106
Feb 28 2017,1,Washington Wizards,4,112,7:00p,220,Golden State Warriors,108
Mar 1 2017,1,Atlanta Hawks,5,100,7:30p,195,Dallas Mavericks,95
Mar 1 2017,1,Boston Celtics,4,103,8:00p,202,Cleveland Cavaliers,99
Mar 1 2017,0,Los Angeles Clippers,-19,103,10:30p,225,Houston Rockets,122
Mar 1 2017,1,Miami Heat,27,125,7:30p,223,Philadelphia 76ers,98
Mar 1 2017,0,Milwaukee Bucks,-12,98,8:00p,208,Denver Nuggets,110
Mar 1 2017,1,New Orleans Pelicans,23,109,8:00p,195,Detroit Pistons,86
Mar 1 2017,0,Orlando Magic,-11,90,7:00p,191,New York Knicks,101
Mar 1 2017,0,Sacramento Kings,-9,100,10:30p,209,Brooklyn Nets,109
Mar 1 2017,1,San Antonio Spurs,1,100,8:30p,199,Indiana Pacers,99
Mar 1 2017,0,Toronto Raptors,-9,96,7:30p,201,Washington Wizards,105
Mar 1 2017,0,Utah Jazz,-27,80,9:00p,187,Minnesota Timberwolves,107
Mar 2 2017,1,Chicago Bulls,7,94,8:00p,181,Golden State Warriors,87
Mar 2 2017,1,Phoenix Suns,17,120,9:00p,223,Charlotte Hornets,103
Mar 2 2017,1,Portland Trail Blazers,5,114,10:30p,223,Oklahoma City Thunder,109
Mar 3 2017,0,Atlanta Hawks,-5,130,7:00p,265,Cleveland Cavaliers,135
Mar 3 2017,1,Dallas Mavericks,4,104,8:30p,204,Memphis Grizzlies,100
Mar 3 2017,0,Los Angeles Lakers,-20,95,10:30p,210,Boston Celtics,115
Mar 3 2017,1,Milwaukee Bucks,11,112,8:00p,213,Los Angeles Clippers,101
Mar 3 2017,0,New Orleans Pelicans,-3,98,9:30p,199,San Antonio Spurs,101
Mar 3 2017,1,Orlando Magic,11,110,7:00p,209,Miami Heat,99
Mar 3 2017,1,Philadelphia 76ers,3,105,7:00p,207,New York Knicks,102
Mar 3 2017,1,Phoenix Suns,7,118,9:00p,229,Oklahoma City Thunder,111
Mar 3 2017,1,Utah Jazz,15,112,9:00p,209,Brooklyn Nets,97
Mar 3 2017,0,Washington Wizards,-8,106,7:00p,220,Toronto Raptors,114
Mar 4 2017,0,Chicago Bulls,-10,91,8:30p,192,Los Angeles Clippers,101
Mar 4 2017,0,Denver Nuggets,-10,102,9:00p,214,Charlotte Hornets,112
Mar 4 2017,1,Houston Rockets,15,123,9:00p,231,Memphis Grizzlies,108
Mar 4 2017,1,Miami Heat,28,120,8:00p,212,Cleveland Cavaliers,92
Mar 4 2017,1,Milwaukee Bucks,7,101,8:00p,195,Toronto Raptors,94
Mar 4 2017,0,Philadelphia 76ers,-30,106,6:00p,242,Detroit Pistons,136
Mar 4 2017,1,Portland Trail Blazers,14,130,10:00p,246,Brooklyn Nets,116
Mar 4 2017,1,San Antonio Spurs,7,97,9:00p,187,Minnesota Timberwolves,90
Mar 5 2017,0,Atlanta Hawks,-1,96,1:00p,193,Indiana Pacers,97
Mar 5 2017,1,Dallas Mavericks,15,104,8:30p,193,Oklahoma City Thunder,89
Mar 5 2017,0,Los Angeles Lakers,-8,97,9:30p,202,New Orleans Pelicans,105
Mar 5 2017,0,New York Knicks,-7,105,3:30p,217,Golden State Warriors,112
Mar 5 2017,1,Phoenix Suns,3,109,5:00p,215,Boston Celtics,106
Mar 5 2017,0,Sacramento Kings,-1,109,6:00p,219,Utah Jazz,110
Mar 5 2017,1,Washington Wizards,1,115,5:00p,229,Orlando Magic,114
Mar 6 2017,0,Atlanta Hawks,-8,111,7:30p,230,Golden State Warriors,119
Mar 6 2017,1,Charlotte Hornets,12,100,8:00p,188,Indiana Pacers,88
Mar 6 2017,0,Cleveland Cavaliers,-8,98,7:00p,204,Miami Heat,106
Mar 6 2017,1,Denver Nuggets,12,108,9:00p,204,Sacramento Kings,96
Mar 6 2017,1,Detroit Pistons,14,109,7:30p,204,Chicago Bulls,95
Mar 6 2017,1,Los Angeles Clippers,14,116,10:30p,218,Boston Celtics,102
Mar 6 2017,0,Memphis Grizzlies,-13,109,8:00p,231,Brooklyn Nets,122
Mar 6 2017,0,Orlando Magic,-8,105,7:00p,218,New York Knicks,113
Mar 6 2017,0,Philadelphia 76ers,-14,98,7:00p,210,Milwaukee Bucks,112
Mar 6 2017,1,San Antonio Spurs,2,112,8:30p,222,Houston Rockets,110
Mar 6 2017,1,Utah Jazz,5,88,9:00p,171,New Orleans Pelicans,83
Mar 7 2017,1,Dallas Mavericks,11,122,8:30p,233,Los Angeles Lakers,111
Mar 7 2017,0,Oklahoma City Thunder,-5,121,8:00p,247,Portland Trail Blazers,126
Mar 7 2017,0,Phoenix Suns,-4,127,9:00p,258,Washington Wizards,131
Mar 8 2017,1,Atlanta Hawks,5,110,7:30p,215,Brooklyn Nets,105
Mar 8 2017,0,Denver Nuggets,-10,113,9:00p,236,Washington Wizards,123
Mar 8 2017,0,Golden State Warriors,-13,86,10:30p,185,Boston Celtics,99
Mar 8 2017,0,Houston Rockets,-7,108,8:00p,223,Utah Jazz,115
Mar 8 2017,1,Indiana Pacers,17,115,8:00p,213,Detroit Pistons,98
Mar 8 2017,1,Miami Heat,7,108,7:30p,209,Charlotte Hornets,101
Mar 8 2017,1,Milwaukee Bucks,11,104,8:00p,197,New York Knicks,93
Mar 8 2017,1,Minnesota Timberwolves,16,107,8:00p,198,Los Angeles Clippers,91
Mar 8 2017,0,New Orleans Pelicans,-7,87,8:00p,181,Toronto Raptors,94
Mar 8 2017,1,Orlando Magic,7,98,7:00p,189,Chicago Bulls,91
Mar 8 2017,1,San Antonio Spurs,10,114,8:30p,218,Sacramento Kings,104
Mar 9 2017,1,Detroit Pistons,5,106,7:30p,207,Cleveland Cavaliers,101
Mar 9 2017,0,Memphis Grizzlies,-16,98,8:00p,212,Los Angeles Clippers,114
Mar 9 2017,1,Oklahoma City Thunder,10,102,8:00p,194,San Antonio Spurs,92
Mar 9 2017,0,Phoenix Suns,-12,110,10:30p,232,Los Angeles Lakers,122
Mar 9 2017,1,Portland Trail Blazers,6,114,10:00p,222,Philadelphia 76ers,108
Mar 10 2017,1,Atlanta Hawks,6,105,8:00p,204,Toronto Raptors,99
Mar 10 2017,0,Chicago Bulls,-21,94,8:00p,209,Houston Rockets,115
Mar 10 2017,1,Charlotte Hornets,40,121,7:00p,202,Orlando Magic,81
Mar 10 2017,1,Dallas Mavericks,9,105,9:00p,201,Brooklyn Nets,96
Mar 10 2017,1,Denver Nuggets,20,119,9:00p,218,Boston Celtics,99
Mar 10 2017,1,Milwaukee Bucks,14,99,8:00p,184,Indiana Pacers,85
Mar 10 2017,1,Minnesota Timberwolves,1,103,8:00p,205,Golden State Warriors,102
Mar 10 2017,0,Sacramento Kings,-8,122,10:30p,252,Washington Wizards,130
Mar 11 2017,0,Charlotte Hornets,-3,122,7:00p,247,New Orleans Pelicans,125
Mar 11 2017,0,Dallas Mavericks,-2,98,9:00p,198,Phoenix Suns,100
Mar 11 2017,1,Detroit Pistons,20,112,5:00p,204,New York Knicks,92
Mar 11 2017,1,Los Angeles Clippers,12,112,3:30p,212,Philadelphia 76ers,100
Mar 11 2017,0,Memphis Grizzlies,-17,90,9:00p,197,Atlanta Hawks,107
Mar 11 2017,1,Miami Heat,15,104,8:00p,193,Toronto Raptors,89
Mar 11 2017,1,Milwaukee Bucks,7,102,8:00p,197,Minnesota Timberwolves,95
Mar 11 2017,1,Oklahoma City Thunder,8,112,3:00p,216,Utah Jazz,104
Mar 11 2017,0,Orlando Magic,-12,104,7:00p,220,Cleveland Cavaliers,116
Mar 11 2017,0,Portland Trail Blazers,-1,124,10:00p,249,Washington Wizards,125
Mar 11 2017,0,Sacramento Kings,-13,92,10:30p,197,Denver Nuggets,105
Mar 11 2017,1,San Antonio Spurs,22,107,8:30p,192,Golden State Warriors,85
Mar 12 2017,1,Boston Celtics,20,100,3:30p,180,Chicago Bulls,80
Mar 12 2017,1,Brooklyn Nets,8,120,6:00p,232,New York Knicks,112
Mar 12 2017,1,Houston Rockets,5,117,9:00p,229,Cleveland Cavaliers,112
Mar 12 2017,1,Indiana Pacers,4,102,6:00p,200,Miami Heat,98
Mar 12 2017,0,Los Angeles Lakers,-2,116,9:30p,234,Philadelphia 76ers,118
Mar 12 2017,0,Phoenix Suns,-9,101,9:00p,211,Portland Trail Blazers,110
Mar 13 2017,0,Charlotte Hornets,-6,109,7:00p,224,Chicago Bulls,115
Mar 13 2017,1,Denver Nuggets,28,129,10:30p,230,Los Angeles Lakers,101
Mar 13 2017,1,Memphis Grizzlies,20,113,8:00p,206,Milwaukee Bucks,93
Mar 13 2017,1,Minnesota Timberwolves,15,119,8:00p,223,Washington Wizards,104
Mar 13 2017,1,Sacramento Kings,5,120,10:30p,235,Orlando Magic,115
Mar 13 2017,1,San Antonio Spurs,8,107,8:00p,206,Atlanta Hawks,99
Mar 13 2017,1,Toronto Raptors,22,100,7:30p,178,Dallas Mavericks,78
Mar 13 2017,1,Utah Jazz,6,114,9:00p,222,Los Angeles Clippers,108
Mar 14 2017,0,Brooklyn Nets,-18,104,7:30p,226,Oklahoma City Thunder,122
Mar 14 2017,1,Cleveland Cavaliers,32,128,7:00p,224,Detroit Pistons,96
Mar 14 2017,1,Golden State Warriors,2,106,10:30p,210,Philadelphia 76ers,104
Mar 14 2017,1,New Orleans Pelicans,23,100,8:00p,177,Portland Trail Blazers,77
Mar 14 2017,1,New York Knicks,6,87,7:30p,168,Indiana Pacers,81
Mar 15 2017,1,Boston Celtics,13,117,7:30p,221,Minnesota Timberwolves,104
Mar 15 2017,0,Chicago Bulls,-7,91,8:00p,189,Memphis Grizzlies,98
Mar 15 2017,0,Detroit Pistons,-14,83,7:30p,180,Utah Jazz,97
Mar 15 2017,1,Houston Rockets,39,139,8:00p,239,Los Angeles Lakers,100
Mar 15 2017,1,Indiana Pacers,21,98,7:00p,175,Charlotte Hornets,77
Mar 15 2017,0,Los Angeles Clippers,-1,96,10:30p,193,Milwaukee Bucks,97
Mar 15 2017,1,Miami Heat,8,120,7:30p,232,New Orleans Pelicans,112
Mar 15 2017,0,Phoenix Suns,-6,101,10:00p,208,Sacramento Kings,107
Mar 15 2017,0,San Antonio Spurs,-4,106,8:00p,216,Portland Trail Blazers,110
Mar 15 2017,0,Washington Wizards,-5,107,7:00p,219,Dallas Mavericks,112
Mar 16 2017,0,Atlanta Hawks,-12,91,7:30p,194,Memphis Grizzlies,103
Mar 16 2017,1,Cleveland Cavaliers,8,91,7:00p,174,Utah Jazz,83
Mar 16 2017,1,Denver Nuggets,15,129,9:00p,243,Los Angeles Clippers,114
Mar 16 2017,1,Golden State Warriors,30,122,10:30p,214,Orlando Magic,92
Mar 16 2017,0,New York Knicks,-11,110,7:30p,231,Brooklyn Nets,121
Mar 16 2017,0,Toronto Raptors,-21,102,7:00p,225,Oklahoma City Thunder,123
Mar 17 2017,0,Brooklyn Nets,-3,95,7:30p,193,Boston Celtics,98
Mar 17 2017,0,Detroit Pistons,-12,75,7:30p,162,Toronto Raptors,87
Mar 17 2017,0,Los Angeles Lakers,-4,103,10:30p,210,Milwaukee Bucks,107
Mar 17 2017,1,Miami Heat,18,123,8:00p,228,Minnesota Timberwolves,105
Mar 17 2017,1,New Orleans Pelicans,16,128,8:00p,240,Houston Rockets,112
Mar 17 2017,1,Philadelphia 76ers,42,116,7:00p,190,Dallas Mavericks,74
Mar 17 2017,0,Phoenix Suns,-6,103,10:00p,212,Orlando Magic,109
Mar 17 2017,1,Washington Wizards,5,112,7:00p,219,Chicago Bulls,107
Mar 18 2017,0,Atlanta Hawks,-16,97,6:00p,210,Portland Trail Blazers,113
Mar 18 2017,1,Chicago Bulls,9,95,9:00p,181,Utah Jazz,86
Mar 18 2017,1,Charlotte Hornets,5,98,7:00p,191,Washington Wizards,93
Mar 18 2017,0,Denver Nuggets,-4,105,9:30p,214,Houston Rockets,109
Mar 18 2017,1,Golden State Warriors,25,117,10:30p,209,Milwaukee Bucks,92
Mar 18 2017,1,Los Angeles Clippers,30,108,8:30p,186,Cleveland Cavaliers,78
Mar 18 2017,1,Memphis Grizzlies,8,104,9:00p,200,San Antonio Spurs,96
Mar 18 2017,1,Oklahoma City Thunder,16,110,3:00p,204,Sacramento Kings,94
Mar 19 2017,0,Brooklyn Nets,-7,104,12:00p,215,Dallas Mavericks,111
Mar 19 2017,1,Detroit Pistons,17,112,4:30p,207,Phoenix Suns,95
Mar 19 2017,0,Los Angeles Lakers,-5,120,9:30p,245,Cleveland Cavaliers,125
Mar 19 2017,0,Miami Heat,-11,104,6:00p,219,Portland Trail Blazers,115
Mar 19 2017,1,New Orleans Pelicans,14,123,6:00p,232,Minnesota Timberwolves,109
Mar 19 2017,1,Philadelphia 76ers,6,105,1:00p,204,Boston Celtics,99
Mar 19 2017,1,San Antonio Spurs,16,118,7:00p,220,Sacramento Kings,102
Mar 19 2017,1,Toronto Raptors,25,116,6:00p,207,Indiana Pacers,91
Mar 20 2017,1,Boston Celtics,8,110,7:30p,212,Washington Wizards,102
Mar 20 2017,1,Charlotte Hornets,15,105,7:00p,195,Atlanta Hawks,90
Mar 20 2017,1,Houston Rockets,1,125,8:00p,249,Denver Nuggets,124
Mar 20 2017,1,Indiana Pacers,7,107,7:00p,207,Utah Jazz,100
Mar 20 2017,1,Los Angeles Clippers,9,114,10:30p,219,New York Knicks,105
Mar 20 2017,0,Oklahoma City Thunder,-16,95,8:00p,206,Golden State Warriors,111
Mar 20 2017,1,Orlando Magic,3,112,7:00p,221,Philadelphia 76ers,109
Mar 21 2017,1,Brooklyn Nets,2,98,7:30p,194,Detroit Pistons,96
Mar 21 2017,0,Dallas Mavericks,-25,87,8:30p,199,Golden State Warriors,112
Mar 21 2017,0,Los Angeles Lakers,-24,109,10:30p,242,Los Angeles Clippers,133
Mar 21 2017,1,Miami Heat,15,112,7:30p,209,Phoenix Suns,97
Mar 21 2017,0,Minnesota Timberwolves,-7,93,9:30p,193,San Antonio Spurs,100
Mar 21 2017,1,New Orleans Pelicans,13,95,8:00p,177,Memphis Grizzlies,82
Mar 21 2017,0,Portland Trail Blazers,-3,90,10:00p,183,Milwaukee Bucks,93
Mar 21 2017,1,Toronto Raptors,2,122,7:00p,242,Chicago Bulls,120
Mar 22 2017,1,Boston Celtics,9,109,7:30p,209,Indiana Pacers,100
Mar 22 2017,1,Chicago Bulls,22,117,8:00p,212,Detroit Pistons,95
Mar 22 2017,1,Denver Nuggets,13,126,9:00p,239,Cleveland Cavaliers,113
Mar 22 2017,1,Oklahoma City Thunder,25,122,8:00p,219,Philadelphia 76ers,97
Mar 22 2017,0,Orlando Magic,-7,102,7:00p,211,Charlotte Hornets,109
Mar 22 2017,0,Sacramento Kings,-18,98,10:30p,214,Milwaukee Bucks,116
Mar 22 2017,1,Utah Jazz,7,108,10:30p,209,New York Knicks,101
Mar 22 2017,1,Washington Wizards,4,104,8:00p,204,Atlanta Hawks,100
Mar 23 2017,1,Brooklyn Nets,28,126,7:30p,224,Phoenix Suns,98
Mar 23 2017,1,Dallas Mavericks,2,97,8:30p,192,Los Angeles Clippers,95
Mar 23 2017,0,Miami Heat,-17,84,7:30p,185,Toronto Raptors,101
Mar 23 2017,1,Portland Trail Blazers,15,110,10:00p,205,New York Knicks,95
Mar 23 2017,1,San Antonio Spurs,7,97,8:30p,187,Memphis Grizzlies,90
Mar 24 2017,1,Boston Celtics,10,130,7:30p,250,Phoenix Suns,120
Mar 24 2017,0,Chicago Bulls,-10,107,8:00p,224,Philadelphia 76ers,117
Mar 24 2017,0,Charlotte Hornets,-7,105,7:00p,217,Cleveland Cavaliers,112
Mar 24 2017,1,Golden State Warriors,14,114,10:30p,214,Sacramento Kings,100
Mar 24 2017,1,Houston Rockets,10,117,8:00p,224,New Orleans Pelicans,107
Mar 24 2017,0,Indiana Pacers,-8,117,7:00p,242,Denver Nuggets,125
Mar 24 2017,1,Los Angeles Lakers,11,130,10:30p,249,Minnesota Timberwolves,119
Mar 24 2017,1,Milwaukee Bucks,3,100,8:00p,197,Atlanta Hawks,97
Mar 24 2017,1,Orlando Magic,28,115,7:00p,202,Detroit Pistons,87
Mar 24 2017,1,Washington Wizards,21,129,7:00p,237,Brooklyn Nets,108
Mar 25 2017,0,Cleveland Cavaliers,-12,115,7:30p,242,Washington Wizards,127
Mar 25 2017,0,Dallas Mavericks,-8,86,8:30p,180,Toronto Raptors,94
Mar 25 2017,1,Los Angeles Clippers,13,108,3:30p,203,Utah Jazz,95
Mar 25 2017,1,Portland Trail Blazers,12,112,10:00p,212,Minnesota Timberwolves,100
Mar 25 2017,1,San Antonio Spurs,8,106,8:30p,204,New York Knicks,98
Mar 26 2017,0,Atlanta Hawks,-15,92,1:00p,199,Brooklyn Nets,107
Mar 26 2017,1,Boston Celtics,4,112,6:00p,220,Miami Heat,108
Mar 26 2017,1,Charlotte Hornets,14,120,1:00p,226,Phoenix Suns,106
Mar 26 2017,0,Denver Nuggets,-25,90,8:00p,205,New Orleans Pelicans,115
Mar 26 2017,1,Golden State Warriors,12,106,8:00p,200,Memphis Grizzlies,94
Mar 26 2017,1,Houston Rockets,12,137,3:30p,262,Oklahoma City Thunder,125
Mar 26 2017,1,Indiana Pacers,13,107,6:00p,201,Philadelphia 76ers,94
Mar 26 2017,0,Los Angeles Clippers,-1,97,3:30p,195,Sacramento Kings,98
Mar 26 2017,0,Los Angeles Lakers,-16,81,9:30p,178,Portland Trail Blazers,97
Mar 26 2017,0,Milwaukee Bucks,-15,94,3:30p,203,Chicago Bulls,109
Mar 27 2017,0,Dallas Mavericks,-1,91,8:30p,183,Oklahoma City Thunder,92
Mar 27 2017,1,New York Knicks,14,109,7:30p,204,Detroit Pistons,95
Mar 27 2017,1,Sacramento Kings,1,91,10:30p,181,Memphis Grizzlies,90
Mar 27 2017,1,San Antonio Spurs,29,103,8:00p,177,Cleveland Cavaliers,74
Mar 27 2017,1,Toronto Raptors,19,131,7:30p,243,Orlando Magic,112
Mar 27 2017,1,Utah Jazz,8,108,10:30p,208,New Orleans Pelicans,100
Mar 28 2017,1,Atlanta Hawks,4,95,7:30p,186,Phoenix Suns,91
Mar 28 2017,0,Brooklyn Nets,-5,101,7:30p,207,Philadelphia 76ers,106
Mar 28 2017,0,Charlotte Hornets,-10,108,7:00p,226,Milwaukee Bucks,118
Mar 28 2017,0,Detroit Pistons,-1,96,7:30p,193,Miami Heat,97
Mar 28 2017,0,Houston Rockets,-7,106,8:00p,219,Golden State Warriors,113
Mar 28 2017,0,Indiana Pacers,-1,114,7:00p,229,Minnesota Timberwolves,115
Mar 28 2017,0,Los Angeles Lakers,-11,108,10:30p,227,Washington Wizards,119
Mar 28 2017,1,Portland Trail Blazers,9,122,10:00p,235,Denver Nuggets,113
Mar 29 2017,0,Boston Celtics,-3,100,7:30p,203,Milwaukee Bucks,103
Mar 29 2017,1,Los Angeles Clippers,9,133,10:30p,257,Washington Wizards,124
Mar 29 2017,1,Memphis Grizzlies,13,110,8:00p,207,Indiana Pacers,97
Mar 29 2017,1,New Orleans Pelicans,3,121,8:00p,239,Dallas Mavericks,118
Mar 29 2017,0,New York Knicks,-17,88,7:30p,193,Miami Heat,105
Mar 29 2017,0,Orlando Magic,-8,106,7:00p,220,Oklahoma City Thunder,114
Mar 29 2017,0,Philadelphia 76ers,-7,92,7:00p,191,Atlanta Hawks,99
Mar 29 2017,0,Sacramento Kings,-30,82,10:30p,194,Utah Jazz,112
Mar 29 2017,0,San Antonio Spurs,-12,98,9:30p,208,Golden State Warriors,110
Mar 29 2017,0,Toronto Raptors,-4,106,7:30p,216,Charlotte Hornets,110
Mar 30 2017,1,Chicago Bulls,6,99,8:00p,192,Cleveland Cavaliers,93
Mar 30 2017,1,Detroit Pistons,1,90,7:30p,179,Brooklyn Nets,89
Mar 30 2017,1,Minnesota Timberwolves,15,119,8:00p,223,Los Angeles Lakers,104
Mar 30 2017,0,Phoenix Suns,-6,118,10:00p,242,Los Angeles Clippers,124
Mar 30 2017,1,Portland Trail Blazers,10,117,10:30p,224,Houston Rockets,107
Mar 31 2017,1,Boston Celtics,1,117,7:30p,233,Orlando Magic,116
Mar 31 2017,1,Charlotte Hornets,8,122,7:00p,236,Denver Nuggets,114
Mar 31 2017,1,Cleveland Cavaliers,17,122,7:30p,227,Philadelphia 76ers,105
Mar 31 2017,1,Golden State Warriors,9,107,10:30p,205,Houston Rockets,98
Mar 31 2017,1,Memphis Grizzlies,9,99,8:00p,189,Dallas Mavericks,90
Mar 31 2017,0,Miami Heat,-4,94,8:00p,192,New York Knicks,98
Mar 31 2017,1,Milwaukee Bucks,3,108,8:00p,213,Detroit Pistons,105
Mar 31 2017,1,New Orleans Pelicans,28,117,8:00p,206,Sacramento Kings,89
Mar 31 2017,0,Oklahoma City Thunder,-5,95,8:00p,195,San Antonio Spurs,100
Mar 31 2017,1,Toronto Raptors,11,111,7:00p,211,Indiana Pacers,100
Mar 31 2017,1,Utah Jazz,7,95,9:00p,183,Washington Wizards,88
Oct 27 2015,0,Atlanta Hawks,-12,94,8:00p,200,Detroit Pistons,106
Oct 27 2015,1,Chicago Bulls,2,97,8:00p,192,Cleveland Cavaliers,95
Oct 27 2015,1,Golden State Warriors,16,111,10:30p,206,New Orleans Pelicans,95
Oct 28 2015,1,Boston Celtics,17,112,7:30p,207,Philadelphia 76ers,95
Oct 28 2015,0,Brooklyn Nets,-15,100,7:30p,215,Chicago Bulls,115
Oct 28 2015,1,Detroit Pistons,5,92,7:30p,179,Utah Jazz,87
Oct 28 2015,0,Houston Rockets,-20,85,8:00p,190,Denver Nuggets,105
Oct 28 2015,0,Los Angeles Lakers,-1,111,10:30p,223,Minnesota Timberwolves,112
Oct 28 2015,0,Memphis Grizzlies,-30,76,8:00p,182,Cleveland Cavaliers,106
Oct 28 2015,1,Miami Heat,10,104,7:30p,198,Charlotte Hornets,94
Oct 28 2015,0,Milwaukee Bucks,-25,97,8:00p,219,New York Knicks,122
Oct 28 2015,1,Oklahoma City Thunder,6,112,8:00p,218,San Antonio Spurs,106
Oct 28 2015,0,Orlando Magic,-1,87,7:00p,175,Washington Wizards,88
Oct 28 2015,0,Phoenix Suns,-16,95,10:00p,206,Dallas Mavericks,111
Oct 28 2015,1,Portland Trail Blazers,18,112,10:00p,206,New Orleans Pelicans,94
Oct 28 2015,0,Sacramento Kings,-7,104,10:00p,215,Los Angeles Clippers,111
Oct 28 2015,1,Toronto Raptors,7,106,7:30p,205,Indiana Pacers,99
Oct 29 2015,0,Indiana Pacers,-9,103,7:00p,215,Memphis Grizzlies,112
Oct 29 2015,1,Los Angeles Clippers,16,104,10:30p,192,Dallas Mavericks,88
Oct 29 2015,0,New York Knicks,-11,101,8:00p,213,Atlanta Hawks,112
Oct 30 2015,1,Atlanta Hawks,3,97,8:00p,191,Charlotte Hornets,94
Oct 30 2015,0,Boston Celtics,-10,103,7:30p,216,Toronto Raptors,113
Oct 30 2015,1,Cleveland Cavaliers,10,102,7:00p,194,Miami Heat,92
Oct 30 2015,0,Denver Nuggets,-17,78,9:00p,173,Minnesota Timberwolves,95
Oct 30 2015,1,Detroit Pistons,4,98,7:30p,192,Chicago Bulls,94
Oct 30 2015,0,Houston Rockets,-20,92,9:30p,204,Golden State Warriors,112
Oct 30 2015,0,Milwaukee Bucks,-5,113,8:00p,231,Washington Wizards,118
Oct 30 2015,0,Orlando Magic,-3,136,7:00p,275,Oklahoma City Thunder,139
Oct 30 2015,0,Philadelphia 76ers,-28,71,7:00p,170,Utah Jazz,99
Oct 30 2015,1,Phoenix Suns,18,110,10:30p,202,Portland Trail Blazers,92
Oct 30 2015,1,Sacramento Kings,18,132,10:00p,246,Los Angeles Lakers,114
Oct 30 2015,1,San Antonio Spurs,27,102,8:30p,177,Brooklyn Nets,75
Oct 31 2015,0,Indiana Pacers,-21,76,7:00p,173,Utah Jazz,97
Oct 31 2015,1,Los Angeles Clippers,5,114,10:30p,223,Sacramento Kings,109
Oct 31 2015,1,Memphis Grizzlies,10,101,8:00p,192,Brooklyn Nets,91
Oct 31 2015,0,New Orleans Pelicans,-14,120,7:30p,254,Golden State Warriors,134
Oct 31 2015,0,Portland Trail Blazers,-11,90,10:00p,191,Phoenix Suns,101
Oct 31 2015,0,Washington Wizards,-7,110,7:00p,227,New York Knicks,117
Nov 1 2015,0,Boston Celtics,-8,87,3:30p,182,San Antonio Spurs,95
Nov 1 2015,1,Chicago Bulls,5,92,7:00p,179,Orlando Magic,87
Nov 1 2015,0,Charlotte Hornets,-2,92,2:00p,186,Atlanta Hawks,94
Nov 1 2015,0,Los Angeles Lakers,-10,93,9:30p,196,Dallas Mavericks,103
Nov 1 2015,1,Miami Heat,20,109,6:00p,198,Houston Rockets,89
Nov 1 2015,1,Oklahoma City Thunder,24,117,7:00p,210,Denver Nuggets,93
Nov 1 2015,1,Toronto Raptors,19,106,6:00p,193,Milwaukee Bucks,87
Nov 2 2015,0,Brooklyn Nets,-7,96,7:30p,199,Milwaukee Bucks,103
Nov 2 2015,1,Golden State Warriors,50,119,10:30p,188,Memphis Grizzlies,69
Nov 2 2015,1,Houston Rockets,5,110,8:00p,215,Oklahoma City Thunder,105
Nov 2 2015,1,Los Angeles Clippers,6,102,10:30p,198,Phoenix Suns,96
Nov 2 2015,0,Minnesota Timberwolves,-5,101,8:00p,207,Portland Trail Blazers,106
Nov 2 2015,0,New York Knicks,-10,84,7:30p,178,San Antonio Spurs,94
Nov 2 2015,0,Philadelphia 76ers,-7,100,7:00p,207,Cleveland Cavaliers,107
Nov 3 2015,1,Charlotte Hornets,25,130,7:00p,235,Chicago Bulls,105
Nov 3 2015,0,Dallas Mavericks,-11,91,8:30p,193,Toronto Raptors,102
Nov 3 2015,0,Detroit Pistons,-12,82,7:30p,176,Indiana Pacers,94
Nov 3 2015,0,Los Angeles Lakers,-11,109,10:30p,229,Denver Nuggets,120
Nov 3 2015,0,Miami Heat,-6,92,7:30p,190,Atlanta Hawks,98
Nov 3 2015,0,New Orleans Pelicans,-9,94,8:00p,197,Orlando Magic,103
Nov 3 2015,0,Sacramento Kings,-14,89,10:00p,192,Memphis Grizzlies,103
Nov 4 2015,1,Atlanta Hawks,14,101,8:00p,188,Brooklyn Nets,87
Nov 4 2015,1,Cleveland Cavaliers,10,96,8:00p,182,New York Knicks,86
Nov 4 2015,1,Golden State Warriors,4,112,10:30p,220,Los Angeles Clippers,108
Nov 4 2015,1,Houston Rockets,5,119,8:00p,233,Orlando Magic,114
Nov 4 2015,1,Indiana Pacers,2,100,7:00p,198,Boston Celtics,98
Nov 4 2015,1,Milwaukee Bucks,4,91,8:00p,178,Philadelphia 76ers,87
Nov 4 2015,0,Oklahoma City Thunder,-5,98,8:00p,201,Toronto Raptors,103
Nov 4 2015,1,Phoenix Suns,21,118,9:00p,215,Sacramento Kings,97
Nov 4 2015,0,Utah Jazz,-16,92,9:00p,200,Portland Trail Blazers,108
Nov 4 2015,1,Washington Wizards,3,102,7:00p,201,San Antonio Spurs,99
Nov 5 2015,1,Chicago Bulls,6,104,8:00p,202,Oklahoma City Thunder,98
Nov 5 2015,0,Dallas Mavericks,-14,94,8:30p,202,Charlotte Hornets,108
Nov 5 2015,0,Denver Nuggets,-12,84,9:00p,180,Utah Jazz,96
Nov 5 2015,0,Minnesota Timberwolves,-12,84,8:00p,180,Miami Heat,96
Nov 5 2015,1,Portland Trail Blazers,19,115,10:30p,211,Memphis Grizzlies,96
Nov 6 2015,1,Boston Celtics,20,118,7:30p,216,Washington Wizards,98
Nov 6 2015,0,Brooklyn Nets,-6,98,7:30p,202,Los Angeles Lakers,104
Nov 6 2015,1,Cleveland Cavaliers,6,108,7:30p,210,Philadelphia 76ers,102
Nov 6 2015,1,Golden State Warriors,15,119,10:30p,223,Denver Nuggets,104
Nov 6 2015,1,Indiana Pacers,3,90,8:00p,177,Miami Heat,87
Nov 6 2015,0,New Orleans Pelicans,-6,115,8:00p,236,Atlanta Hawks,121
Nov 6 2015,0,New York Knicks,-7,92,7:30p,191,Milwaukee Bucks,99
Nov 6 2015,1,Orlando Magic,5,92,7:00p,179,Toronto Raptors,87
Nov 6 2015,0,Phoenix Suns,-8,92,9:30p,192,Detroit Pistons,100
Nov 6 2015,0,Sacramento Kings,-6,110,10:30p,226,Houston Rockets,116
Nov 7 2015,1,Atlanta Hawks,15,114,7:30p,213,Washington Wizards,99
Nov 7 2015,0,Chicago Bulls,-9,93,6:00p,195,Minnesota Timberwolves,102
Nov 7 2015,1,Dallas Mavericks,9,107,8:30p,205,New Orleans Pelicans,98
Nov 7 2015,0,Los Angeles Clippers,-4,105,10:30p,214,Houston Rockets,109
Nov 7 2015,1,Milwaukee Bucks,8,94,8:30p,180,Brooklyn Nets,86
Nov 7 2015,0,Philadelphia 76ers,-8,97,7:00p,202,Orlando Magic,105
Nov 7 2015,0,Sacramento Kings,-9,94,10:00p,197,Golden State Warriors,103
Nov 7 2015,1,San Antonio Spurs,20,114,8:30p,208,Charlotte Hornets,94
Nov 7 2015,1,Utah Jazz,10,89,9:00p,168,Memphis Grizzlies,79
Nov 8 2015,1,Cleveland Cavaliers,4,101,3:30p,198,Indiana Pacers,97
Nov 8 2015,1,Miami Heat,20,96,6:00p,172,Toronto Raptors,76
Nov 8 2015,1,New York Knicks,4,99,3:30p,194,Los Angeles Lakers,95
Nov 8 2015,1,Oklahoma City Thunder,21,124,7:00p,227,Phoenix Suns,103
Nov 8 2015,0,Portland Trail Blazers,-17,103,9:00p,223,Detroit Pistons,120
Nov 9 2015,0,Atlanta Hawks,-10,107,8:00p,224,Minnesota Timberwolves,117
Nov 9 2015,1,Denver Nuggets,4,108,9:00p,212,Portland Trail Blazers,104
Nov 9 2015,1,Golden State Warriors,14,109,10:30p,204,Detroit Pistons,95
Nov 9 2015,1,Indiana Pacers,13,97,7:00p,181,Orlando Magic,84
Nov 9 2015,1,Los Angeles Clippers,2,94,10:30p,186,Memphis Grizzlies,92
Nov 9 2015,0,Philadelphia 76ers,-23,88,7:00p,199,Chicago Bulls,111
Nov 9 2015,0,Sacramento Kings,-18,88,10:00p,194,San Antonio Spurs,106
Nov 10 2015,1,Cleveland Cavaliers,4,118,7:00p,232,Utah Jazz,114
Nov 10 2015,1,Miami Heat,13,101,7:30p,189,Los Angeles Lakers,88
Nov 10 2015,0,Milwaukee Bucks,-16,83,8:00p,182,Boston Celtics,99
Nov 10 2015,0,Minnesota Timberwolves,-9,95,8:00p,199,Charlotte Hornets,104
Nov 10 2015,1,New Orleans Pelicans,15,120,8:00p,225,Dallas Mavericks,105
Nov 10 2015,0,Toronto Raptors,-2,109,7:30p,220,New York Knicks,111
Nov 10 2015,0,Washington Wizards,-24,101,7:00p,226,Oklahoma City Thunder,125
Nov 11 2015,1,Atlanta Hawks,8,106,8:00p,204,New Orleans Pelicans,98
Nov 11 2015,0,Boston Celtics,-11,91,7:30p,193,Indiana Pacers,102
Nov 11 2015,1,Charlotte Hornets,2,95,7:00p,188,New York Knicks,93
Nov 11 2015,1,Dallas Mavericks,10,118,8:00p,226,Los Angeles Clippers,108
Nov 11 2015,1,Denver Nuggets,1,103,9:00p,205,Milwaukee Bucks,102
Nov 11 2015,0,Houston Rockets,-8,98,8:00p,204,Brooklyn Nets,106
Nov 11 2015,0,Memphis Grizzlies,-16,84,8:00p,184,Golden State Warriors,100
Nov 11 2015,1,Orlando Magic,2,101,7:00p,200,Los Angeles Lakers,99
Nov 11 2015,0,Philadelphia 76ers,-16,103,7:00p,222,Toronto Raptors,119
Nov 11 2015,0,Portland Trail Blazers,-12,101,10:30p,214,San Antonio Spurs,113
Nov 11 2015,1,Sacramento Kings,9,101,10:00p,193,Detroit Pistons,92
Nov 12 2015,1,Miami Heat,1,92,7:30p,183,Utah Jazz,91
Nov 12 2015,0,Minnesota Timberwolves,-13,116,8:00p,245,Golden State Warriors,129
Nov 12 2015,1,Phoenix Suns,14,118,10:30p,222,Los Angeles Clippers,104
Nov 13 2015,1,Boston Celtics,13,106,7:30p,199,Atlanta Hawks,93
Nov 13 2015,1,Chicago Bulls,5,102,8:00p,199,Charlotte Hornets,97
Nov 13 2015,1,Dallas Mavericks,8,90,8:30p,172,Los Angeles Lakers,82
Nov 13 2015,1,Denver Nuggets,9,107,9:00p,205,Houston Rockets,98
Nov 13 2015,1,Indiana Pacers,4,107,7:00p,210,Minnesota Timberwolves,103
Nov 13 2015,1,Memphis Grizzlies,1,101,8:00p,201,Portland Trail Blazers,100
Nov 13 2015,0,New York Knicks,-6,84,7:30p,174,Cleveland Cavaliers,90
Nov 13 2015,1,Oklahoma City Thunder,17,102,8:00p,187,Philadelphia 76ers,85
Nov 13 2015,1,Orlando Magic,9,102,7:00p,195,Utah Jazz,93
Nov 13 2015,1,Sacramento Kings,2,111,10:00p,220,Brooklyn Nets,109
Nov 13 2015,1,Toronto Raptors,19,100,7:30p,181,New Orleans Pelicans,81
Nov 14 2015,1,Golden State Warriors,8,107,10:30p,206,Brooklyn Nets,99
Nov 14 2015,0,Houston Rockets,-12,98,8:00p,208,Dallas Mavericks,110
Nov 14 2015,1,Los Angeles Clippers,5,101,3:30p,197,Detroit Pistons,96
Nov 14 2015,1,Milwaukee Bucks,3,108,8:30p,213,Cleveland Cavaliers,105
Nov 14 2015,1,Phoenix Suns,24,105,9:00p,186,Denver Nuggets,81
Nov 14 2015,1,San Antonio Spurs,9,92,8:30p,175,Philadelphia 76ers,83
Nov 14 2015,1,Washington Wizards,9,108,7:00p,207,Orlando Magic,99
Nov 15 2015,0,Atlanta Hawks,-1,96,6:00p,193,Utah Jazz,97
Nov 15 2015,1,Charlotte Hornets,12,106,5:00p,200,Portland Trail Blazers,94
Nov 15 2015,1,Los Angeles Lakers,12,97,9:30p,182,Detroit Pistons,85
Nov 15 2015,0,Minnesota Timberwolves,-8,106,3:30p,220,Memphis Grizzlies,114
Nov 15 2015,1,New York Knicks,8,95,12:00p,182,New Orleans Pelicans,87
Nov 15 2015,0,Oklahoma City Thunder,-15,85,7:00p,185,Boston Celtics,100
Nov 15 2015,1,Sacramento Kings,6,107,9:00p,208,Toronto Raptors,101
Nov 16 2015,1,Chicago Bulls,1,96,8:00p,191,Indiana Pacers,95
Nov 16 2015,0,Houston Rockets,-16,95,8:00p,206,Boston Celtics,111
Nov 16 2015,1,Memphis Grizzlies,8,122,8:00p,236,Oklahoma City Thunder,114
Nov 16 2015,0,Philadelphia 76ers,-6,86,7:00p,178,Dallas Mavericks,92
Nov 16 2015,1,Phoenix Suns,19,120,9:00p,221,Los Angeles Lakers,101
Nov 16 2015,1,San Antonio Spurs,13,93,8:30p,173,Portland Trail Blazers,80
Nov 17 2015,1,Brooklyn Nets,2,90,7:30p,178,Atlanta Hawks,88
Nov 17 2015,1,Detroit Pistons,5,104,7:30p,203,Cleveland Cavaliers,99
Nov 17 2015,1,Golden State Warriors,5,115,10:30p,225,Toronto Raptors,110
Nov 17 2015,0,Miami Heat,-12,91,7:30p,194,Minnesota Timberwolves,103
Nov 17 2015,0,New Orleans Pelicans,-17,98,8:00p,213,Denver Nuggets,115
Nov 17 2015,1,New York Knicks,8,102,7:30p,196,Charlotte Hornets,94
Nov 17 2015,1,Washington Wizards,29,115,7:00p,201,Milwaukee Bucks,86
Nov 18 2015,1,Atlanta Hawks,6,103,8:00p,200,Sacramento Kings,97
Nov 18 2015,0,Boston Celtics,-4,102,7:30p,208,Dallas Mavericks,106
Nov 18 2015,1,Charlotte Hornets,5,116,7:00p,227,Brooklyn Nets,111
Nov 18 2015,1,Houston Rockets,5,108,8:00p,211,Portland Trail Blazers,103
Nov 18 2015,1,Oklahoma City Thunder,7,110,8:00p,213,New Orleans Pelicans,103
Nov 18 2015,1,Orlando Magic,3,104,7:00p,205,Minnesota Timberwolves,101
Nov 18 2015,0,Philadelphia 76ers,-27,85,7:00p,197,Indiana Pacers,112
Nov 18 2015,0,Phoenix Suns,-6,97,10:30p,200,Chicago Bulls,103
Nov 18 2015,1,San Antonio Spurs,11,109,8:30p,207,Denver Nuggets,98
Nov 18 2015,1,Utah Jazz,4,93,9:00p,182,Toronto Raptors,89
Nov 19 2015,1,Cleveland Cavaliers,15,115,8:00p,215,Milwaukee Bucks,100
Nov 19 2015,0,Los Angeles Clippers,-7,117,10:30p,241,Golden State Warriors,124
Nov 19 2015,1,Miami Heat,7,116,7:30p,225,Sacramento Kings,109
Nov 20 2015,1,Boston Celtics,25,120,7:30p,215,Brooklyn Nets,95
Nov 20 2015,1,Charlotte Hornets,25,113,7:00p,201,Philadelphia 76ers,88
Nov 20 2015,1,Dallas Mavericks,9,102,8:30p,195,Utah Jazz,93
Nov 20 2015,0,Denver Nuggets,-7,107,9:00p,221,Phoenix Suns,114
Nov 20 2015,1,Golden State Warriors,12,106,10:30p,200,Chicago Bulls,94
Nov 20 2015,0,Los Angeles Lakers,-11,91,10:30p,193,Toronto Raptors,102
Nov 20 2015,1,Memphis Grizzlies,12,96,8:00p,180,Houston Rockets,84
Nov 20 2015,0,Minnesota Timberwolves,-10,86,8:00p,182,Detroit Pistons,96
Nov 20 2015,1,New Orleans Pelicans,14,104,8:00p,194,San Antonio Spurs,90
Nov 20 2015,0,Oklahoma City Thunder,-3,90,8:00p,183,New York Knicks,93
Nov 20 2015,1,Portland Trail Blazers,11,102,10:00p,193,Los Angeles Clippers,91
Nov 21 2015,1,Cleveland Cavaliers,12,109,7:30p,206,Atlanta Hawks,97
Nov 21 2015,0,Detroit Pistons,-2,95,7:30p,192,Washington Wizards,97
Nov 21 2015,0,Houston Rockets,-5,102,8:00p,209,New York Knicks,107
Nov 21 2015,1,Indiana Pacers,37,123,7:00p,209,Milwaukee Bucks,86
Nov 21 2015,1,Miami Heat,5,96,8:00p,187,Philadelphia 76ers,91
Nov 21 2015,0,Orlando Magic,-6,91,5:00p,188,Sacramento Kings,97
Nov 21 2015,1,San Antonio Spurs,10,92,8:30p,174,Memphis Grizzlies,82
Nov 22 2015,1,Brooklyn Nets,10,111,6:00p,212,Boston Celtics,101
Nov 22 2015,0,Denver Nuggets,-13,105,8:00p,223,Golden State Warriors,118
Nov 22 2015,0,Los Angeles Clippers,-11,80,3:30p,171,Toronto Raptors,91
Nov 22 2015,0,Los Angeles Lakers,-14,93,9:30p,200,Portland Trail Blazers,107
Nov 22 2015,1,New Orleans Pelicans,6,122,6:00p,238,Phoenix Suns,116
Nov 22 2015,1,Oklahoma City Thunder,3,117,7:00p,231,Dallas Mavericks,114
Nov 23 2015,1,Charlotte Hornets,5,127,7:00p,249,Sacramento Kings,122
Nov 23 2015,1,Cleveland Cavaliers,14,117,7:00p,220,Orlando Magic,103
Nov 23 2015,1,Miami Heat,17,95,7:30p,173,New York Knicks,78
Nov 23 2015,1,Milwaukee Bucks,21,109,8:00p,197,Detroit Pistons,88
Nov 23 2015,1,Minnesota Timberwolves,5,100,8:00p,195,Philadelphia 76ers,95
Nov 23 2015,1,San Antonio Spurs,14,98,8:30p,182,Phoenix Suns,84
Nov 23 2015,0,Utah Jazz,-22,89,9:00p,200,Oklahoma City Thunder,111
Nov 24 2015,1,Atlanta Hawks,24,121,8:00p,218,Boston Celtics,97
Nov 24 2015,0,Denver Nuggets,-17,94,9:00p,205,Los Angeles Clippers,111
Nov 24 2015,1,Golden State Warriors,34,111,10:30p,188,Los Angeles Lakers,77
Nov 24 2015,1,Memphis Grizzlies,14,110,8:00p,206,Dallas Mavericks,96
Nov 24 2015,0,Portland Trail Blazers,-5,88,10:00p,181,Chicago Bulls,93
Nov 24 2015,0,Washington Wizards,-17,106,7:00p,229,Indiana Pacers,123
Nov 25 2015,1,Boston Celtics,4,84,7:30p,164,Philadelphia 76ers,80
Nov 25 2015,1,Charlotte Hornets,14,101,7:00p,188,Washington Wizards,87
Nov 25 2015,1,Detroit Pistons,23,104,7:30p,185,Miami Heat,81
Nov 25 2015,0,Houston Rockets,-9,93,8:00p,195,Memphis Grizzlies,102
Nov 25 2015,0,Los Angeles Clippers,-11,91,10:30p,193,Utah Jazz,102
Nov 25 2015,0,Milwaukee Bucks,-11,118,8:00p,247,Sacramento Kings,129
Nov 25 2015,1,Minnesota Timberwolves,4,99,8:00p,194,Atlanta Hawks,95
Nov 25 2015,1,Oklahoma City Thunder,11,110,8:00p,209,Brooklyn Nets,99
Nov 25 2015,1,Orlando Magic,9,100,7:00p,191,New York Knicks,91
Nov 25 2015,0,Phoenix Suns,-6,114,9:00p,234,New Orleans Pelicans,120
Nov 25 2015,1,San Antonio Spurs,5,88,8:30p,171,Dallas Mavericks,83
Nov 25 2015,1,Toronto Raptors,4,103,7:30p,202,Cleveland Cavaliers,99
Nov 27 2015,1,Boston Celtics,33,111,7:30p,189,Washington Wizards,78
Nov 27 2015,0,Charlotte Hornets,-5,90,7:00p,185,Cleveland Cavaliers,95
Nov 27 2015,0,Denver Nuggets,-11,80,9:00p,171,San Antonio Spurs,91
Nov 27 2015,1,Houston Rockets,2,116,8:00p,230,Philadelphia 76ers,114
Nov 27 2015,1,Indiana Pacers,12,104,8:00p,196,Chicago Bulls,92
Nov 27 2015,1,Los Angeles Clippers,21,111,10:30p,201,New Orleans Pelicans,90
Nov 27 2015,0,Memphis Grizzlies,-15,101,8:00p,217,Atlanta Hawks,116
Nov 27 2015,0,New York Knicks,-19,78,7:30p,175,Miami Heat,97
Nov 27 2015,1,Oklahoma City Thunder,16,103,8:00p,190,Detroit Pistons,87
Nov 27 2015,1,Orlando Magic,24,114,7:00p,204,Milwaukee Bucks,90
Nov 27 2015,0,Phoenix Suns,-19,116,9:30p,251,Golden State Warriors,135
Nov 27 2015,0,Sacramento Kings,-10,91,10:00p,192,Minnesota Timberwolves,101
Nov 28 2015,1,Cleveland Cavaliers,2,90,7:30p,178,Brooklyn Nets,88
Nov 28 2015,1,Dallas Mavericks,11,92,8:30p,173,Denver Nuggets,81
Nov 28 2015,1,Golden State Warriors,19,120,10:30p,221,Sacramento Kings,101
Nov 28 2015,1,Portland Trail Blazers,12,108,10:00p,204,Los Angeles Lakers,96
Nov 28 2015,1,San Antonio Spurs,20,108,8:30p,196,Atlanta Hawks,88
Nov 28 2015,1,Utah Jazz,14,101,9:00p,188,New Orleans Pelicans,87
Nov 28 2015,0,Washington Wizards,-2,82,7:00p,166,Toronto Raptors,84
Nov 29 2015,1,Brooklyn Nets,4,87,6:00p,170,Detroit Pistons,83
Nov 29 2015,1,Charlotte Hornets,5,87,2:00p,169,Milwaukee Bucks,82
Nov 29 2015,1,Los Angeles Clippers,8,107,3:30p,206,Minnesota Timberwolves,99
Nov 29 2015,0,Los Angeles Lakers,-4,103,9:30p,210,Indiana Pacers,107
Nov 29 2015,1,Memphis Grizzlies,8,92,6:00p,176,Philadelphia 76ers,84
Nov 29 2015,0,New York Knicks,-5,111,7:30p,227,Houston Rockets,116
Nov 29 2015,1,Orlando Magic,19,110,6:00p,201,Boston Celtics,91
Nov 29 2015,0,Toronto Raptors,-5,102,6:00p,209,Phoenix Suns,107
Nov 30 2015,1,Atlanta Hawks,6,106,8:00p,206,Oklahoma City Thunder,100
Nov 30 2015,1,Chicago Bulls,3,92,8:00p,181,San Antonio Spurs,89
Nov 30 2015,1,Detroit Pistons,11,116,7:30p,221,Houston Rockets,105
Nov 30 2015,1,Los Angeles Clippers,15,102,10:30p,189,Portland Trail Blazers,87
Nov 30 2015,0,Miami Heat,-10,95,7:30p,200,Boston Celtics,105
Nov 30 2015,1,Milwaukee Bucks,18,92,8:00p,166,Denver Nuggets,74
Nov 30 2015,1,Sacramento Kings,14,112,10:00p,210,Dallas Mavericks,98
Nov 30 2015,0,Utah Jazz,-3,103,9:00p,209,Golden State Warriors,106
Dec 1 2015,1,Brooklyn Nets,3,94,7:30p,185,Phoenix Suns,91
Dec 1 2015,0,Cleveland Cavaliers,-12,85,7:00p,182,Washington Wizards,97
Dec 1 2015,0,Minnesota Timberwolves,-3,93,8:00p,189,Orlando Magic,96
Dec 1 2015,0,New Orleans Pelicans,-9,104,8:00p,217,Memphis Grizzlies,113
Dec 1 2015,1,Philadelphia 76ers,12,103,7:00p,194,Los Angeles Lakers,91
Dec 1 2015,0,Portland Trail Blazers,-3,112,10:00p,227,Dallas Mavericks,115
Dec 2 2015,0,Atlanta Hawks,-10,86,8:00p,182,Toronto Raptors,96
Dec 2 2015,1,Chicago Bulls,9,99,8:00p,189,Denver Nuggets,90
Dec 2 2015,0,Charlotte Hornets,-17,99,7:00p,215,Golden State Warriors,116
Dec 2 2015,1,Detroit Pistons,5,127,7:30p,249,Phoenix Suns,122
Dec 2 2015,1,Houston Rockets,7,108,8:00p,209,New Orleans Pelicans,101
Dec 2 2015,0,Los Angeles Clippers,-12,91,10:30p,194,Indiana Pacers,103
Dec 2 2015,1,New York Knicks,12,99,7:30p,186,Philadelphia 76ers,87
Dec 2 2015,1,San Antonio Spurs,25,95,8:30p,165,Milwaukee Bucks,70
Dec 2 2015,0,Washington Wizards,-4,104,7:00p,212,Los Angeles Lakers,108
Dec 3 2015,0,Memphis Grizzlies,-20,83,9:30p,186,San Antonio Spurs,103
Dec 3 2015,1,Miami Heat,2,97,7:00p,192,Oklahoma City Thunder,95
Dec 3 2015,1,Portland Trail Blazers,12,123,10:00p,234,Indiana Pacers,111
Dec 3 2015,0,Sacramento Kings,-17,97,10:00p,211,Boston Celtics,114
Dec 3 2015,0,Toronto Raptors,-1,105,7:30p,211,Denver Nuggets,106
Dec 3 2015,0,Utah Jazz,-9,94,9:00p,197,Orlando Magic,103
Dec 4 2015,1,Atlanta Hawks,13,100,8:00p,187,Los Angeles Lakers,87
Dec 4 2015,0,Dallas Mavericks,-4,96,8:30p,196,Houston Rockets,100
Dec 4 2015,1,Detroit Pistons,7,102,7:30p,197,Milwaukee Bucks,95
Dec 4 2015,1,New Orleans Pelicans,6,114,9:30p,222,Cleveland Cavaliers,108
Dec 4 2015,1,New York Knicks,17,108,7:00p,199,Brooklyn Nets,91
Dec 4 2015,1,Washington Wizards,3,109,7:00p,215,Phoenix Suns,106
Dec 5 2015,0,Chicago Bulls,-6,96,8:00p,198,Charlotte Hornets,102
Dec 5 2015,1,Houston Rockets,7,120,8:00p,233,Sacramento Kings,113
Dec 5 2015,1,Los Angeles Clippers,2,103,10:30p,204,Orlando Magic,101
Dec 5 2015,1,Miami Heat,15,99,8:00p,183,Cleveland Cavaliers,84
Dec 5 2015,1,Milwaukee Bucks,15,106,8:30p,197,New York Knicks,91
Dec 5 2015,0,Minnesota Timberwolves,-6,103,8:00p,212,Portland Trail Blazers,109
Dec 5 2015,0,Philadelphia 76ers,-3,105,1:00p,213,Denver Nuggets,108
Dec 5 2015,1,San Antonio Spurs,3,108,8:30p,213,Boston Celtics,105
Dec 5 2015,0,Toronto Raptors,-3,109,5:00p,221,Golden State Warriors,112
Dec 5 2015,1,Utah Jazz,3,122,9:00p,241,Indiana Pacers,119
Dec 6 2015,0,Brooklyn Nets,-16,98,6:00p,212,Golden State Warriors,114
Dec 6 2015,1,Detroit Pistons,20,111,6:00p,202,Los Angeles Lakers,91
Dec 6 2015,1,Memphis Grizzlies,2,95,3:30p,188,Phoenix Suns,93
Dec 6 2015,1,Oklahoma City Thunder,3,98,7:00p,193,Sacramento Kings,95
Dec 6 2015,0,Washington Wizards,-12,104,6:00p,220,Dallas Mavericks,116
Dec 7 2015,0,Chicago Bulls,-2,101,8:00p,204,Phoenix Suns,103
Dec 7 2015,1,Charlotte Hornets,20,104,7:00p,188,Detroit Pistons,84
Dec 7 2015,0,Miami Heat,-11,103,7:30p,217,Washington Wizards,114
Dec 7 2015,1,Milwaukee Bucks,2,90,8:00p,178,Portland Trail Blazers,88
Dec 7 2015,0,Minnesota Timberwolves,-4,106,8:00p,216,Los Angeles Clippers,110
Dec 7 2015,0,New Orleans Pelicans,-18,93,8:00p,204,Boston Celtics,111
Dec 7 2015,0,New York Knicks,-7,97,7:30p,201,Dallas Mavericks,104
Dec 7 2015,0,Philadelphia 76ers,-51,68,7:00p,187,San Antonio Spurs,119
Dec 7 2015,1,Toronto Raptors,9,102,7:30p,195,Los Angeles Lakers,93
Dec 8 2015,1,Brooklyn Nets,5,110,7:30p,215,Houston Rockets,105
Dec 8 2015,1,Cleveland Cavaliers,5,105,7:00p,205,Portland Trail Blazers,100
Dec 8 2015,0,Denver Nuggets,-11,74,9:00p,159,Orlando Magic,85
Dec 8 2015,0,Indiana Pacers,-8,123,7:00p,254,Golden State Warriors,131
Dec 8 2015,0,Memphis Grizzlies,-37,88,8:00p,213,Oklahoma City Thunder,125
Dec 8 2015,1,Sacramento Kings,8,114,10:00p,220,Utah Jazz,106
Dec 9 2015,1,Boston Celtics,5,105,7:00p,205,Chicago Bulls,100
Dec 9 2015,1,Charlotte Hornets,18,99,7:00p,180,Miami Heat,81
Dec 9 2015,0,Dallas Mavericks,-3,95,9:30p,193,Atlanta Hawks,98
Dec 9 2015,0,Detroit Pistons,-1,92,7:30p,185,Memphis Grizzlies,93
Dec 9 2015,0,Milwaukee Bucks,-14,95,8:00p,204,Los Angeles Clippers,109
Dec 9 2015,1,Minnesota Timberwolves,1,123,8:00p,245,Los Angeles Lakers,122
Dec 9 2015,1,Phoenix Suns,3,107,9:00p,211,Orlando Magic,104
Dec 9 2015,1,Toronto Raptors,3,97,7:30p,191,San Antonio Spurs,94
Dec 9 2015,1,Utah Jazz,21,106,9:00p,191,New York Knicks,85
Dec 9 2015,0,Washington Wizards,-6,103,7:00p,212,Houston Rockets,109
Dec 10 2015,1,Brooklyn Nets,9,100,7:30p,191,Philadelphia 76ers,91
Dec 10 2015,1,Chicago Bulls,3,83,8:00p,163,Los Angeles Clippers,80
Dec 10 2015,1,Oklahoma City Thunder,13,107,8:00p,201,Atlanta Hawks,94
Dec 10 2015,1,Sacramento Kings,2,99,10:30p,196,New York Knicks,97
Dec 11 2015,0,Boston Celtics,-5,119,7:30p,243,Golden State Warriors,124
Dec 11 2015,1,Denver Nuggets,3,111,9:00p,219,Minnesota Timberwolves,108
Dec 11 2015,1,Indiana Pacers,13,96,7:00p,179,Miami Heat,83
Dec 11 2015,0,Memphis Grizzlies,-24,99,8:00p,222,Charlotte Hornets,123
Dec 11 2015,1,New Orleans Pelicans,2,107,8:00p,212,Washington Wizards,105
Dec 11 2015,0,Orlando Magic,-35,76,7:00p,187,Cleveland Cavaliers,111
Dec 11 2015,0,Philadelphia 76ers,-12,95,7:00p,202,Detroit Pistons,107
Dec 11 2015,0,Phoenix Suns,-10,96,9:30p,202,Portland Trail Blazers,106
Dec 11 2015,1,San Antonio Spurs,22,109,9:30p,196,Los Angeles Lakers,87
Dec 11 2015,1,Toronto Raptors,7,90,7:30p,173,Milwaukee Bucks,83
Dec 11 2015,0,Utah Jazz,-4,90,9:00p,184,Oklahoma City Thunder,94
Dec 12 2015,0,Atlanta Hawks,-25,78,8:00p,181,San Antonio Spurs,103
Dec 12 2015,0,Brooklyn Nets,-5,100,5:00p,205,Los Angeles Clippers,105
Dec 12 2015,1,Chicago Bulls,4,98,8:00p,192,New Orleans Pelicans,94
Dec 12 2015,0,Charlotte Hornets,-5,93,7:00p,191,Boston Celtics,98
Dec 12 2015,0,Dallas Mavericks,-3,111,8:30p,225,Washington Wizards,114
Dec 12 2015,1,Detroit Pistons,22,118,7:30p,214,Indiana Pacers,96
Dec 12 2015,1,Houston Rockets,29,126,8:00p,223,Los Angeles Lakers,97
Dec 12 2015,1,Milwaukee Bucks,13,108,8:30p,203,Golden State Warriors,95
Dec 12 2015,0,Portland Trail Blazers,-2,110,10:00p,222,New York Knicks,112
Dec 13 2015,1,Miami Heat,3,100,6:00p,197,Memphis Grizzlies,97
Dec 13 2015,1,Oklahoma City Thunder,6,104,7:00p,202,Utah Jazz,98
Dec 13 2015,1,Phoenix Suns,7,108,3:30p,209,Minnesota Timberwolves,101
Dec 13 2015,1,Toronto Raptors,20,96,6:00p,172,Philadelphia 76ers,76
Dec 14 2015,0,Atlanta Hawks,-12,88,8:00p,188,Miami Heat,100
Dec 14 2015,0,Brooklyn Nets,-23,82,7:30p,187,Orlando Magic,105
Dec 14 2015,1,Chicago Bulls,19,115,8:00p,211,Philadelphia 76ers,96
Dec 14 2015,1,Dallas Mavericks,10,104,8:30p,198,Phoenix Suns,94
Dec 14 2015,1,Denver Nuggets,6,114,9:00p,222,Houston Rockets,108
Dec 14 2015,0,Detroit Pistons,-2,103,7:30p,208,Los Angeles Clippers,105
Dec 14 2015,1,Indiana Pacers,16,106,7:00p,196,Toronto Raptors,90
Dec 14 2015,1,Memphis Grizzlies,17,112,8:00p,207,Washington Wizards,95
Dec 14 2015,1,Portland Trail Blazers,4,105,10:00p,206,New Orleans Pelicans,101
Dec 14 2015,1,San Antonio Spurs,37,118,8:30p,199,Utah Jazz,81
Dec 15 2015,0,Boston Celtics,-12,77,7:30p,166,Cleveland Cavaliers,89
Dec 15 2015,1,Los Angeles Lakers,18,113,10:30p,208,Milwaukee Bucks,95
Dec 15 2015,0,Minnesota Timberwolves,-12,100,8:00p,212,Denver Nuggets,112
Dec 15 2015,1,Sacramento Kings,10,107,10:00p,204,Houston Rockets,97
Dec 16 2015,1,Atlanta Hawks,21,127,8:00p,233,Philadelphia 76ers,106
Dec 16 2015,0,Brooklyn Nets,-6,98,7:30p,202,Miami Heat,104
Dec 16 2015,1,Chicago Bulls,13,98,8:00p,183,Memphis Grizzlies,85
Dec 16 2015,1,Detroit Pistons,3,119,7:30p,235,Boston Celtics,116
Dec 16 2015,1,Golden State Warriors,25,128,10:30p,231,Phoenix Suns,103
Dec 16 2015,1,Indiana Pacers,26,107,7:00p,188,Dallas Mavericks,81
Dec 16 2015,1,Los Angeles Clippers,13,103,10:30p,193,Milwaukee Bucks,90
Dec 16 2015,1,New York Knicks,5,107,7:30p,209,Minnesota Timberwolves,102
Dec 16 2015,1,Oklahoma City Thunder,16,106,8:00p,196,Portland Trail Blazers,90
Dec 16 2015,1,Orlando Magic,15,113,7:00p,211,Charlotte Hornets,98
Dec 16 2015,1,San Antonio Spurs,19,114,8:30p,209,Washington Wizards,95
Dec 16 2015,0,Utah Jazz,-10,94,9:00p,198,New Orleans Pelicans,104
Dec 17 2015,1,Charlotte Hornets,10,109,7:00p,208,Toronto Raptors,99
Dec 17 2015,1,Cleveland Cavaliers,4,104,8:00p,204,Oklahoma City Thunder,100
Dec 17 2015,0,Los Angeles Lakers,-20,87,10:30p,194,Houston Rockets,107
Dec 18 2015,0,Boston Celtics,-8,101,7:30p,210,Atlanta Hawks,109
Dec 18 2015,0,Chicago Bulls,-3,144,8:00p,291,Detroit Pistons,147
Dec 18 2015,1,Dallas Mavericks,9,97,8:30p,185,Memphis Grizzlies,88
Dec 18 2015,1,Golden State Warriors,9,121,10:30p,233,Milwaukee Bucks,112
Dec 18 2015,1,Indiana Pacers,7,104,7:00p,201,Brooklyn Nets,97
Dec 18 2015,0,Miami Heat,-14,94,8:00p,202,Toronto Raptors,108
Dec 18 2015,1,Minnesota Timberwolves,4,99,8:00p,194,Sacramento Kings,95
Dec 18 2015,1,Orlando Magic,8,102,7:00p,196,Portland Trail Blazers,94
Dec 18 2015,0,Philadelphia 76ers,-10,97,7:00p,204,New York Knicks,107
Dec 18 2015,1,Phoenix Suns,16,104,10:30p,192,New Orleans Pelicans,88
Dec 18 2015,1,San Antonio Spurs,8,115,8:00p,222,Los Angeles Clippers,107
Dec 18 2015,1,Utah Jazz,9,97,9:00p,185,Denver Nuggets,88
Dec 19 2015,1,Houston Rockets,10,107,8:00p,204,Los Angeles Clippers,97
Dec 19 2015,1,Memphis Grizzlies,12,96,8:00p,180,Indiana Pacers,84
Dec 19 2015,1,New York Knicks,16,107,7:30p,198,Chicago Bulls,91
Dec 19 2015,1,Oklahoma City Thunder,40,118,5:00p,196,Los Angeles Lakers,78
Dec 19 2015,1,Washington Wizards,8,109,7:00p,210,Charlotte Hornets,101
Dec 20 2015,0,Brooklyn Nets,-15,85,1:00p,185,Minnesota Timberwolves,100
Dec 20 2015,1,Cleveland Cavaliers,22,108,3:30p,194,Philadelphia 76ers,86
Dec 20 2015,0,Denver Nuggets,-5,125,8:00p,255,New Orleans Pelicans,130
Dec 20 2015,1,Miami Heat,7,116,1:00p,225,Portland Trail Blazers,109
Dec 20 2015,0,Orlando Magic,-3,100,6:00p,203,Atlanta Hawks,103
Dec 20 2015,0,Phoenix Suns,-6,95,5:00p,196,Milwaukee Bucks,101
Dec 20 2015,0,Toronto Raptors,-10,94,6:00p,198,Sacramento Kings,104
Dec 21 2015,1,Atlanta Hawks,9,106,8:00p,203,Portland Trail Blazers,97
Dec 21 2015,1,Boston Celtics,14,113,7:30p,212,Minnesota Timberwolves,99
Dec 21 2015,0,Chicago Bulls,-3,102,8:00p,207,Brooklyn Nets,105
Dec 21 2015,1,Houston Rockets,7,102,8:00p,197,Charlotte Hornets,95
Dec 21 2015,0,Los Angeles Clippers,-1,99,10:30p,199,Oklahoma City Thunder,100
Dec 21 2015,0,New York Knicks,-8,99,7:30p,206,Orlando Magic,107
Dec 21 2015,1,San Antonio Spurs,14,106,8:30p,198,Indiana Pacers,92
Dec 21 2015,1,Utah Jazz,21,110,9:00p,199,Phoenix Suns,89
Dec 21 2015,1,Washington Wizards,14,113,7:00p,212,Sacramento Kings,99
Dec 22 2015,0,Denver Nuggets,-4,107,9:00p,218,Los Angeles Lakers,111
Dec 22 2015,0,Miami Heat,-1,92,7:30p,185,Detroit Pistons,93
Dec 22 2015,0,Philadelphia 76ers,-14,90,7:00p,194,Memphis Grizzlies,104
Dec 22 2015,1,Toronto Raptors,4,103,7:30p,202,Dallas Mavericks,99
Dec 23 2015,1,Atlanta Hawks,7,107,8:00p,207,Detroit Pistons,100
Dec 23 2015,0,Brooklyn Nets,-1,118,7:30p,237,Dallas Mavericks,119
Dec 23 2015,0,Charlotte Hornets,-13,89,7:00p,191,Boston Celtics,102
Dec 23 2015,1,Cleveland Cavaliers,7,91,7:00p,175,New York Knicks,84
Dec 23 2015,1,Golden State Warriors,18,103,10:30p,188,Utah Jazz,85
Dec 23 2015,0,Indiana Pacers,-2,106,7:00p,214,Sacramento Kings,108
Dec 23 2015,0,Los Angeles Lakers,-35,85,10:30p,205,Oklahoma City Thunder,120
Dec 23 2015,1,Milwaukee Bucks,13,113,8:00p,213,Philadelphia 76ers,100
Dec 23 2015,0,Minnesota Timberwolves,-25,83,8:00p,191,San Antonio Spurs,108
Dec 23 2015,1,New Orleans Pelicans,26,115,8:00p,204,Portland Trail Blazers,89
Dec 23 2015,1,Orlando Magic,3,104,7:00p,205,Houston Rockets,101
Dec 23 2015,0,Phoenix Suns,-8,96,9:00p,200,Denver Nuggets,104
Dec 23 2015,1,Washington Wizards,9,100,7:00p,191,Memphis Grizzlies,91
Dec 25 2015,1,Golden State Warriors,6,89,5:00p,172,Cleveland Cavaliers,83
Dec 25 2015,1,Houston Rockets,4,88,8:00p,172,San Antonio Spurs,84
Dec 25 2015,0,Los Angeles Lakers,-10,84,10:30p,178,Los Angeles Clippers,94
Dec 25 2015,1,Miami Heat,6,94,12:00p,182,New Orleans Pelicans,88
Dec 25 2015,0,Oklahoma City Thunder,-9,96,2:30p,201,Chicago Bulls,105
Dec 26 2015,1,Atlanta Hawks,19,117,7:30p,215,New York Knicks,98
Dec 26 2015,0,Brooklyn Nets,-15,96,4:00p,207,Washington Wizards,111
Dec 26 2015,1,Charlotte Hornets,6,98,7:00p,190,Memphis Grizzlies,92
Dec 26 2015,1,Dallas Mavericks,7,118,8:30p,229,Chicago Bulls,111
Dec 26 2015,0,Detroit Pistons,-6,93,7:30p,192,Boston Celtics,99
Dec 26 2015,0,Milwaukee Bucks,-21,90,5:00p,201,Toronto Raptors,111
Dec 26 2015,0,Minnesota Timberwolves,-14,88,8:00p,190,Indiana Pacers,102
Dec 26 2015,1,New Orleans Pelicans,2,110,7:00p,218,Houston Rockets,108
Dec 26 2015,0,Orlando Magic,-7,101,7:00p,209,Miami Heat,108
Dec 26 2015,0,Phoenix Suns,-7,104,9:00p,215,Philadelphia 76ers,111
Dec 26 2015,1,Portland Trail Blazers,29,105,10:00p,181,Cleveland Cavaliers,76
Dec 26 2015,1,San Antonio Spurs,15,101,8:30p,187,Denver Nuggets,86
Dec 26 2015,0,Utah Jazz,-5,104,9:00p,213,Los Angeles Clippers,109
Dec 27 2015,1,Boston Celtics,9,100,7:00p,191,New York Knicks,91
Dec 27 2015,1,Memphis Grizzlies,16,112,6:00p,208,Los Angeles Lakers,96
Dec 27 2015,1,Oklahoma City Thunder,10,122,7:00p,234,Denver Nuggets,112
Dec 27 2015,0,Sacramento Kings,-4,94,9:00p,192,Portland Trail Blazers,98
Dec 28 2015,1,Chicago Bulls,7,104,8:00p,201,Toronto Raptors,97
Dec 28 2015,1,Charlotte Hornets,10,108,7:00p,206,Los Angeles Lakers,98
Dec 28 2015,1,Dallas Mavericks,10,103,8:30p,196,Milwaukee Bucks,93
Dec 28 2015,1,Golden State Warriors,19,122,10:30p,225,Sacramento Kings,103
Dec 28 2015,1,Indiana Pacers,6,93,7:00p,180,Atlanta Hawks,87
Dec 28 2015,0,Miami Heat,-6,105,7:30p,216,Brooklyn Nets,111
Dec 28 2015,1,Orlando Magic,15,104,7:00p,193,New Orleans Pelicans,89
Dec 28 2015,0,Phoenix Suns,-4,97,9:00p,198,Cleveland Cavaliers,101
Dec 28 2015,1,San Antonio Spurs,6,101,8:30p,196,Minnesota Timberwolves,95
Dec 28 2015,1,Utah Jazz,4,95,9:00p,186,Philadelphia 76ers,91
Dec 28 2015,0,Washington Wizards,-17,91,7:00p,199,Los Angeles Clippers,108
Dec 29 2015,0,Denver Nuggets,-6,87,9:00p,180,Cleveland Cavaliers,93
Dec 29 2015,0,Houston Rockets,-6,115,8:00p,236,Atlanta Hawks,121
Dec 29 2015,1,Memphis Grizzlies,9,99,8:00p,189,Miami Heat,90
Dec 29 2015,1,New York Knicks,12,108,7:30p,204,Detroit Pistons,96
Dec 29 2015,1,Oklahoma City Thunder,8,131,8:00p,254,Milwaukee Bucks,123
Dec 30 2015,0,Boston Celtics,-8,104,7:30p,216,Los Angeles Lakers,112
Dec 30 2015,1,Chicago Bulls,2,102,8:00p,202,Indiana Pacers,100
Dec 30 2015,0,Charlotte Hornets,-5,117,7:00p,239,Los Angeles Clippers,122
Dec 30 2015,1,Dallas Mavericks,23,114,8:30p,205,Golden State Warriors,91
Dec 30 2015,1,Minnesota Timberwolves,14,94,8:00p,174,Utah Jazz,80
Dec 30 2015,1,Orlando Magic,7,100,7:00p,193,Brooklyn Nets,93
Dec 30 2015,1,Portland Trail Blazers,7,110,10:00p,213,Denver Nuggets,103
Dec 30 2015,0,Sacramento Kings,-5,105,10:00p,215,Philadelphia 76ers,110
Dec 30 2015,1,San Antonio Spurs,33,112,8:30p,191,Phoenix Suns,79
Dec 30 2015,1,Toronto Raptors,3,94,7:30p,185,Washington Wizards,91
Dec 31 2015,1,Detroit Pistons,25,115,6:00p,205,Minnesota Timberwolves,90
Dec 31 2015,0,Houston Rockets,-4,110,7:00p,224,Golden State Warriors,114
Dec 31 2015,0,Indiana Pacers,-4,116,6:00p,236,Milwaukee Bucks,120
Dec 31 2015,0,New Orleans Pelicans,-6,89,8:00p,184,Los Angeles Clippers,95
Dec 31 2015,1,Oklahoma City Thunder,4,110,8:00p,216,Phoenix Suns,106
Dec 31 2015,1,Utah Jazz,13,109,9:00p,205,Portland Trail Blazers,96
Jan 1 2016,1,Chicago Bulls,27,108,8:00p,189,New York Knicks,81
Jan 1 2016,1,Los Angeles Lakers,9,93,10:30p,177,Philadelphia 76ers,84
Jan 1 2016,1,Miami Heat,24,106,7:30p,188,Dallas Mavericks,82
Jan 1 2016,1,Toronto Raptors,10,104,7:30p,198,Charlotte Hornets,94
Jan 1 2016,1,Washington Wizards,12,103,7:00p,194,Orlando Magic,91
Jan 2 2016,0,Boston Celtics,-3,97,3:00p,197,Brooklyn Nets,100
Jan 2 2016,0,Charlotte Hornets,-19,90,7:00p,199,Oklahoma City Thunder,109
Jan 2 2016,1,Cleveland Cavaliers,25,104,7:30p,183,Orlando Magic,79
Jan 2 2016,0,Dallas Mavericks,-7,98,8:30p,203,New Orleans Pelicans,105
Jan 2 2016,1,Golden State Warriors,3,111,10:30p,219,Denver Nuggets,108
Jan 2 2016,1,Indiana Pacers,12,94,7:00p,176,Detroit Pistons,82
Jan 2 2016,1,Los Angeles Clippers,31,130,10:30p,229,Philadelphia 76ers,99
Jan 2 2016,0,Minnesota Timberwolves,-10,85,8:00p,180,Milwaukee Bucks,95
Jan 2 2016,1,Sacramento Kings,23,142,5:00p,261,Phoenix Suns,119
Jan 2 2016,1,San Antonio Spurs,18,121,8:30p,224,Houston Rockets,103
Jan 2 2016,1,Utah Jazz,5,92,9:00p,179,Memphis Grizzlies,87
Jan 3 2016,0,Denver Nuggets,-6,106,9:00p,218,Portland Trail Blazers,112
Jan 3 2016,1,Los Angeles Lakers,20,97,9:30p,174,Phoenix Suns,77
Jan 3 2016,1,New York Knicks,14,111,3:30p,208,Atlanta Hawks,97
Jan 3 2016,0,Toronto Raptors,-2,113,3:30p,228,Chicago Bulls,115
Jan 3 2016,0,Washington Wizards,-22,75,6:00p,172,Miami Heat,97
Jan 4 2016,0,Brooklyn Nets,-9,94,7:30p,197,Boston Celtics,103
Jan 4 2016,1,Cleveland Cavaliers,22,122,7:00p,222,Toronto Raptors,100
Jan 4 2016,1,Detroit Pistons,26,115,7:30p,204,Orlando Magic,89
Jan 4 2016,1,Golden State Warriors,10,111,10:30p,212,Charlotte Hornets,101
Jan 4 2016,1,Miami Heat,3,103,7:30p,203,Indiana Pacers,100
Jan 4 2016,0,Milwaukee Bucks,-25,98,8:00p,221,San Antonio Spurs,123
Jan 4 2016,0,Oklahoma City Thunder,-12,104,8:00p,220,Sacramento Kings,116
Jan 4 2016,1,Philadelphia 76ers,10,109,7:00p,208,Minnesota Timberwolves,99
Jan 4 2016,0,Portland Trail Blazers,-13,78,10:00p,169,Memphis Grizzlies,91
Jan 4 2016,0,Utah Jazz,-2,91,9:00p,184,Houston Rockets,93
Jan 5 2016,0,Atlanta Hawks,-6,101,8:00p,208,New York Knicks,107
Jan 5 2016,1,Chicago Bulls,11,117,8:00p,223,Milwaukee Bucks,106
Jan 5 2016,1,Dallas Mavericks,1,117,8:30p,233,Sacramento Kings,116
Jan 5 2016,0,Los Angeles Lakers,-21,88,10:30p,197,Golden State Warriors,109
Jan 6 2016,0,Boston Celtics,-5,94,7:30p,193,Detroit Pistons,99
Jan 6 2016,0,Brooklyn Nets,-17,74,7:30p,165,Toronto Raptors,91
Jan 6 2016,0,Miami Heat,-8,90,7:00p,188,New York Knicks,98
Jan 6 2016,0,Minnesota Timberwolves,-4,74,8:00p,152,Denver Nuggets,78
Jan 6 2016,0,New Orleans Pelicans,-9,91,8:00p,191,Dallas Mavericks,100
Jan 6 2016,1,Oklahoma City Thunder,18,112,9:30p,206,Memphis Grizzlies,94
Jan 6 2016,0,Orlando Magic,-9,86,7:00p,181,Indiana Pacers,95
Jan 6 2016,1,Phoenix Suns,9,111,9:00p,213,Charlotte Hornets,102
Jan 6 2016,0,Portland Trail Blazers,-11,98,10:00p,207,Los Angeles Clippers,109
Jan 6 2016,1,San Antonio Spurs,25,123,8:30p,221,Utah Jazz,98
Jan 6 2016,0,Washington Wizards,-6,115,7:00p,236,Cleveland Cavaliers,121
Jan 7 2016,1,Chicago Bulls,9,101,8:00p,193,Boston Celtics,92
Jan 7 2016,1,Houston Rockets,9,103,8:00p,197,Utah Jazz,94
Jan 7 2016,0,Philadelphia 76ers,-28,98,7:00p,224,Atlanta Hawks,126
Jan 7 2016,1,Sacramento Kings,3,118,10:30p,233,Los Angeles Lakers,115
Jan 8 2016,0,Brooklyn Nets,-6,77,7:30p,160,Orlando Magic,83
Jan 8 2016,0,Los Angeles Lakers,-4,113,10:30p,230,Oklahoma City Thunder,117
Jan 8 2016,1,Memphis Grizzlies,7,91,8:00p,175,Denver Nuggets,84
Jan 8 2016,1,Milwaukee Bucks,1,96,8:00p,191,Dallas Mavericks,95
Jan 8 2016,0,Minnesota Timberwolves,-26,99,8:00p,224,Cleveland Cavaliers,125
Jan 8 2016,0,New Orleans Pelicans,-5,86,8:00p,177,Indiana Pacers,91
Jan 8 2016,0,Phoenix Suns,-8,95,9:30p,198,Miami Heat,103
Jan 8 2016,0,Portland Trail Blazers,-20,108,10:00p,236,Golden State Warriors,128
Jan 8 2016,1,San Antonio Spurs,1,100,8:30p,199,New York Knicks,99
Jan 8 2016,0,Washington Wizards,-9,88,7:00p,185,Toronto Raptors,97
Jan 9 2016,1,Atlanta Hawks,15,120,5:00p,225,Chicago Bulls,105
Jan 9 2016,1,Detroit Pistons,14,103,7:30p,192,Brooklyn Nets,89
Jan 9 2016,1,Los Angeles Clippers,14,97,3:30p,180,Charlotte Hornets,83
Jan 9 2016,0,Orlando Magic,-6,99,7:00p,204,Washington Wizards,105
Jan 9 2016,0,Philadelphia 76ers,-13,95,7:30p,203,Toronto Raptors,108
Jan 9 2016,0,Sacramento Kings,-12,116,10:00p,244,Golden State Warriors,128
Jan 9 2016,1,Utah Jazz,15,98,9:00p,181,Miami Heat,83
Jan 10 2016,1,Denver Nuggets,3,95,8:00p,187,Charlotte Hornets,92
Jan 10 2016,1,Houston Rockets,4,107,7:00p,210,Indiana Pacers,103
Jan 10 2016,1,Los Angeles Clippers,3,114,3:30p,225,New Orleans Pelicans,111
Jan 10 2016,0,Los Angeles Lakers,-12,74,9:30p,160,Utah Jazz,86
Jan 10 2016,1,Memphis Grizzlies,3,101,6:00p,199,Boston Celtics,98
Jan 10 2016,0,Minnesota Timberwolves,-6,87,5:00p,180,Dallas Mavericks,93
Jan 10 2016,1,New York Knicks,12,100,7:30p,188,Milwaukee Bucks,88
Jan 10 2016,0,Philadelphia 76ers,-10,85,6:00p,180,Cleveland Cavaliers,95
Jan 10 2016,1,Portland Trail Blazers,5,115,9:00p,225,Oklahoma City Thunder,110
Jan 11 2016,0,Brooklyn Nets,-27,79,7:30p,185,San Antonio Spurs,106
Jan 11 2016,0,Chicago Bulls,-14,100,8:00p,214,Washington Wizards,114
Jan 11 2016,1,Golden State Warriors,8,111,10:30p,214,Miami Heat,103
Jan 12 2016,0,Dallas Mavericks,-3,107,8:30p,217,Cleveland Cavaliers,110
Jan 12 2016,0,Detroit Pistons,-10,99,7:30p,208,San Antonio Spurs,109
Jan 12 2016,1,Indiana Pacers,19,116,7:00p,213,Phoenix Suns,97
Jan 12 2016,1,Los Angeles Lakers,4,95,10:30p,186,New Orleans Pelicans,91
Jan 12 2016,0,Memphis Grizzlies,-16,91,8:00p,198,Houston Rockets,107
Jan 12 2016,1,Milwaukee Bucks,5,106,8:00p,207,Chicago Bulls,101
Jan 12 2016,0,Minnesota Timberwolves,-5,96,8:00p,197,Oklahoma City Thunder,101
Jan 12 2016,1,New York Knicks,6,120,7:30p,234,Boston Celtics,114
Jan 13 2016,1,Boston Celtics,9,103,8:00p,197,Indiana Pacers,94
Jan 13 2016,1,Brooklyn Nets,6,110,7:30p,214,New York Knicks,104
Jan 13 2016,1,Charlotte Hornets,23,107,7:00p,191,Atlanta Hawks,84
Jan 13 2016,1,Denver Nuggets,2,112,9:00p,222,Golden State Warriors,110
Jan 13 2016,1,Houston Rockets,3,107,8:00p,211,Minnesota Timberwolves,104
Jan 13 2016,1,Los Angeles Clippers,14,104,10:30p,194,Miami Heat,90
Jan 13 2016,1,Oklahoma City Thunder,19,108,8:00p,197,Dallas Mavericks,89
Jan 13 2016,1,Portland Trail Blazers,14,99,10:00p,184,Utah Jazz,85
Jan 13 2016,0,Sacramento Kings,-12,97,10:00p,206,New Orleans Pelicans,109
Jan 13 2016,1,Washington Wizards,5,106,7:00p,207,Milwaukee Bucks,101
Jan 14 2016,1,Golden State Warriors,18,116,10:30p,214,Los Angeles Lakers,98
Jan 14 2016,1,Memphis Grizzlies,2,103,8:00p,204,Detroit Pistons,101
Jan 14 2016,0,Orlando Magic,-3,103,3:00p,209,Toronto Raptors,106
Jan 14 2016,0,Philadelphia 76ers,-4,111,7:00p,226,Chicago Bulls,115
Jan 14 2016,1,San Antonio Spurs,4,99,8:00p,194,Cleveland Cavaliers,95
Jan 14 2016,0,Utah Jazz,-2,101,9:00p,204,Sacramento Kings,103
Jan 15 2016,1,Boston Celtics,14,117,7:30p,220,Phoenix Suns,103
Jan 15 2016,0,Brooklyn Nets,-12,104,7:30p,220,Portland Trail Blazers,116
Jan 15 2016,0,Chicago Bulls,-6,77,8:00p,160,Dallas Mavericks,83
Jan 15 2016,0,Denver Nuggets,-3,95,9:00p,193,Miami Heat,98
Jan 15 2016,0,Houston Rockets,-14,77,9:30p,168,Cleveland Cavaliers,91
Jan 15 2016,0,Indiana Pacers,-14,104,7:00p,222,Washington Wizards,118
Jan 15 2016,1,Milwaukee Bucks,7,108,8:00p,209,Atlanta Hawks,101
Jan 15 2016,1,New Orleans Pelicans,2,109,8:00p,216,Charlotte Hornets,107
Jan 15 2016,1,Oklahoma City Thunder,20,113,7:00p,206,Minnesota Timberwolves,93
Jan 16 2016,1,Atlanta Hawks,28,114,7:30p,200,Brooklyn Nets,86
Jan 16 2016,0,Charlotte Hornets,-13,92,7:00p,197,Milwaukee Bucks,105
Jan 16 2016,1,Detroit Pistons,18,113,7:30p,208,Golden State Warriors,95
Jan 16 2016,0,Los Angeles Clippers,-7,103,10:30p,213,Sacramento Kings,110
Jan 16 2016,1,Memphis Grizzlies,8,103,8:00p,198,New York Knicks,95
Jan 16 2016,1,Philadelphia 76ers,25,114,7:30p,203,Portland Trail Blazers,89
Jan 16 2016,1,Utah Jazz,27,109,9:00p,191,Los Angeles Lakers,82
Jan 16 2016,0,Washington Wizards,-2,117,7:30p,236,Boston Celtics,119
Jan 17 2016,1,Denver Nuggets,3,129,8:00p,255,Indiana Pacers,126
Jan 17 2016,0,Los Angeles Lakers,-17,95,9:30p,207,Houston Rockets,112
Jan 17 2016,1,Minnesota Timberwolves,30,117,3:30p,204,Phoenix Suns,87
Jan 17 2016,1,Oklahoma City Thunder,25,99,7:00p,173,Miami Heat,74
Jan 17 2016,1,San Antonio Spurs,29,112,7:00p,195,Dallas Mavericks,83
Jan 18 2016,1,Atlanta Hawks,17,98,5:00p,179,Orlando Magic,81
Jan 18 2016,1,Charlotte Hornets,5,124,2:00p,243,Utah Jazz,119
Jan 18 2016,0,Cleveland Cavaliers,-34,98,8:00p,230,Golden State Warriors,132
Jan 18 2016,1,Dallas Mavericks,5,118,8:30p,231,Boston Celtics,113
Jan 18 2016,0,Detroit Pistons,-10,101,3:30p,212,Chicago Bulls,111
Jan 18 2016,1,Los Angeles Clippers,8,140,10:30p,272,Houston Rockets,132
Jan 18 2016,1,Memphis Grizzlies,2,101,2:30p,200,New Orleans Pelicans,99
Jan 18 2016,1,New York Knicks,6,119,1:00p,232,Philadelphia 76ers,113
Jan 18 2016,1,Toronto Raptors,12,112,7:30p,212,Brooklyn Nets,100
Jan 18 2016,0,Washington Wizards,-10,98,2:00p,206,Portland Trail Blazers,108
Jan 19 2016,0,Denver Nuggets,-6,104,9:00p,214,Oklahoma City Thunder,110
Jan 19 2016,0,Miami Heat,-12,79,7:30p,170,Milwaukee Bucks,91
Jan 19 2016,1,New Orleans Pelicans,15,114,8:00p,213,Minnesota Timberwolves,99
Jan 19 2016,0,Phoenix Suns,-3,94,9:00p,191,Indiana Pacers,97
Jan 20 2016,0,Brooklyn Nets,-13,78,7:30p,169,Cleveland Cavaliers,91
Jan 20 2016,0,Chicago Bulls,-31,94,8:00p,219,Golden State Warriors,125
Jan 20 2016,1,Dallas Mavericks,12,106,8:30p,200,Minnesota Timberwolves,94
Jan 20 2016,0,Houston Rockets,-9,114,8:00p,237,Detroit Pistons,123
Jan 20 2016,0,Los Angeles Lakers,-19,93,10:30p,205,Sacramento Kings,112
Jan 20 2016,1,New York Knicks,7,118,7:30p,229,Utah Jazz,111
Jan 20 2016,1,Oklahoma City Thunder,14,109,8:00p,204,Charlotte Hornets,95
Jan 20 2016,0,Orlando Magic,-9,87,7:00p,183,Philadelphia 76ers,96
Jan 20 2016,0,Portland Trail Blazers,-6,98,10:30p,202,Atlanta Hawks,104
Jan 20 2016,1,Toronto Raptors,6,115,7:30p,224,Boston Celtics,109
Jan 20 2016,1,Washington Wizards,19,106,7:00p,193,Miami Heat,87
Jan 21 2016,1,Cleveland Cavaliers,13,115,8:00p,217,Los Angeles Clippers,102
Jan 21 2016,0,Denver Nuggets,-1,101,9:00p,203,Memphis Grizzlies,102
Jan 21 2016,1,New Orleans Pelicans,16,115,8:00p,214,Detroit Pistons,99
Jan 21 2016,0,Phoenix Suns,-28,89,10:30p,206,San Antonio Spurs,117
Jan 21 2016,1,Sacramento Kings,3,91,10:00p,179,Atlanta Hawks,88
Jan 22 2016,1,Boston Celtics,9,110,7:30p,211,Chicago Bulls,101
Jan 22 2016,0,Brooklyn Nets,-22,86,7:30p,194,Utah Jazz,108
Jan 22 2016,0,Dallas Mavericks,-3,106,8:30p,215,Oklahoma City Thunder,109
Jan 22 2016,1,Golden State Warriors,12,122,10:30p,232,Indiana Pacers,110
Jan 22 2016,1,Houston Rockets,4,102,8:00p,200,Milwaukee Bucks,98
Jan 22 2016,0,Los Angeles Lakers,-13,95,10:30p,203,San Antonio Spurs,108
Jan 22 2016,0,New York Knicks,-28,88,7:30p,204,Los Angeles Clippers,116
Jan 22 2016,0,Orlando Magic,-4,116,7:00p,236,Charlotte Hornets,120
Jan 22 2016,1,Toronto Raptors,20,101,8:00p,182,Miami Heat,81
Jan 23 2016,1,Charlotte Hornets,13,97,7:00p,181,New York Knicks,84
Jan 23 2016,0,Cleveland Cavaliers,-13,83,8:30p,179,Chicago Bulls,96
Jan 23 2016,1,Denver Nuggets,3,104,9:30p,205,Detroit Pistons,101
Jan 23 2016,1,Minnesota Timberwolves,5,106,8:00p,207,Memphis Grizzlies,101
Jan 23 2016,1,New Orleans Pelicans,17,116,7:00p,215,Milwaukee Bucks,99
Jan 23 2016,1,Phoenix Suns,3,98,9:00p,193,Atlanta Hawks,95
Jan 23 2016,1,Portland Trail Blazers,18,121,10:30p,224,Los Angeles Lakers,103
Jan 23 2016,1,Sacramento Kings,11,108,10:30p,205,Indiana Pacers,97
Jan 24 2016,1,Brooklyn Nets,10,116,7:30p,222,Oklahoma City Thunder,106
Jan 24 2016,1,Houston Rockets,11,115,3:30p,219,Dallas Mavericks,104
Jan 24 2016,0,Philadelphia 76ers,-20,92,7:00p,204,Boston Celtics,112
Jan 24 2016,1,Toronto Raptors,18,112,6:00p,206,Los Angeles Clippers,94
Jan 25 2016,0,Chicago Bulls,-5,84,8:00p,173,Miami Heat,89
Jan 25 2016,1,Cleveland Cavaliers,7,114,7:00p,221,Minnesota Timberwolves,107
Jan 25 2016,0,Denver Nuggets,-14,105,9:00p,224,Atlanta Hawks,119
Jan 25 2016,1,Golden State Warriors,30,120,10:30p,210,San Antonio Spurs,90
Jan 25 2016,1,Memphis Grizzlies,6,108,8:00p,210,Orlando Magic,102
Jan 25 2016,0,New Orleans Pelicans,-1,111,8:00p,223,Houston Rockets,112
Jan 25 2016,0,Sacramento Kings,-1,128,10:00p,257,Charlotte Hornets,129
Jan 25 2016,0,Utah Jazz,-3,92,9:00p,187,Detroit Pistons,95
Jan 25 2016,0,Washington Wizards,-25,91,7:00p,207,Boston Celtics,116
Jan 26 2016,0,Brooklyn Nets,-4,98,7:30p,200,Miami Heat,102
Jan 26 2016,0,Indiana Pacers,-2,89,7:00p,180,Los Angeles Clippers,91
Jan 26 2016,0,Los Angeles Lakers,-2,90,10:30p,182,Dallas Mavericks,92
Jan 26 2016,1,Milwaukee Bucks,7,107,8:00p,207,Orlando Magic,100
Jan 26 2016,0,New York Knicks,-6,122,7:30p,250,Oklahoma City Thunder,128
Jan 26 2016,1,Philadelphia 76ers,10,113,7:00p,216,Phoenix Suns,103
Jan 26 2016,1,Portland Trail Blazers,15,112,10:00p,209,Sacramento Kings,97
Jan 26 2016,1,Toronto Raptors,17,106,7:30p,195,Washington Wizards,89
Jan 27 2016,0,Atlanta Hawks,-2,83,8:00p,168,Los Angeles Clippers,85
Jan 27 2016,1,Boston Celtics,8,111,7:30p,214,Denver Nuggets,103
Jan 27 2016,1,Cleveland Cavaliers,22,115,7:00p,208,Phoenix Suns,93
Jan 27 2016,1,Detroit Pistons,13,110,7:30p,207,Philadelphia 76ers,97
Jan 27 2016,1,Golden State Warriors,20,127,10:30p,234,Dallas Mavericks,107
Jan 27 2016,0,Minnesota Timberwolves,-3,123,8:00p,249,Oklahoma City Thunder,126
Jan 27 2016,1,San Antonio Spurs,31,130,8:00p,229,Houston Rockets,99
Jan 27 2016,1,Utah Jazz,29,102,9:00p,175,Charlotte Hornets,73
Jan 28 2016,1,Indiana Pacers,19,111,7:00p,203,Atlanta Hawks,92
Jan 28 2016,0,Los Angeles Lakers,-23,91,10:30p,205,Chicago Bulls,114
Jan 28 2016,1,Memphis Grizzlies,20,103,8:00p,186,Milwaukee Bucks,83
Jan 28 2016,1,New Orleans Pelicans,9,114,8:00p,219,Sacramento Kings,105
Jan 28 2016,1,Toronto Raptors,10,103,8:00p,196,New York Knicks,93
Jan 28 2016,0,Washington Wizards,-4,113,7:00p,230,Denver Nuggets,117
Jan 29 2016,1,Boston Celtics,19,113,7:30p,207,Orlando Magic,94
Jan 29 2016,1,Dallas Mavericks,12,91,8:30p,170,Brooklyn Nets,79
Jan 29 2016,0,Detroit Pistons,-8,106,7:30p,220,Cleveland Cavaliers,114
Jan 29 2016,1,Los Angeles Clippers,12,105,10:30p,198,Los Angeles Lakers,93
Jan 29 2016,0,Milwaukee Bucks,-4,103,8:00p,210,Miami Heat,107
Jan 29 2016,1,New York Knicks,18,102,7:30p,186,Phoenix Suns,84
Jan 29 2016,1,Oklahoma City Thunder,8,116,8:00p,224,Houston Rockets,108
Jan 29 2016,1,Portland Trail Blazers,18,109,10:00p,200,Charlotte Hornets,91
Jan 29 2016,1,Utah Jazz,13,103,9:00p,193,Minnesota Timberwolves,90
Jan 30 2016,1,Cleveland Cavaliers,14,117,8:30p,220,San Antonio Spurs,103
Jan 30 2016,0,Houston Rockets,-1,122,8:00p,245,Washington Wizards,123
Jan 30 2016,1,Indiana Pacers,4,109,7:00p,214,Denver Nuggets,105
Jan 30 2016,1,Memphis Grizzlies,4,121,8:00p,238,Sacramento Kings,117
Jan 30 2016,1,New Orleans Pelicans,2,105,7:00p,208,Brooklyn Nets,103
Jan 30 2016,0,Philadelphia 76ers,-3,105,5:00p,213,Golden State Warriors,108
Jan 30 2016,1,Toronto Raptors,4,111,6:30p,218,Detroit Pistons,107
Jan 31 2016,1,Dallas Mavericks,13,91,7:00p,169,Phoenix Suns,78
Jan 31 2016,1,Los Angeles Clippers,27,120,3:30p,213,Chicago Bulls,93
Jan 31 2016,0,Los Angeles Lakers,-19,82,9:30p,183,Charlotte Hornets,101
Jan 31 2016,1,Miami Heat,18,105,6:00p,192,Atlanta Hawks,87
Jan 31 2016,0,New York Knicks,-21,95,7:30p,211,Golden State Warriors,116
Jan 31 2016,1,Orlando Magic,5,119,6:00p,233,Boston Celtics,114
Jan 31 2016,1,Portland Trail Blazers,3,96,9:00p,189,Minnesota Timberwolves,93
Feb 1 2016,1,Atlanta Hawks,15,112,8:00p,209,Dallas Mavericks,97
Feb 1 2016,0,Brooklyn Nets,-5,100,7:30p,205,Detroit Pistons,105
Feb 1 2016,1,Denver Nuggets,19,112,9:00p,205,Toronto Raptors,93
Feb 1 2016,0,Indiana Pacers,-5,106,7:00p,217,Cleveland Cavaliers,111
Feb 1 2016,0,New Orleans Pelicans,-15,95,8:00p,205,Memphis Grizzlies,110
Feb 1 2016,1,Oklahoma City Thunder,16,114,8:00p,212,Washington Wizards,98
Feb 1 2016,1,Sacramento Kings,7,111,10:00p,215,Milwaukee Bucks,104
Feb 1 2016,1,San Antonio Spurs,15,107,8:30p,199,Orlando Magic,92
Feb 1 2016,1,Utah Jazz,9,105,9:00p,201,Chicago Bulls,96
Feb 2 2016,1,Houston Rockets,13,115,8:00p,217,Miami Heat,102
Feb 2 2016,1,Los Angeles Lakers,4,119,10:30p,234,Minnesota Timberwolves,115
Feb 2 2016,0,New York Knicks,-8,89,7:30p,186,Boston Celtics,97
Feb 2 2016,0,Phoenix Suns,-7,97,9:00p,201,Toronto Raptors,104
Feb 2 2016,1,Portland Trail Blazers,12,107,10:00p,202,Milwaukee Bucks,95
Feb 3 2016,1,Boston Celtics,7,102,7:30p,197,Detroit Pistons,95
Feb 3 2016,0,Brooklyn Nets,-14,100,7:30p,214,Indiana Pacers,114
Feb 3 2016,1,Charlotte Hornets,9,106,7:00p,203,Cleveland Cavaliers,97
Feb 3 2016,0,Dallas Mavericks,-3,90,8:30p,183,Miami Heat,93
Feb 3 2016,0,Los Angeles Clippers,-6,102,10:30p,210,Minnesota Timberwolves,108
Feb 3 2016,1,Oklahoma City Thunder,3,117,8:00p,231,Orlando Magic,114
Feb 3 2016,0,Philadelphia 76ers,-38,86,7:00p,210,Atlanta Hawks,124
Feb 3 2016,0,Sacramento Kings,-5,102,10:00p,209,Chicago Bulls,107
Feb 3 2016,1,San Antonio Spurs,13,110,8:30p,207,New Orleans Pelicans,97
Feb 3 2016,1,Utah Jazz,4,85,9:00p,166,Denver Nuggets,81
Feb 3 2016,0,Washington Wizards,-13,121,8:00p,255,Golden State Warriors,134
Feb 4 2016,1,Detroit Pistons,6,111,7:00p,216,New York Knicks,105
Feb 4 2016,0,New Orleans Pelicans,-3,96,9:30p,195,Los Angeles Lakers,99
Feb 4 2016,0,Phoenix Suns,-6,105,9:00p,216,Houston Rockets,111
Feb 4 2016,0,Portland Trail Blazers,-7,103,10:00p,213,Toronto Raptors,110
Feb 5 2016,1,Atlanta Hawks,6,102,7:00p,198,Indiana Pacers,96
Feb 5 2016,1,Brooklyn Nets,9,128,7:30p,247,Sacramento Kings,119
Feb 5 2016,0,Charlotte Hornets,-3,95,7:00p,193,Miami Heat,98
Feb 5 2016,0,Cleveland Cavaliers,-1,103,7:30p,207,Boston Celtics,104
Feb 5 2016,0,Dallas Mavericks,-26,90,9:30p,206,San Antonio Spurs,116
Feb 5 2016,1,Denver Nuggets,5,115,9:00p,225,Chicago Bulls,110
Feb 5 2016,0,New York Knicks,-6,85,7:30p,176,Memphis Grizzlies,91
Feb 5 2016,0,Orlando Magic,-14,93,7:00p,200,Los Angeles Clippers,107
Feb 5 2016,1,Utah Jazz,3,84,9:00p,165,Milwaukee Bucks,81
Feb 5 2016,1,Washington Wizards,12,106,7:00p,200,Philadelphia 76ers,94
Feb 6 2016,1,Charlotte Hornets,4,108,7:00p,212,Washington Wizards,104
Feb 6 2016,1,Cleveland Cavaliers,15,99,7:30p,183,New Orleans Pelicans,84
Feb 6 2016,1,Golden State Warriors,8,116,9:00p,224,Oklahoma City Thunder,108
Feb 6 2016,0,Houston Rockets,-17,79,5:00p,175,Portland Trail Blazers,96
Feb 6 2016,1,Indiana Pacers,8,112,7:00p,216,Detroit Pistons,104
Feb 6 2016,0,Memphis Grizzlies,-4,110,8:00p,224,Dallas Mavericks,114
Feb 6 2016,1,Minnesota Timberwolves,7,112,8:00p,217,Chicago Bulls,105
Feb 6 2016,1,Philadelphia 76ers,5,103,7:30p,201,Brooklyn Nets,98
Feb 6 2016,0,Phoenix Suns,-9,89,9:00p,187,Utah Jazz,98
Feb 6 2016,1,San Antonio Spurs,4,106,8:30p,208,Los Angeles Lakers,102
Feb 7 2016,1,Boston Celtics,9,128,1:00p,247,Sacramento Kings,119
Feb 7 2016,0,Miami Heat,-7,93,2:00p,193,Los Angeles Clippers,100
Feb 7 2016,0,New York Knicks,-5,96,1:00p,197,Denver Nuggets,101
Feb 7 2016,1,Orlando Magic,2,96,1:00p,190,Atlanta Hawks,94
Feb 8 2016,0,Atlanta Hawks,-7,110,8:00p,227,Orlando Magic,117
Feb 8 2016,1,Brooklyn Nets,1,105,7:30p,209,Denver Nuggets,104
Feb 8 2016,1,Charlotte Hornets,17,108,7:00p,199,Chicago Bulls,91
Feb 8 2016,1,Cleveland Cavaliers,20,120,7:00p,220,Sacramento Kings,100
Feb 8 2016,0,Detroit Pistons,-14,89,7:30p,192,Toronto Raptors,103
Feb 8 2016,1,Indiana Pacers,2,89,7:00p,176,Los Angeles Lakers,87
Feb 8 2016,0,Memphis Grizzlies,-6,106,8:00p,218,Portland Trail Blazers,112
Feb 8 2016,0,Minnesota Timberwolves,-14,102,8:00p,218,New Orleans Pelicans,116
Feb 8 2016,0,Philadelphia 76ers,-6,92,7:00p,190,Los Angeles Clippers,98
Feb 8 2016,0,Phoenix Suns,-16,106,9:00p,228,Oklahoma City Thunder,122
Feb 9 2016,0,Dallas Mavericks,-2,119,8:30p,240,Utah Jazz,121
Feb 9 2016,1,Golden State Warriors,13,123,10:30p,233,Houston Rockets,110
Feb 9 2016,0,Miami Heat,-18,101,8:00p,220,San Antonio Spurs,119
Feb 9 2016,1,Milwaukee Bucks,1,112,8:00p,223,Boston Celtics,111
Feb 9 2016,0,New York Knicks,-3,108,8:00p,219,Washington Wizards,111
Feb 10 2016,1,Boston Celtics,5,139,7:30p,273,Los Angeles Clippers,134
Feb 10 2016,0,Brooklyn Nets,-19,90,7:30p,199,Memphis Grizzlies,109
Feb 10 2016,0,Chicago Bulls,-23,90,8:00p,203,Atlanta Hawks,113
Feb 10 2016,1,Cleveland Cavaliers,9,120,8:00p,231,Los Angeles Lakers,111
Feb 10 2016,0,Detroit Pistons,-11,92,7:30p,195,Denver Nuggets,103
Feb 10 2016,0,Indiana Pacers,-22,95,7:00p,212,Charlotte Hornets,117
Feb 10 2016,1,Minnesota Timberwolves,5,117,8:00p,229,Toronto Raptors,112
Feb 10 2016,1,New Orleans Pelicans,4,100,8:00p,196,Utah Jazz,96
Feb 10 2016,0,Orlando Magic,-2,96,7:00p,194,San Antonio Spurs,98
Feb 10 2016,0,Philadelphia 76ers,-4,110,7:00p,224,Sacramento Kings,114
Feb 10 2016,0,Phoenix Suns,-8,104,9:00p,216,Golden State Warriors,112
Feb 10 2016,1,Portland Trail Blazers,13,116,10:30p,219,Houston Rockets,103
Feb 11 2016,1,Milwaukee Bucks,7,99,8:00p,191,Washington Wizards,92
Feb 11 2016,1,Oklahoma City Thunder,26,121,8:00p,216,New Orleans Pelicans,95
Feb 18 2016,1,Cleveland Cavaliers,11,106,8:00p,201,Chicago Bulls,95
Feb 18 2016,1,Los Angeles Clippers,19,105,10:30p,191,San Antonio Spurs,86
Feb 18 2016,1,Washington Wizards,14,103,7:00p,192,Utah Jazz,89
Feb 19 2016,0,Atlanta Hawks,-4,111,8:00p,226,Miami Heat,115
Feb 19 2016,1,Brooklyn Nets,11,109,7:30p,207,New York Knicks,98
Feb 19 2016,1,Chicago Bulls,10,116,8:00p,222,Toronto Raptors,106
Feb 19 2016,0,Los Angeles Lakers,-6,113,10:30p,232,San Antonio Spurs,119
Feb 19 2016,1,Memphis Grizzlies,5,109,8:00p,213,Minnesota Timberwolves,104
Feb 19 2016,0,Milwaukee Bucks,-3,95,8:00p,193,Charlotte Hornets,98
Feb 19 2016,1,New Orleans Pelicans,7,121,8:00p,235,Philadelphia 76ers,114
Feb 19 2016,0,Oklahoma City Thunder,-3,98,8:00p,199,Indiana Pacers,101
Feb 19 2016,1,Orlando Magic,6,110,7:00p,214,Dallas Mavericks,104
Feb 19 2016,0,Phoenix Suns,-16,100,9:30p,216,Houston Rockets,116
Feb 19 2016,1,Portland Trail Blazers,32,137,10:00p,242,Golden State Warriors,105
Feb 19 2016,1,Sacramento Kings,6,116,10:00p,226,Denver Nuggets,110
Feb 19 2016,1,Utah Jazz,18,111,10:30p,204,Boston Celtics,93
Feb 19 2016,1,Washington Wizards,12,98,7:00p,184,Detroit Pistons,86
Feb 20 2016,0,Atlanta Hawks,-8,109,7:30p,226,Milwaukee Bucks,117
Feb 20 2016,0,Los Angeles Clippers,-3,112,8:30p,227,Golden State Warriors,115
Feb 20 2016,1,Miami Heat,20,114,7:30p,208,Washington Wizards,94
Feb 20 2016,0,Minnesota Timberwolves,-8,95,8:00p,198,New York Knicks,103
Feb 21 2016,0,Brooklyn Nets,-8,96,6:00p,200,Charlotte Hornets,104
Feb 21 2016,1,Chicago Bulls,11,126,8:00p,241,Los Angeles Lakers,115
Feb 21 2016,1,Dallas Mavericks,26,129,7:00p,232,Philadelphia 76ers,103
Feb 21 2016,0,Denver Nuggets,-20,101,5:00p,222,Boston Celtics,121
Feb 21 2016,0,Detroit Pistons,-5,106,3:30p,217,New Orleans Pelicans,111
Feb 21 2016,0,Oklahoma City Thunder,-23,92,3:30p,207,Cleveland Cavaliers,115
Feb 21 2016,0,Orlando Magic,-3,102,6:00p,207,Indiana Pacers,105
Feb 21 2016,0,Phoenix Suns,-7,111,5:00p,229,San Antonio Spurs,118
Feb 21 2016,1,Portland Trail Blazers,4,115,9:00p,226,Utah Jazz,111
Feb 21 2016,1,Toronto Raptors,13,98,6:00p,183,Memphis Grizzlies,85
Feb 22 2016,0,Atlanta Hawks,-10,92,8:00p,194,Golden State Warriors,102
Feb 22 2016,0,Cleveland Cavaliers,-8,88,7:00p,184,Detroit Pistons,96
Feb 22 2016,1,Los Angeles Clippers,40,124,10:30p,208,Phoenix Suns,84
Feb 22 2016,1,Miami Heat,8,101,7:30p,194,Indiana Pacers,93
Feb 22 2016,1,Milwaukee Bucks,7,108,8:00p,209,Los Angeles Lakers,101
Feb 22 2016,1,Minnesota Timberwolves,2,124,8:00p,246,Boston Celtics,122
Feb 22 2016,0,New York Knicks,-27,95,7:30p,217,Toronto Raptors,122
Feb 23 2016,0,Denver Nuggets,-4,110,9:00p,224,Sacramento Kings,114
Feb 23 2016,0,Philadelphia 76ers,-9,115,7:00p,239,Orlando Magic,124
Feb 23 2016,1,Portland Trail Blazers,8,112,10:00p,216,Brooklyn Nets,104
Feb 23 2016,1,Utah Jazz,3,117,9:00p,231,Houston Rockets,114
Feb 23 2016,1,Washington Wizards,20,109,7:00p,198,New Orleans Pelicans,89
Feb 24 2016,1,Chicago Bulls,5,109,8:00p,213,Washington Wizards,104
Feb 24 2016,1,Cleveland Cavaliers,11,114,7:00p,217,Charlotte Hornets,103
Feb 24 2016,0,Dallas Mavericks,-13,103,8:30p,219,Oklahoma City Thunder,116
Feb 24 2016,1,Detroit Pistons,20,111,7:30p,202,Philadelphia 76ers,91
Feb 24 2016,1,Indiana Pacers,3,108,7:00p,213,New York Knicks,105
Feb 24 2016,0,Los Angeles Clippers,-6,81,10:30p,168,Denver Nuggets,87
Feb 24 2016,1,Memphis Grizzlies,9,128,8:00p,247,Los Angeles Lakers,119
Feb 24 2016,0,Miami Heat,-6,112,7:30p,230,Golden State Warriors,118
Feb 24 2016,0,Sacramento Kings,-16,92,10:30p,200,San Antonio Spurs,108
Feb 24 2016,1,Toronto Raptors,9,114,7:30p,219,Minnesota Timberwolves,105
Feb 25 2016,1,Boston Celtics,5,112,7:30p,219,Milwaukee Bucks,107
Feb 25 2016,1,New Orleans Pelicans,4,123,8:00p,242,Oklahoma City Thunder,119
Feb 25 2016,0,Orlando Magic,-16,114,7:00p,244,Golden State Warriors,130
Feb 25 2016,0,Phoenix Suns,-10,106,9:00p,222,Brooklyn Nets,116
Feb 25 2016,0,Portland Trail Blazers,-14,105,10:30p,224,Houston Rockets,119
Feb 25 2016,0,Utah Jazz,-18,78,10:30p,174,San Antonio Spurs,96
Feb 26 2016,1,Atlanta Hawks,15,103,8:00p,191,Chicago Bulls,88
Feb 26 2016,1,Dallas Mavericks,6,122,8:30p,238,Denver Nuggets,116
Feb 26 2016,0,Indiana Pacers,-1,95,7:00p,191,Charlotte Hornets,96
Feb 26 2016,0,Los Angeles Lakers,-17,95,10:30p,207,Memphis Grizzlies,112
Feb 26 2016,1,New York Knicks,13,108,7:30p,203,Orlando Magic,95
Feb 26 2016,0,Philadelphia 76ers,-9,94,7:00p,197,Washington Wizards,103
Feb 26 2016,0,Sacramento Kings,-10,107,10:00p,224,Los Angeles Clippers,117
Feb 26 2016,1,Toronto Raptors,2,99,7:30p,196,Cleveland Cavaliers,97
Feb 27 2016,1,Boston Celtics,12,101,3:00p,190,Miami Heat,89
Feb 27 2016,0,Chicago Bulls,-8,95,8:00p,198,Portland Trail Blazers,103
Feb 27 2016,0,Houston Rockets,-10,94,8:00p,198,San Antonio Spurs,104
Feb 27 2016,0,Milwaukee Bucks,-11,91,8:30p,193,Detroit Pistons,102
Feb 27 2016,0,New Orleans Pelicans,-2,110,7:00p,222,Minnesota Timberwolves,112
Feb 27 2016,0,Oklahoma City Thunder,-3,118,8:30p,239,Golden State Warriors,121
Feb 27 2016,1,Phoenix Suns,5,111,9:30p,217,Memphis Grizzlies,106
Feb 27 2016,0,Utah Jazz,-2,96,9:30p,194,Brooklyn Nets,98
Feb 28 2016,1,Atlanta Hawks,11,87,3:30p,163,Charlotte Hornets,76
Feb 28 2016,1,Dallas Mavericks,27,128,7:00p,229,Minnesota Timberwolves,101
Feb 28 2016,1,Detroit Pistons,13,114,6:00p,215,Toronto Raptors,101
Feb 28 2016,0,Indiana Pacers,-9,102,6:00p,213,Portland Trail Blazers,111
Feb 28 2016,0,New York Knicks,-17,81,7:30p,179,Miami Heat,98
Feb 28 2016,1,Orlando Magic,14,130,6:00p,246,Philadelphia 76ers,116
Feb 28 2016,1,Washington Wizards,14,113,1:00p,212,Cleveland Cavaliers,99
Feb 29 2016,1,Boston Celtics,5,100,7:30p,195,Utah Jazz,95
Feb 29 2016,1,Cleveland Cavaliers,4,100,7:00p,196,Indiana Pacers,96
Feb 29 2016,0,Denver Nuggets,-7,96,9:00p,199,Memphis Grizzlies,103
Feb 29 2016,1,Los Angeles Clippers,10,105,10:30p,200,Brooklyn Nets,95
Feb 29 2016,1,Milwaukee Bucks,7,128,8:00p,249,Houston Rockets,121
Feb 29 2016,0,Sacramento Kings,-15,116,10:00p,247,Oklahoma City Thunder,131
Feb 29 2016,1,Washington Wizards,8,116,7:00p,224,Philadelphia 76ers,108
Mar 1 2016,1,Charlotte Hornets,34,126,7:00p,218,Phoenix Suns,92
Mar 1 2016,1,Dallas Mavericks,13,121,8:30p,229,Orlando Magic,108
Mar 1 2016,1,Golden State Warriors,4,109,10:30p,214,Atlanta Hawks,105
Mar 1 2016,1,Los Angeles Lakers,6,107,10:30p,208,Brooklyn Nets,101
Mar 1 2016,1,Miami Heat,18,129,7:30p,240,Chicago Bulls,111
Mar 1 2016,0,New York Knicks,-19,85,7:30p,189,Portland Trail Blazers,104
Mar 2 2016,1,Boston Celtics,23,116,7:30p,209,Portland Trail Blazers,93
Mar 2 2016,1,Denver Nuggets,10,117,9:00p,224,Los Angeles Lakers,107
Mar 2 2016,1,Houston Rockets,5,100,8:00p,195,New Orleans Pelicans,95
Mar 2 2016,1,Los Angeles Clippers,5,103,10:30p,201,Oklahoma City Thunder,98
Mar 2 2016,1,Memphis Grizzlies,6,104,8:00p,202,Sacramento Kings,98
Mar 2 2016,0,Milwaukee Bucks,-5,99,8:00p,203,Indiana Pacers,104
Mar 2 2016,0,Minnesota Timberwolves,-6,98,8:00p,202,Washington Wizards,104
Mar 2 2016,1,Orlando Magic,13,102,7:00p,191,Chicago Bulls,89
Mar 2 2016,0,Philadelphia 76ers,-20,99,7:00p,218,Charlotte Hornets,119
Mar 2 2016,1,San Antonio Spurs,16,97,8:00p,178,Detroit Pistons,81
Mar 2 2016,1,Toronto Raptors,10,104,7:30p,198,Utah Jazz,94
Mar 3 2016,0,Dallas Mavericks,-3,101,8:30p,205,Sacramento Kings,104
Mar 3 2016,1,Golden State Warriors,15,121,10:30p,227,Oklahoma City Thunder,106
Mar 3 2016,1,Miami Heat,16,108,7:30p,200,Phoenix Suns,92
Mar 3 2016,0,New Orleans Pelicans,-8,86,8:00p,180,San Antonio Spurs,94
Mar 4 2016,1,Boston Celtics,1,105,7:30p,209,New York Knicks,104
Mar 4 2016,1,Charlotte Hornets,7,108,7:00p,209,Indiana Pacers,101
Mar 4 2016,1,Cleveland Cavaliers,25,108,8:00p,191,Washington Wizards,83
Mar 4 2016,0,Denver Nuggets,-1,120,9:00p,241,Brooklyn Nets,121
Mar 4 2016,0,Los Angeles Lakers,-29,77,10:30p,183,Atlanta Hawks,106
Mar 4 2016,1,Memphis Grizzlies,6,94,8:00p,182,Utah Jazz,88
Mar 4 2016,1,Milwaukee Bucks,15,116,8:00p,217,Minnesota Timberwolves,101
Mar 4 2016,0,Orlando Magic,-18,84,7:00p,186,Phoenix Suns,102
Mar 4 2016,0,Philadelphia 76ers,-10,102,7:00p,214,Miami Heat,112
Mar 4 2016,1,Toronto Raptors,2,117,7:30p,232,Portland Trail Blazers,115
Mar 5 2016,1,Chicago Bulls,8,108,8:30p,208,Houston Rockets,100
Mar 5 2016,1,Cleveland Cavaliers,17,120,7:00p,223,Boston Celtics,103
Mar 5 2016,0,Los Angeles Clippers,-10,97,10:30p,204,Atlanta Hawks,107
Mar 5 2016,1,Minnesota Timberwolves,14,132,8:00p,250,Brooklyn Nets,118
Mar 5 2016,0,New Orleans Pelicans,-12,94,7:00p,200,Utah Jazz,106
Mar 5 2016,1,New York Knicks,13,102,7:00p,191,Detroit Pistons,89
Mar 5 2016,1,San Antonio Spurs,10,104,8:30p,198,Sacramento Kings,94
Mar 5 2016,0,Washington Wizards,-1,99,7:00p,199,Indiana Pacers,100
Mar 6 2016,1,Denver Nuggets,2,116,5:00p,230,Dallas Mavericks,114
Mar 6 2016,1,Detroit Pistons,20,123,6:00p,226,Portland Trail Blazers,103
Mar 6 2016,1,Los Angeles Lakers,17,112,3:30p,207,Golden State Warriors,95
Mar 6 2016,0,Memphis Grizzlies,-9,100,4:00p,209,Phoenix Suns,109
Mar 6 2016,1,Miami Heat,5,103,6:00p,201,Philadelphia 76ers,98
Mar 6 2016,0,Milwaukee Bucks,-8,96,3:30p,200,Oklahoma City Thunder,104
Mar 6 2016,0,Toronto Raptors,-6,107,6:30p,220,Houston Rockets,113
Mar 7 2016,1,Chicago Bulls,10,100,8:00p,190,Milwaukee Bucks,90
Mar 7 2016,1,Charlotte Hornets,5,108,7:00p,211,Minnesota Timberwolves,103
Mar 7 2016,0,Cleveland Cavaliers,-3,103,7:00p,209,Memphis Grizzlies,106
Mar 7 2016,0,Dallas Mavericks,-19,90,8:30p,199,Los Angeles Clippers,109
Mar 7 2016,1,Golden State Warriors,6,119,10:30p,232,Orlando Magic,113
Mar 7 2016,1,Indiana Pacers,8,99,7:00p,190,San Antonio Spurs,91
Mar 7 2016,1,New Orleans Pelicans,3,115,8:00p,227,Sacramento Kings,112
Mar 8 2016,1,Denver Nuggets,16,110,9:00p,204,New York Knicks,94
Mar 8 2016,1,Los Angeles Lakers,9,107,10:30p,205,Orlando Magic,98
Mar 8 2016,0,Minnesota Timberwolves,-25,91,8:00p,207,San Antonio Spurs,116
Mar 8 2016,1,Portland Trail Blazers,7,116,10:00p,225,Washington Wizards,109
Mar 8 2016,1,Toronto Raptors,5,104,7:30p,203,Brooklyn Nets,99
Mar 8 2016,0,Utah Jazz,-7,84,9:00p,175,Atlanta Hawks,91
Mar 9 2016,1,Boston Celtics,20,116,7:00p,212,Memphis Grizzlies,96
Mar 9 2016,1,Charlotte Hornets,9,122,7:00p,235,New Orleans Pelicans,113
Mar 9 2016,0,Dallas Mavericks,-6,96,8:30p,198,Detroit Pistons,102
Mar 9 2016,1,Golden State Warriors,21,115,10:30p,209,Utah Jazz,94
Mar 9 2016,1,Milwaukee Bucks,6,114,8:00p,222,Miami Heat,108
Mar 9 2016,1,Oklahoma City Thunder,12,120,9:30p,228,Los Angeles Clippers,108
Mar 9 2016,0,Philadelphia 76ers,-14,104,7:00p,222,Houston Rockets,118
Mar 9 2016,0,Phoenix Suns,-31,97,9:00p,225,New York Knicks,128
Mar 9 2016,0,Sacramento Kings,-9,111,10:00p,231,Cleveland Cavaliers,120
Mar 10 2016,1,Denver Nuggets,18,116,9:00p,214,Phoenix Suns,98
Mar 10 2016,0,Los Angeles Lakers,-12,108,10:30p,228,Cleveland Cavaliers,120
Mar 10 2016,1,San Antonio Spurs,8,109,8:00p,210,Chicago Bulls,101
Mar 10 2016,1,Toronto Raptors,8,104,7:30p,200,Atlanta Hawks,96
Mar 11 2016,0,Boston Celtics,-4,98,7:30p,200,Houston Rockets,102
Mar 11 2016,0,Chicago Bulls,-22,96,8:00p,214,Miami Heat,118
Mar 11 2016,1,Charlotte Hornets,15,118,7:00p,221,Detroit Pistons,103
Mar 11 2016,1,Golden State Warriors,16,128,10:30p,240,Portland Trail Blazers,112
Mar 11 2016,1,Los Angeles Clippers,7,101,10:30p,195,New York Knicks,94
Mar 11 2016,1,Memphis Grizzlies,7,121,8:00p,235,New Orleans Pelicans,114
Mar 11 2016,0,Oklahoma City Thunder,-3,96,8:00p,195,Minnesota Timberwolves,99
Mar 11 2016,1,Philadelphia 76ers,6,95,7:00p,184,Brooklyn Nets,89
Mar 11 2016,0,Sacramento Kings,-7,100,10:00p,207,Orlando Magic,107
Mar 11 2016,1,Utah Jazz,21,114,9:00p,207,Washington Wizards,93
Mar 12 2016,1,Atlanta Hawks,12,95,7:30p,178,Memphis Grizzlies,83
Mar 12 2016,1,Charlotte Hornets,16,125,7:00p,234,Houston Rockets,109
Mar 12 2016,0,Dallas Mavericks,-7,105,2:00p,217,Indiana Pacers,112
Mar 12 2016,1,Denver Nuggets,16,116,9:30p,216,Washington Wizards,100
Mar 12 2016,1,Golden State Warriors,7,123,10:30p,239,Phoenix Suns,116
Mar 12 2016,1,Milwaukee Bucks,11,103,7:30p,195,New Orleans Pelicans,92
Mar 12 2016,0,Philadelphia 76ers,-14,111,7:00p,236,Detroit Pistons,125
Mar 12 2016,1,Portland Trail Blazers,37,121,10:30p,205,Orlando Magic,84
Mar 12 2016,1,San Antonio Spurs,8,93,8:30p,178,Oklahoma City Thunder,85
Mar 12 2016,1,Toronto Raptors,8,112,7:00p,216,Miami Heat,104
Mar 13 2016,1,Atlanta Hawks,29,104,6:00p,179,Indiana Pacers,75
Mar 13 2016,0,Brooklyn Nets,-9,100,8:00p,209,Milwaukee Bucks,109
Mar 13 2016,0,Los Angeles Clippers,-24,90,3:30p,204,Cleveland Cavaliers,114
Mar 13 2016,0,Los Angeles Lakers,-3,87,9:30p,177,New York Knicks,90
Mar 13 2016,0,Sacramento Kings,-9,99,6:00p,207,Utah Jazz,108
Mar 14 2016,0,Charlotte Hornets,-11,96,7:00p,203,Dallas Mavericks,107
Mar 14 2016,1,Golden State Warriors,18,125,10:30p,232,New Orleans Pelicans,107
Mar 14 2016,1,Houston Rockets,49,130,8:00p,211,Memphis Grizzlies,81
Mar 14 2016,1,Miami Heat,5,124,7:30p,243,Denver Nuggets,119
Mar 14 2016,1,Oklahoma City Thunder,34,128,8:00p,222,Portland Trail Blazers,94
Mar 14 2016,1,Phoenix Suns,3,107,10:00p,211,Minnesota Timberwolves,104
Mar 14 2016,0,Toronto Raptors,-2,107,7:30p,216,Chicago Bulls,109
Mar 14 2016,1,Utah Jazz,9,94,10:30p,179,Cleveland Cavaliers,85
Mar 14 2016,1,Washington Wizards,43,124,8:00p,205,Detroit Pistons,81
Mar 15 2016,1,Brooklyn Nets,17,131,7:30p,245,Philadelphia 76ers,114
Mar 15 2016,1,Indiana Pacers,5,103,7:00p,201,Boston Celtics,98
Mar 15 2016,0,Los Angeles Lakers,-8,98,10:30p,204,Sacramento Kings,106
Mar 15 2016,0,Milwaukee Bucks,-18,89,8:00p,196,Toronto Raptors,107
Mar 15 2016,1,Orlando Magic,6,116,7:00p,226,Denver Nuggets,110
Mar 15 2016,1,San Antonio Spurs,21,108,8:30p,195,Los Angeles Clippers,87
Mar 16 2016,0,Boston Celtics,-21,109,7:00p,239,Oklahoma City Thunder,130
Mar 16 2016,1,Charlotte Hornets,8,107,7:00p,206,Orlando Magic,99
Mar 16 2016,1,Cleveland Cavaliers,1,99,7:00p,197,Dallas Mavericks,98
Mar 16 2016,0,Detroit Pistons,-4,114,7:30p,232,Atlanta Hawks,118
Mar 16 2016,1,Golden State Warriors,36,121,10:30p,206,New York Knicks,85
Mar 16 2016,0,Houston Rockets,-16,106,9:30p,228,Los Angeles Clippers,122
Mar 16 2016,0,Memphis Grizzlies,-6,108,8:00p,222,Minnesota Timberwolves,114
Mar 16 2016,0,Sacramento Kings,-15,108,10:00p,231,New Orleans Pelicans,123
Mar 16 2016,1,Washington Wizards,21,117,7:00p,213,Chicago Bulls,96
Mar 17 2016,1,Atlanta Hawks,18,116,8:00p,214,Denver Nuggets,98
Mar 17 2016,1,Chicago Bulls,16,118,8:00p,220,Brooklyn Nets,102
Mar 17 2016,0,Indiana Pacers,-7,94,7:00p,195,Toronto Raptors,101
Mar 17 2016,0,Miami Heat,-3,106,7:30p,215,Charlotte Hornets,109
Mar 17 2016,1,Milwaukee Bucks,10,96,8:00p,182,Memphis Grizzlies,86
Mar 17 2016,0,Philadelphia 76ers,-5,94,7:00p,193,Washington Wizards,99
Mar 17 2016,1,San Antonio Spurs,8,118,8:30p,228,Portland Trail Blazers,110
Mar 17 2016,1,Utah Jazz,34,103,9:00p,172,Phoenix Suns,69
Mar 18 2016,0,Dallas Mavericks,-18,112,8:30p,242,Golden State Warriors,130
Mar 18 2016,1,Detroit Pistons,7,115,7:30p,223,Sacramento Kings,108
Mar 18 2016,1,Houston Rockets,5,116,8:00p,227,Minnesota Timberwolves,111
Mar 18 2016,0,Los Angeles Lakers,-5,90,10:30p,185,Phoenix Suns,95
Mar 18 2016,0,New Orleans Pelicans,-5,112,8:00p,229,Portland Trail Blazers,117
Mar 18 2016,0,Orlando Magic,-6,103,7:00p,212,Cleveland Cavaliers,109
Mar 18 2016,0,Philadelphia 76ers,-14,97,7:00p,208,Oklahoma City Thunder,111
Mar 18 2016,1,Toronto Raptors,14,105,7:30p,196,Boston Celtics,91
Mar 19 2016,1,Atlanta Hawks,12,109,7:30p,206,Houston Rockets,97
Mar 19 2016,1,Chicago Bulls,7,92,8:00p,177,Utah Jazz,85
Mar 19 2016,0,Charlotte Hornets,-8,93,6:00p,194,Denver Nuggets,101
Mar 19 2016,1,Detroit Pistons,12,115,7:00p,218,Brooklyn Nets,103
Mar 19 2016,0,Indiana Pacers,-4,111,7:00p,226,Oklahoma City Thunder,115
Mar 19 2016,1,Memphis Grizzlies,11,113,8:00p,215,Los Angeles Clippers,102
Mar 19 2016,1,Miami Heat,21,122,7:30p,223,Cleveland Cavaliers,101
Mar 19 2016,1,San Antonio Spurs,8,87,8:30p,166,Golden State Warriors,79
Mar 19 2016,1,Washington Wizards,10,99,7:00p,188,New York Knicks,89
Mar 20 2016,1,Dallas Mavericks,12,132,4:00p,252,Portland Trail Blazers,120
Mar 20 2016,0,Milwaukee Bucks,-9,85,7:00p,179,Utah Jazz,94
Mar 20 2016,1,New Orleans Pelicans,4,109,6:00p,214,Los Angeles Clippers,105
Mar 20 2016,0,New York Knicks,-8,80,7:30p,168,Sacramento Kings,88
Mar 20 2016,0,Philadelphia 76ers,-15,105,6:00p,225,Boston Celtics,120
Mar 20 2016,1,Toronto Raptors,5,105,4:30p,205,Orlando Magic,100
Mar 21 2016,0,Atlanta Hawks,-15,102,8:00p,219,Washington Wizards,117
Mar 21 2016,1,Boston Celtics,11,107,7:30p,203,Orlando Magic,96
Mar 21 2016,1,Chicago Bulls,7,109,8:00p,211,Sacramento Kings,102
Mar 21 2016,1,Charlotte Hornets,3,91,7:00p,179,San Antonio Spurs,88
Mar 21 2016,1,Cleveland Cavaliers,33,124,7:00p,215,Denver Nuggets,91
Mar 21 2016,1,Detroit Pistons,1,92,7:30p,183,Milwaukee Bucks,91
Mar 21 2016,1,Indiana Pacers,16,91,7:00p,166,Philadelphia 76ers,75
Mar 21 2016,0,Minnesota Timberwolves,-5,104,8:00p,213,Golden State Warriors,109
Mar 21 2016,0,Phoenix Suns,-6,97,10:00p,200,Memphis Grizzlies,103
Mar 22 2016,0,Brooklyn Nets,-5,100,7:30p,205,Charlotte Hornets,105
Mar 22 2016,1,Los Angeles Lakers,7,107,10:30p,207,Memphis Grizzlies,100
Mar 22 2016,0,New Orleans Pelicans,-14,99,8:00p,212,Miami Heat,113
Mar 22 2016,1,Oklahoma City Thunder,4,111,8:00p,218,Houston Rockets,107
Mar 23 2016,1,Boston Celtics,12,91,7:30p,170,Toronto Raptors,79
Mar 23 2016,0,Chicago Bulls,-8,107,8:00p,222,New York Knicks,115
Mar 23 2016,1,Cleveland Cavaliers,9,113,7:00p,217,Milwaukee Bucks,104
Mar 23 2016,1,Denver Nuggets,1,104,9:00p,207,Philadelphia 76ers,103
Mar 23 2016,1,Detroit Pistons,16,118,7:30p,220,Orlando Magic,102
Mar 23 2016,1,Golden State Warriors,16,114,10:30p,212,Los Angeles Clippers,98
Mar 23 2016,0,Houston Rockets,-2,87,8:00p,176,Utah Jazz,89
Mar 23 2016,1,Minnesota Timberwolves,9,113,8:00p,217,Sacramento Kings,104
Mar 23 2016,1,Phoenix Suns,12,119,10:00p,226,Los Angeles Lakers,107
Mar 23 2016,1,Portland Trail Blazers,6,109,10:00p,212,Dallas Mavericks,103
Mar 23 2016,1,San Antonio Spurs,24,112,8:30p,200,Miami Heat,88
Mar 23 2016,0,Washington Wizards,-21,101,7:00p,223,Atlanta Hawks,122
Mar 24 2016,1,Brooklyn Nets,9,104,7:30p,199,Cleveland Cavaliers,95
Mar 24 2016,1,Indiana Pacers,8,92,7:00p,176,New Orleans Pelicans,84
Mar 24 2016,1,Los Angeles Clippers,2,96,10:30p,190,Portland Trail Blazers,94
Mar 24 2016,1,New York Knicks,12,106,7:30p,200,Chicago Bulls,94
Mar 24 2016,1,Oklahoma City Thunder,22,113,8:00p,204,Utah Jazz,91
Mar 25 2016,1,Atlanta Hawks,11,101,8:00p,191,Milwaukee Bucks,90
Mar 25 2016,1,Detroit Pistons,7,112,7:30p,217,Charlotte Hornets,105
Mar 25 2016,1,Golden State Warriors,8,128,10:30p,248,Dallas Mavericks,120
Mar 25 2016,1,Houston Rockets,3,112,8:00p,221,Toronto Raptors,109
Mar 25 2016,0,Los Angeles Lakers,-11,105,10:30p,221,Denver Nuggets,116
Mar 25 2016,1,Miami Heat,11,108,8:00p,205,Orlando Magic,97
Mar 25 2016,1,Sacramento Kings,22,116,10:00p,210,Phoenix Suns,94
Mar 25 2016,1,San Antonio Spurs,6,110,8:30p,214,Memphis Grizzlies,104
Mar 25 2016,0,Washington Wizards,-3,129,7:00p,261,Minnesota Timberwolves,132
Mar 26 2016,1,Brooklyn Nets,10,120,6:00p,230,Indiana Pacers,110
Mar 26 2016,0,Detroit Pistons,-17,95,7:30p,207,Atlanta Hawks,112
Mar 26 2016,0,Milwaukee Bucks,-24,91,8:30p,206,Charlotte Hornets,115
Mar 26 2016,0,Minnesota Timberwolves,-9,84,8:00p,177,Utah Jazz,93
Mar 26 2016,0,New Orleans Pelicans,-24,91,7:00p,206,Toronto Raptors,115
Mar 26 2016,0,New York Knicks,-14,93,7:30p,200,Cleveland Cavaliers,107
Mar 26 2016,1,Oklahoma City Thunder,19,111,8:00p,203,San Antonio Spurs,92
Mar 26 2016,1,Orlando Magic,22,111,7:00p,200,Chicago Bulls,89
Mar 26 2016,0,Phoenix Suns,-3,99,10:00p,201,Boston Celtics,102
Mar 26 2016,1,Portland Trail Blazers,3,108,10:00p,213,Philadelphia 76ers,105
Mar 27 2016,1,Golden State Warriors,12,117,8:00p,222,Philadelphia 76ers,105
Mar 27 2016,1,Indiana Pacers,3,104,6:00p,205,Houston Rockets,101
Mar 27 2016,1,Los Angeles Clippers,15,105,3:30p,195,Denver Nuggets,90
Mar 27 2016,0,Los Angeles Lakers,-13,88,9:30p,189,Washington Wizards,101
Mar 27 2016,1,Sacramento Kings,22,133,6:00p,244,Dallas Mavericks,111
Mar 28 2016,0,Chicago Bulls,-2,100,8:00p,202,Atlanta Hawks,102
Mar 28 2016,0,Denver Nuggets,-9,88,9:00p,185,Dallas Mavericks,97
Mar 28 2016,1,Los Angeles Clippers,24,114,10:30p,204,Boston Celtics,90
Mar 28 2016,0,Memphis Grizzlies,-14,87,8:00p,188,San Antonio Spurs,101
Mar 28 2016,1,Miami Heat,11,110,7:30p,209,Brooklyn Nets,99
Mar 28 2016,1,Minnesota Timberwolves,5,121,8:00p,237,Phoenix Suns,116
Mar 28 2016,1,New Orleans Pelicans,8,99,8:00p,190,New York Knicks,91
Mar 28 2016,1,Portland Trail Blazers,12,105,10:00p,198,Sacramento Kings,93
Mar 28 2016,0,Toronto Raptors,-19,100,7:30p,219,Oklahoma City Thunder,119
Mar 28 2016,1,Utah Jazz,48,123,9:00p,198,Los Angeles Lakers,75
Mar 29 2016,0,Cleveland Cavaliers,-6,100,8:00p,206,Houston Rockets,106
Mar 29 2016,1,Detroit Pistons,6,88,7:30p,170,Oklahoma City Thunder,82
Mar 29 2016,1,Golden State Warriors,8,102,10:30p,196,Washington Wizards,94
Mar 29 2016,0,Indiana Pacers,-2,96,7:00p,194,Chicago Bulls,98
Mar 29 2016,1,Orlando Magic,34,139,7:00p,244,Brooklyn Nets,105
Mar 29 2016,0,Philadelphia 76ers,-15,85,7:00p,185,Charlotte Hornets,100
Mar 30 2016,1,Dallas Mavericks,2,91,8:30p,180,New York Knicks,89
Mar 30 2016,1,Los Angeles Lakers,2,102,10:30p,202,Miami Heat,100
Mar 30 2016,0,Memphis Grizzlies,-4,105,8:00p,214,Denver Nuggets,109
Mar 30 2016,1,Milwaukee Bucks,11,105,8:00p,199,Phoenix Suns,94
Mar 30 2016,0,Minnesota Timberwolves,-20,79,8:00p,178,Los Angeles Clippers,99
Mar 30 2016,1,Sacramento Kings,9,120,10:00p,231,Washington Wizards,111
Mar 30 2016,1,San Antonio Spurs,8,100,8:30p,192,New Orleans Pelicans,92
Mar 30 2016,1,Toronto Raptors,8,105,7:30p,202,Atlanta Hawks,97
Mar 30 2016,0,Utah Jazz,-7,96,9:00p,199,Golden State Warriors,103
Mar 31 2016,1,Cleveland Cavaliers,20,107,7:00p,194,Brooklyn Nets,87
Mar 31 2016,0,Houston Rockets,-3,100,7:00p,203,Chicago Bulls,103
Mar 31 2016,0,Indiana Pacers,-20,94,7:00p,208,Orlando Magic,114
Mar 31 2016,1,New Orleans Pelicans,6,101,8:00p,196,Denver Nuggets,95
Mar 31 2016,1,Oklahoma City Thunder,2,119,9:30p,236,Los Angeles Clippers,117
Mar 31 2016,1,Portland Trail Blazers,7,116,10:00p,225,Boston Celtics,109
Oct 28 2014,0,Los Angeles Lakers,-18,90,10:30p,198,Houston Rockets,108
Oct 28 2014,1,New Orleans Pelicans,17,101,8:00p,185,Orlando Magic,84
Oct 28 2014,1,San Antonio Spurs,1,101,8:00p,201,Dallas Mavericks,100
Oct 29 2014,1,Boston Celtics,16,121,7:30p,226,Brooklyn Nets,105
Oct 29 2014,1,Charlotte Hornets,2,108,7:00p,214,Milwaukee Bucks,106
Oct 29 2014,1,Denver Nuggets,10,89,9:00p,168,Detroit Pistons,79
Oct 29 2014,1,Indiana Pacers,12,103,7:00p,194,Philadelphia 76ers,91
Oct 29 2014,1,Memphis Grizzlies,4,105,8:00p,206,Minnesota Timberwolves,101
Oct 29 2014,1,Miami Heat,12,107,7:30p,202,Washington Wizards,95
Oct 29 2014,0,New York Knicks,-24,80,8:00p,184,Chicago Bulls,104
Oct 29 2014,1,Phoenix Suns,20,119,10:00p,218,Los Angeles Lakers,99
Oct 29 2014,1,Portland Trail Blazers,17,106,10:30p,195,Oklahoma City Thunder,89
Oct 29 2014,0,Sacramento Kings,-18,77,10:00p,172,Golden State Warriors,95
Oct 29 2014,1,Toronto Raptors,7,109,7:30p,211,Atlanta Hawks,102
Oct 29 2014,0,Utah Jazz,-11,93,9:00p,197,Houston Rockets,104
Oct 30 2014,0,Cleveland Cavaliers,-5,90,8:00p,185,New York Knicks,95
Oct 30 2014,1,Dallas Mavericks,18,120,8:30p,222,Utah Jazz,102
Oct 30 2014,1,Los Angeles Clippers,3,93,10:30p,183,Oklahoma City Thunder,90
Oct 30 2014,1,Minnesota Timberwolves,6,97,8:00p,188,Detroit Pistons,91
Oct 30 2014,0,Orlando Magic,-7,98,7:00p,203,Washington Wizards,105
Oct 31 2014,0,Chicago Bulls,-6,108,8:00p,222,Cleveland Cavaliers,114
Oct 31 2014,0,Indiana Pacers,-8,89,7:00p,186,Memphis Grizzlies,97
Oct 31 2014,0,Los Angeles Lakers,-7,111,10:30p,229,Los Angeles Clippers,118
Oct 31 2014,1,Milwaukee Bucks,12,93,8:30p,174,Philadelphia 76ers,81
Oct 31 2014,1,Phoenix Suns,5,94,10:00p,183,San Antonio Spurs,89
Oct 31 2014,1,Sacramento Kings,9,103,10:00p,197,Portland Trail Blazers,94
Nov 1 2014,1,Atlanta Hawks,10,102,7:30p,194,Indiana Pacers,92
Nov 1 2014,0,Charlotte Hornets,-2,69,7:00p,140,Memphis Grizzlies,71
Nov 1 2014,0,Detroit Pistons,-12,90,7:30p,192,Brooklyn Nets,102
Nov 1 2014,1,Golden State Warriors,23,127,10:30p,231,Los Angeles Lakers,104
Nov 1 2014,1,Houston Rockets,14,104,8:00p,194,Boston Celtics,90
Nov 1 2014,0,Minnesota Timberwolves,-1,105,8:00p,211,Chicago Bulls,106
Nov 1 2014,0,New Orleans Pelicans,-5,104,7:00p,213,Dallas Mavericks,109
Nov 1 2014,1,Oklahoma City Thunder,11,102,8:00p,193,Denver Nuggets,91
Nov 1 2014,0,Orlando Magic,-13,95,7:00p,203,Toronto Raptors,108
Nov 1 2014,0,Philadelphia 76ers,-18,96,7:00p,210,Miami Heat,114
Nov 1 2014,1,Utah Jazz,27,118,9:00p,209,Phoenix Suns,91
Nov 1 2014,1,Washington Wizards,11,108,7:00p,205,Milwaukee Bucks,97
Nov 2 2014,0,Los Angeles Clippers,-6,92,3:30p,190,Sacramento Kings,98
Nov 2 2014,1,Miami Heat,5,107,6:00p,209,Toronto Raptors,102
Nov 2 2014,1,New York Knicks,3,96,7:30p,189,Charlotte Hornets,93
Nov 2 2014,0,Portland Trail Blazers,-5,90,9:00p,185,Golden State Warriors,95
Nov 3 2014,1,Brooklyn Nets,31,116,7:30p,201,Oklahoma City Thunder,85
Nov 3 2014,1,Dallas Mavericks,5,118,8:30p,231,Boston Celtics,113
Nov 3 2014,0,Denver Nuggets,-5,105,9:00p,215,Sacramento Kings,110
Nov 3 2014,1,Los Angeles Clippers,6,107,10:30p,208,Utah Jazz,101
Nov 3 2014,1,Memphis Grizzlies,12,93,8:00p,174,New Orleans Pelicans,81
Nov 3 2014,0,Philadelphia 76ers,-11,93,7:00p,197,Houston Rockets,104
Nov 4 2014,1,Chicago Bulls,8,98,8:00p,188,Orlando Magic,90
Nov 4 2014,0,Indiana Pacers,-6,81,7:00p,168,Milwaukee Bucks,87
Nov 4 2014,0,Los Angeles Lakers,-6,106,10:30p,218,Phoenix Suns,112
Nov 4 2014,0,Miami Heat,-17,91,7:30p,199,Houston Rockets,108
Nov 4 2014,1,New Orleans Pelicans,9,100,8:00p,191,Charlotte Hornets,91
Nov 4 2014,0,New York Knicks,-15,83,7:30p,181,Washington Wizards,98
Nov 4 2014,1,Portland Trail Blazers,19,101,10:00p,183,Cleveland Cavaliers,82
Nov 4 2014,1,Toronto Raptors,12,100,7:30p,188,Oklahoma City Thunder,88
Nov 5 2014,0,Boston Celtics,-3,107,7:30p,217,Toronto Raptors,110
Nov 5 2014,0,Brooklyn Nets,-7,91,7:30p,189,Minnesota Timberwolves,98
Nov 5 2014,1,Charlotte Hornets,7,96,7:00p,185,Miami Heat,89
Nov 5 2014,1,Detroit Pistons,3,98,7:30p,193,New York Knicks,95
Nov 5 2014,1,Golden State Warriors,17,121,10:30p,225,Los Angeles Clippers,104
Nov 5 2014,0,Milwaukee Bucks,-9,86,8:00p,181,Chicago Bulls,95
Nov 5 2014,0,Philadelphia 76ers,-2,89,7:00p,180,Orlando Magic,91
Nov 5 2014,0,Phoenix Suns,-11,91,9:00p,193,Memphis Grizzlies,102
Nov 5 2014,1,Sacramento Kings,22,131,10:00p,240,Denver Nuggets,109
Nov 5 2014,1,San Antonio Spurs,2,94,8:30p,186,Atlanta Hawks,92
Nov 5 2014,1,Utah Jazz,2,102,9:00p,202,Cleveland Cavaliers,100
Nov 5 2014,1,Washington Wizards,2,96,8:00p,190,Indiana Pacers,94
Nov 6 2014,1,Houston Rockets,17,98,8:00p,179,San Antonio Spurs,81
Nov 6 2014,1,Portland Trail Blazers,21,108,10:30p,195,Dallas Mavericks,87
Nov 7 2014,1,Boston Celtics,3,101,7:30p,199,Indiana Pacers,98
Nov 7 2014,1,Brooklyn Nets,11,110,7:30p,209,New York Knicks,99
Nov 7 2014,1,Charlotte Hornets,3,122,7:00p,241,Atlanta Hawks,119
Nov 7 2014,0,Denver Nuggets,-9,101,10:30p,211,Cleveland Cavaliers,110
Nov 7 2014,1,Detroit Pistons,3,98,7:30p,193,Milwaukee Bucks,95
Nov 7 2014,0,Oklahoma City Thunder,-2,89,8:00p,180,Memphis Grizzlies,91
Nov 7 2014,1,Orlando Magic,9,112,7:00p,215,Minnesota Timberwolves,103
Nov 7 2014,0,Philadelphia 76ers,-3,115,7:00p,233,Chicago Bulls,118
Nov 7 2014,0,Phoenix Suns,-2,112,9:00p,226,Sacramento Kings,114
Nov 7 2014,1,Toronto Raptors,19,103,7:30p,187,Washington Wizards,84
Nov 7 2014,0,Utah Jazz,-23,82,9:00p,187,Dallas Mavericks,105
Nov 8 2014,1,Atlanta Hawks,7,103,7:30p,199,New York Knicks,96
Nov 8 2014,0,Chicago Bulls,-5,101,8:00p,207,Boston Celtics,106
Nov 8 2014,0,Houston Rockets,-11,87,8:00p,185,Golden State Warriors,98
Nov 8 2014,0,Indiana Pacers,-7,90,7:00p,187,Washington Wizards,97
Nov 8 2014,1,Los Angeles Clippers,4,106,3:30p,208,Portland Trail Blazers,102
Nov 8 2014,1,Miami Heat,10,102,7:30p,194,Minnesota Timberwolves,92
Nov 8 2014,1,Milwaukee Bucks,1,93,8:30p,185,Memphis Grizzlies,92
Nov 8 2014,0,San Antonio Spurs,-1,99,8:30p,199,New Orleans Pelicans,100
Nov 9 2014,1,Brooklyn Nets,8,104,3:30p,200,Orlando Magic,96
Nov 9 2014,0,Dallas Mavericks,-9,96,7:30p,201,Miami Heat,105
Nov 9 2014,0,Detroit Pistons,-1,96,6:00p,193,Utah Jazz,97
Nov 9 2014,1,Los Angeles Lakers,15,107,9:30p,199,Charlotte Hornets,92
Nov 9 2014,1,Oklahoma City Thunder,8,101,7:00p,194,Sacramento Kings,93
Nov 9 2014,1,Phoenix Suns,12,107,8:00p,202,Golden State Warriors,95
Nov 9 2014,1,Portland Trail Blazers,16,116,9:00p,216,Denver Nuggets,100
Nov 9 2014,1,Toronto Raptors,32,120,7:00p,208,Philadelphia 76ers,88
Nov 10 2014,1,Chicago Bulls,11,102,8:00p,193,Detroit Pistons,91
Nov 10 2014,1,Cleveland Cavaliers,7,118,7:00p,229,New Orleans Pelicans,111
Nov 10 2014,1,Indiana Pacers,11,97,7:00p,183,Utah Jazz,86
Nov 10 2014,0,Los Angeles Clippers,-4,85,10:30p,174,San Antonio Spurs,89
Nov 10 2014,0,New York Knicks,-6,85,7:30p,176,Atlanta Hawks,91
Nov 11 2014,1,Dallas Mavericks,8,106,8:30p,204,Sacramento Kings,98
Nov 11 2014,0,Golden State Warriors,-13,100,10:30p,213,San Antonio Spurs,113
Nov 11 2014,1,Memphis Grizzlies,5,107,8:00p,209,Los Angeles Lakers,102
Nov 11 2014,1,Milwaukee Bucks,7,85,8:00p,163,Oklahoma City Thunder,78
Nov 11 2014,1,Portland Trail Blazers,2,102,10:00p,202,Charlotte Hornets,100
Nov 11 2014,1,Toronto Raptors,4,104,7:30p,204,Orlando Magic,100
Nov 12 2014,1,Atlanta Hawks,3,100,7:30p,197,Utah Jazz,97
Nov 12 2014,0,Boston Celtics,-15,94,7:30p,203,Oklahoma City Thunder,109
Nov 12 2014,0,Denver Nuggets,-17,113,9:00p,243,Portland Trail Blazers,130
Nov 12 2014,0,Miami Heat,-6,75,7:30p,156,Indiana Pacers,81
Nov 12 2014,0,Minnesota Timberwolves,-12,101,10:00p,214,Houston Rockets,113
Nov 12 2014,1,New Orleans Pelicans,7,109,8:00p,211,Los Angeles Lakers,102
Nov 12 2014,0,New York Knicks,-2,95,7:30p,192,Orlando Magic,97
Nov 12 2014,1,Phoenix Suns,8,112,9:00p,216,Brooklyn Nets,104
Nov 12 2014,1,Washington Wizards,4,107,7:00p,210,Detroit Pistons,103
Nov 13 2014,1,Dallas Mavericks,53,123,8:30p,193,Philadelphia 76ers,70
Nov 13 2014,1,Golden State Warriors,8,107,10:30p,206,Brooklyn Nets,99
Nov 13 2014,1,Memphis Grizzlies,1,111,8:00p,221,Sacramento Kings,110
Nov 13 2014,0,Toronto Raptors,-7,93,8:00p,193,Chicago Bulls,100
Nov 14 2014,1,Atlanta Hawks,11,114,7:30p,217,Miami Heat,103
Nov 14 2014,0,Boston Celtics,-1,121,7:30p,243,Cleveland Cavaliers,122
Nov 14 2014,1,Houston Rockets,1,88,8:00p,175,Philadelphia 76ers,87
Nov 14 2014,0,Indiana Pacers,-21,87,7:00p,195,Denver Nuggets,108
Nov 14 2014,0,Los Angeles Lakers,-13,80,10:00p,173,San Antonio Spurs,93
Nov 14 2014,1,New Orleans Pelicans,48,139,8:00p,230,Minnesota Timberwolves,91
Nov 14 2014,0,New York Knicks,-2,100,7:30p,202,Utah Jazz,102
Nov 14 2014,0,Oklahoma City Thunder,-7,89,8:00p,185,Detroit Pistons,96
Nov 14 2014,1,Orlando Magic,16,101,7:00p,186,Milwaukee Bucks,85
Nov 14 2014,0,Phoenix Suns,-8,95,9:00p,198,Charlotte Hornets,103
Nov 15 2014,0,Chicago Bulls,-9,90,8:00p,189,Indiana Pacers,99
Nov 15 2014,1,Cleveland Cavaliers,33,127,7:30p,221,Atlanta Hawks,94
Nov 15 2014,1,Dallas Mavericks,14,131,8:30p,248,Minnesota Timberwolves,117
Nov 15 2014,1,Golden State Warriors,25,112,10:30p,199,Charlotte Hornets,87
Nov 15 2014,1,Los Angeles Clippers,13,120,10:30p,227,Phoenix Suns,107
Nov 15 2014,1,Memphis Grizzlies,7,95,8:00p,183,Detroit Pistons,88
Nov 15 2014,1,Portland Trail Blazers,10,97,10:00p,184,Brooklyn Nets,87
Nov 15 2014,1,Sacramento Kings,3,94,10:00p,185,San Antonio Spurs,91
Nov 15 2014,1,Toronto Raptors,18,111,7:30p,204,Utah Jazz,93
Nov 15 2014,1,Washington Wizards,5,98,7:00p,191,Orlando Magic,93
Nov 16 2014,0,Los Angeles Lakers,-21,115,9:30p,251,Golden State Warriors,136
Nov 16 2014,0,Miami Heat,-7,84,6:00p,175,Milwaukee Bucks,91
Nov 16 2014,1,New York Knicks,16,109,1:00p,202,Denver Nuggets,93
Nov 16 2014,0,Oklahoma City Thunder,-4,65,7:00p,134,Houston Rockets,69
Nov 17 2014,0,Boston Celtics,-4,114,7:30p,232,Phoenix Suns,118
Nov 17 2014,0,Brooklyn Nets,-12,83,7:30p,178,Miami Heat,95
Nov 17 2014,0,Charlotte Hornets,-27,80,7:00p,187,Dallas Mavericks,107
Nov 17 2014,0,Cleveland Cavaliers,-9,97,7:00p,203,Denver Nuggets,106
Nov 17 2014,0,Detroit Pistons,-14,93,7:30p,200,Orlando Magic,107
Nov 17 2014,0,Los Angeles Clippers,-16,89,10:30p,194,Chicago Bulls,105
Nov 17 2014,1,Memphis Grizzlies,26,119,8:00p,212,Houston Rockets,93
Nov 17 2014,1,Portland Trail Blazers,9,102,10:00p,195,New Orleans Pelicans,93
Nov 17 2014,1,San Antonio Spurs,25,100,8:30p,175,Philadelphia 76ers,75
Nov 18 2014,0,Atlanta Hawks,-5,109,7:30p,223,Los Angeles Lakers,114
Nov 18 2014,1,Milwaukee Bucks,4,117,8:00p,230,New York Knicks,113
Nov 18 2014,0,Sacramento Kings,-6,100,10:00p,206,New Orleans Pelicans,106
Nov 18 2014,1,Utah Jazz,17,98,9:00p,179,Oklahoma City Thunder,81
Nov 19 2014,0,Brooklyn Nets,-4,118,7:30p,240,Milwaukee Bucks,122
Nov 19 2014,0,Cleveland Cavaliers,-2,90,7:00p,182,San Antonio Spurs,92
Nov 19 2014,1,Denver Nuggets,7,107,9:00p,207,Oklahoma City Thunder,100
Nov 19 2014,0,Detroit Pistons,-2,86,7:30p,174,Phoenix Suns,88
Nov 19 2014,0,Houston Rockets,-6,92,9:30p,190,Los Angeles Lakers,98
Nov 19 2014,1,Indiana Pacers,2,88,7:00p,174,Charlotte Hornets,86
Nov 19 2014,1,Minnesota Timberwolves,16,115,8:00p,214,New York Knicks,99
Nov 19 2014,0,Orlando Magic,-24,90,7:00p,204,Los Angeles Clippers,114
Nov 19 2014,0,Philadelphia 76ers,-11,90,7:00p,191,Boston Celtics,101
Nov 19 2014,1,Toronto Raptors,4,96,7:30p,188,Memphis Grizzlies,92
Nov 19 2014,0,Washington Wizards,-3,102,7:00p,207,Dallas Mavericks,105
Nov 20 2014,0,Miami Heat,-17,93,8:00p,203,Los Angeles Clippers,110
Nov 20 2014,1,Sacramento Kings,15,103,10:30p,191,Chicago Bulls,88
Nov 21 2014,1,Atlanta Hawks,10,99,7:30p,188,Detroit Pistons,89
Nov 21 2014,0,Charlotte Hornets,-5,100,7:00p,205,Orlando Magic,105
Nov 21 2014,1,Dallas Mavericks,34,140,8:30p,246,Los Angeles Lakers,106
Nov 21 2014,1,Denver Nuggets,20,117,9:00p,214,New Orleans Pelicans,97
Nov 21 2014,1,Golden State Warriors,13,101,10:30p,189,Utah Jazz,88
Nov 21 2014,1,Memphis Grizzlies,17,117,8:00p,217,Boston Celtics,100
Nov 21 2014,0,Minnesota Timberwolves,-29,92,8:00p,213,San Antonio Spurs,121
Nov 21 2014,0,Oklahoma City Thunder,-2,92,8:00p,186,Brooklyn Nets,94
Nov 21 2014,0,Philadelphia 76ers,-26,96,7:00p,218,Phoenix Suns,122
Nov 21 2014,1,Portland Trail Blazers,18,105,10:30p,192,Chicago Bulls,87
Nov 21 2014,1,Toronto Raptors,42,124,7:30p,206,Milwaukee Bucks,82
Nov 21 2014,1,Washington Wizards,13,91,8:00p,169,Cleveland Cavaliers,78
Nov 22 2014,0,Cleveland Cavaliers,-17,93,7:30p,203,Toronto Raptors,110
Nov 22 2014,1,Houston Rockets,3,95,8:00p,187,Dallas Mavericks,92
Nov 22 2014,0,Indiana Pacers,-23,83,7:00p,189,Phoenix Suns,106
Nov 22 2014,0,Milwaukee Bucks,-11,100,8:30p,211,Washington Wizards,111
Nov 22 2014,0,Minnesota Timberwolves,-12,101,8:00p,214,Sacramento Kings,113
Nov 22 2014,1,New York Knicks,8,91,7:30p,174,Philadelphia 76ers,83
Nov 22 2014,0,Orlando Magic,-7,92,7:00p,191,Miami Heat,99
Nov 22 2014,1,San Antonio Spurs,12,99,8:30p,186,Brooklyn Nets,87
Nov 22 2014,0,Utah Jazz,-12,94,9:00p,200,New Orleans Pelicans,106
Nov 23 2014,0,Boston Celtics,-6,88,6:00p,182,Portland Trail Blazers,94
Nov 23 2014,0,Los Angeles Lakers,-7,94,9:30p,195,Denver Nuggets,101
Nov 23 2014,1,Memphis Grizzlies,16,107,6:00p,198,Los Angeles Clippers,91
Nov 23 2014,1,Miami Heat,1,94,6:00p,187,Charlotte Hornets,93
Nov 23 2014,0,Oklahoma City Thunder,-5,86,7:00p,177,Golden State Warriors,91
Nov 24 2014,0,Charlotte Hornets,-21,92,7:00p,205,Los Angeles Clippers,113
Nov 24 2014,1,Cleveland Cavaliers,32,106,7:00p,180,Orlando Magic,74
Nov 24 2014,0,Dallas Mavericks,-11,100,8:30p,211,Indiana Pacers,111
Nov 24 2014,1,Houston Rockets,5,91,8:00p,177,New York Knicks,86
Nov 24 2014,0,Philadelphia 76ers,-10,104,7:00p,218,Portland Trail Blazers,114
Nov 24 2014,1,Toronto Raptors,4,104,7:30p,204,Phoenix Suns,100
Nov 24 2014,0,Utah Jazz,-2,95,9:00p,192,Chicago Bulls,97
Nov 25 2014,1,Denver Nuggets,5,114,9:00p,223,Chicago Bulls,109
Nov 25 2014,0,Miami Heat,-17,97,7:30p,211,Golden State Warriors,114
Nov 25 2014,1,Milwaukee Bucks,12,98,8:00p,184,Detroit Pistons,86
Nov 25 2014,0,New Orleans Pelicans,-10,89,8:00p,188,Sacramento Kings,99
Nov 25 2014,0,Washington Wizards,-4,102,7:00p,208,Atlanta Hawks,106
Nov 26 2014,0,Atlanta Hawks,-11,115,7:30p,241,Toronto Raptors,126
Nov 26 2014,0,Charlotte Hornets,-8,97,7:00p,202,Portland Trail Blazers,105
Nov 26 2014,1,Cleveland Cavaliers,26,113,7:00p,200,Washington Wizards,87
Nov 26 2014,1,Dallas Mavericks,7,109,7:30p,211,New York Knicks,102
Nov 26 2014,0,Detroit Pistons,-6,98,7:30p,202,Los Angeles Clippers,104
Nov 26 2014,1,Houston Rockets,13,102,8:00p,191,Sacramento Kings,89
Nov 26 2014,0,Los Angeles Lakers,-6,93,10:30p,192,Memphis Grizzlies,99
Nov 26 2014,0,Minnesota Timberwolves,-17,86,8:00p,189,Milwaukee Bucks,103
Nov 26 2014,1,Oklahoma City Thunder,15,97,8:00p,179,Utah Jazz,82
Nov 26 2014,0,Orlando Magic,-15,96,7:00p,207,Golden State Warriors,111
Nov 26 2014,0,Philadelphia 76ers,-8,91,7:00p,190,Brooklyn Nets,99
Nov 26 2014,1,Phoenix Suns,8,120,9:00p,232,Denver Nuggets,112
Nov 26 2014,1,San Antonio Spurs,6,106,8:30p,206,Indiana Pacers,100
Nov 28 2014,1,Atlanta Hawks,9,100,7:30p,191,New Orleans Pelicans,91
Nov 28 2014,0,Boston Celtics,-7,102,1:00p,211,Chicago Bulls,109
Nov 28 2014,0,Charlotte Hornets,-5,101,7:00p,207,Golden State Warriors,106
Nov 28 2014,1,Denver Nuggets,25,122,9:00p,219,Phoenix Suns,97
Nov 28 2014,0,Detroit Pistons,-16,88,7:30p,192,Milwaukee Bucks,104
Nov 28 2014,0,Houston Rockets,-17,85,8:00p,187,Los Angeles Clippers,102
Nov 28 2014,1,Indiana Pacers,15,98,8:00p,181,Orlando Magic,83
Nov 28 2014,0,Los Angeles Lakers,-1,119,10:30p,239,Minnesota Timberwolves,120
Nov 28 2014,1,Oklahoma City Thunder,27,105,8:00p,183,New York Knicks,78
Nov 28 2014,0,Portland Trail Blazers,-13,99,10:00p,211,Memphis Grizzlies,112
Nov 28 2014,1,San Antonio Spurs,8,112,8:30p,216,Sacramento Kings,104
Nov 28 2014,0,Toronto Raptors,-4,102,7:30p,208,Dallas Mavericks,106
Nov 29 2014,1,Atlanta Hawks,30,105,7:30p,180,Charlotte Hornets,75
Nov 29 2014,1,Cleveland Cavaliers,12,109,7:30p,206,Indiana Pacers,97
Nov 29 2014,0,Milwaukee Bucks,-14,103,9:00p,220,Houston Rockets,117
Nov 29 2014,0,Philadelphia 76ers,-7,103,7:00p,213,Dallas Mavericks,110
Nov 29 2014,0,Utah Jazz,-16,96,9:00p,208,Los Angeles Clippers,112
Nov 29 2014,1,Washington Wizards,3,83,7:00p,163,New Orleans Pelicans,80
Nov 30 2014,0,Boston Celtics,-22,89,1:00p,200,San Antonio Spurs,111
Nov 30 2014,0,Brooklyn Nets,-18,84,3:00p,186,Chicago Bulls,102
Nov 30 2014,0,Detroit Pistons,-11,93,3:30p,197,Golden State Warriors,104
Nov 30 2014,1,Los Angeles Lakers,7,129,9:30p,251,Toronto Raptors,122
Nov 30 2014,0,New York Knicks,-7,79,7:30p,165,Miami Heat,86
Nov 30 2014,0,Phoenix Suns,-3,90,8:00p,183,Orlando Magic,93
Nov 30 2014,1,Portland Trail Blazers,14,107,9:00p,200,Minnesota Timberwolves,93
Nov 30 2014,0,Sacramento Kings,-12,85,6:00p,182,Memphis Grizzlies,97
Dec 1 2014,1,Los Angeles Clippers,26,127,10:30p,228,Minnesota Timberwolves,101
Dec 1 2014,0,Philadelphia 76ers,-6,103,7:00p,212,San Antonio Spurs,109
Dec 1 2014,0,Utah Jazz,-2,101,9:00p,204,Denver Nuggets,103
Dec 1 2014,1,Washington Wizards,21,107,7:00p,193,Miami Heat,86
Dec 2 2014,1,Atlanta Hawks,4,109,7:30p,214,Boston Celtics,105
Dec 2 2014,0,Chicago Bulls,-3,129,8:00p,261,Dallas Mavericks,132
Dec 2 2014,1,Cleveland Cavaliers,3,111,7:00p,219,Milwaukee Bucks,108
Dec 2 2014,0,Denver Nuggets,-2,103,9:00p,208,Portland Trail Blazers,105
Dec 2 2014,0,Detroit Pistons,-10,96,7:30p,202,Los Angeles Lakers,106
Dec 2 2014,1,Golden State Warriors,1,98,10:30p,195,Orlando Magic,97
Dec 2 2014,1,New Orleans Pelicans,8,112,8:00p,216,Oklahoma City Thunder,104
Dec 2 2014,0,New York Knicks,-5,93,7:30p,191,Brooklyn Nets,98
Dec 2 2014,1,Phoenix Suns,17,116,9:00p,215,Indiana Pacers,99
Dec 2 2014,0,Sacramento Kings,-8,109,10:00p,226,Toronto Raptors,117
Dec 3 2014,1,Boston Celtics,7,109,7:30p,211,Detroit Pistons,102
Dec 3 2014,1,Brooklyn Nets,2,95,7:30p,188,San Antonio Spurs,93
Dec 3 2014,0,Charlotte Hornets,-7,95,7:00p,197,Chicago Bulls,102
Dec 3 2014,1,Houston Rockets,9,105,8:00p,201,Memphis Grizzlies,96
Dec 3 2014,1,Los Angeles Clippers,28,114,10:30p,200,Orlando Magic,86
Dec 3 2014,0,Miami Heat,-10,102,7:30p,214,Atlanta Hawks,112
Dec 3 2014,0,Milwaukee Bucks,-2,105,8:00p,212,Dallas Mavericks,107
Dec 3 2014,0,Minnesota Timberwolves,-8,77,8:00p,162,Philadelphia 76ers,85
Dec 3 2014,0,Utah Jazz,-19,104,9:00p,227,Toronto Raptors,123
Dec 3 2014,1,Washington Wizards,16,111,7:00p,206,Los Angeles Lakers,95
Dec 4 2014,1,Golden State Warriors,27,112,10:30p,197,New Orleans Pelicans,85
Dec 4 2014,0,New York Knicks,-3,87,8:00p,177,Cleveland Cavaliers,90
Dec 4 2014,1,Portland Trail Blazers,6,88,10:00p,170,Indiana Pacers,82
Dec 5 2014,1,Boston Celtics,17,113,7:30p,209,Los Angeles Lakers,96
Dec 5 2014,0,Brooklyn Nets,-23,75,7:30p,173,Atlanta Hawks,98
Dec 5 2014,1,Charlotte Hornets,1,103,7:00p,205,New York Knicks,102
Dec 5 2014,0,Dallas Mavericks,-12,106,8:30p,224,Phoenix Suns,118
Dec 5 2014,0,Memphis Grizzlies,-6,101,8:00p,208,San Antonio Spurs,107
Dec 5 2014,1,Milwaukee Bucks,24,109,8:30p,194,Miami Heat,85
Dec 5 2014,0,Minnesota Timberwolves,-2,112,8:00p,226,Houston Rockets,114
Dec 5 2014,0,Philadelphia 76ers,-12,91,7:00p,194,Oklahoma City Thunder,103
Dec 5 2014,1,Sacramento Kings,1,102,10:00p,203,Indiana Pacers,101
Dec 5 2014,0,Toronto Raptors,-14,91,7:30p,196,Cleveland Cavaliers,105
Dec 5 2014,0,Utah Jazz,-5,93,9:00p,191,Orlando Magic,98
Dec 5 2014,1,Washington Wizards,30,119,7:00p,208,Denver Nuggets,89
Dec 6 2014,0,Chicago Bulls,-10,102,8:00p,214,Golden State Warriors,112
Dec 6 2014,0,Detroit Pistons,-7,101,7:30p,209,Philadelphia 76ers,108
Dec 6 2014,1,Houston Rockets,5,100,8:00p,195,Phoenix Suns,95
Dec 6 2014,1,Los Angeles Clippers,20,120,10:30p,220,New Orleans Pelicans,100
Dec 6 2014,0,Sacramento Kings,-9,96,10:00p,201,Orlando Magic,105
Dec 6 2014,1,San Antonio Spurs,22,123,8:30p,224,Minnesota Timberwolves,101
Dec 7 2014,1,Atlanta Hawks,12,96,3:30p,180,Denver Nuggets,84
Dec 7 2014,1,Boston Celtics,8,101,1:00p,194,Washington Wizards,93
Dec 7 2014,1,Dallas Mavericks,23,125,7:30p,227,Milwaukee Bucks,102
Dec 7 2014,0,Detroit Pistons,-2,94,6:00p,190,Oklahoma City Thunder,96
Dec 7 2014,0,Los Angeles Lakers,-17,87,9:30p,191,New Orleans Pelicans,104
Dec 7 2014,1,Memphis Grizzlies,16,103,6:00p,190,Miami Heat,87
Dec 7 2014,0,New York Knicks,-4,99,7:30p,202,Portland Trail Blazers,103
Dec 8 2014,0,Brooklyn Nets,-22,88,7:30p,198,Cleveland Cavaliers,110
Dec 8 2014,0,Indiana Pacers,-16,92,7:00p,200,Atlanta Hawks,108
Dec 8 2014,1,Los Angeles Clippers,1,121,10:30p,241,Phoenix Suns,120
Dec 8 2014,0,Minnesota Timberwolves,-16,86,8:00p,188,Golden State Warriors,102
Dec 8 2014,1,Sacramento Kings,9,101,10:00p,193,Utah Jazz,92
Dec 8 2014,1,Toronto Raptors,5,112,7:30p,219,Denver Nuggets,107
Dec 8 2014,1,Washington Wizards,1,133,7:00p,265,Boston Celtics,132
Dec 9 2014,1,Cleveland Cavaliers,4,105,7:00p,206,Toronto Raptors,101
Dec 9 2014,0,Detroit Pistons,-12,86,7:30p,184,Portland Trail Blazers,98
Dec 9 2014,1,Los Angeles Lakers,3,98,10:30p,193,Sacramento Kings,95
Dec 9 2014,1,Memphis Grizzlies,9,114,8:00p,219,Dallas Mavericks,105
Dec 9 2014,1,New Orleans Pelicans,11,104,8:00p,197,New York Knicks,93
Dec 9 2014,1,Oklahoma City Thunder,13,114,8:00p,215,Milwaukee Bucks,101
Dec 9 2014,0,Phoenix Suns,-6,97,9:00p,200,Miami Heat,103
Dec 9 2014,1,Utah Jazz,4,100,9:00p,196,San Antonio Spurs,96
Dec 10 2014,1,Atlanta Hawks,16,95,7:30p,174,Philadelphia 76ers,79
Dec 10 2014,1,Chicago Bulls,25,105,8:00p,185,Brooklyn Nets,80
Dec 10 2014,1,Charlotte Hornets,9,96,7:00p,183,Boston Celtics,87
Dec 10 2014,1,Dallas Mavericks,5,112,8:00p,219,New Orleans Pelicans,107
Dec 10 2014,1,Denver Nuggets,20,102,10:30p,184,Miami Heat,82
Dec 10 2014,1,Golden State Warriors,12,105,10:30p,198,Houston Rockets,93
Dec 10 2014,0,Indiana Pacers,-7,96,7:00p,199,Los Angeles Clippers,103
Dec 10 2014,1,Minnesota Timberwolves,8,90,8:00p,172,Portland Trail Blazers,82
Dec 10 2014,0,Orlando Magic,-2,89,7:00p,180,Washington Wizards,91
Dec 10 2014,1,San Antonio Spurs,14,109,8:30p,204,New York Knicks,95
Dec 11 2014,1,Oklahoma City Thunder,9,103,8:00p,197,Cleveland Cavaliers,94
Dec 11 2014,0,Sacramento Kings,-4,109,10:30p,222,Houston Rockets,113
Dec 12 2014,1,Atlanta Hawks,6,87,7:30p,168,Orlando Magic,81
Dec 12 2014,0,Boston Celtics,-6,95,7:30p,196,New York Knicks,101
Dec 12 2014,1,Brooklyn Nets,18,88,7:30p,158,Philadelphia 76ers,70
Dec 12 2014,1,Chicago Bulls,9,115,7:00p,221,Portland Trail Blazers,106
Dec 12 2014,1,Memphis Grizzlies,6,113,8:00p,220,Charlotte Hornets,107
Dec 12 2014,0,Minnesota Timberwolves,-19,92,8:00p,203,Oklahoma City Thunder,111
Dec 12 2014,1,New Orleans Pelicans,5,119,8:00p,233,Cleveland Cavaliers,114
Dec 12 2014,0,Phoenix Suns,-2,103,9:00p,208,Detroit Pistons,105
Dec 12 2014,0,San Antonio Spurs,-2,110,9:30p,222,Los Angeles Lakers,112
Dec 12 2014,1,Toronto Raptors,12,106,7:30p,200,Indiana Pacers,94
Dec 12 2014,0,Utah Jazz,-5,95,9:00p,195,Miami Heat,100
Dec 12 2014,1,Washington Wizards,8,104,7:00p,200,Los Angeles Clippers,96
Dec 13 2014,0,Charlotte Hornets,-27,87,7:00p,201,Brooklyn Nets,114
Dec 13 2014,0,Dallas Mavericks,-7,98,2:00p,203,Golden State Warriors,105
Dec 13 2014,1,Houston Rockets,12,108,8:00p,204,Denver Nuggets,96
Dec 13 2014,0,Indiana Pacers,-10,85,7:00p,180,Portland Trail Blazers,95
Dec 13 2014,1,Milwaukee Bucks,5,111,7:30p,217,Los Angeles Clippers,106
Dec 13 2014,1,Orlando Magic,1,100,7:00p,199,Atlanta Hawks,99
Dec 13 2014,0,Philadelphia 76ers,-5,115,7:30p,235,Memphis Grizzlies,120
Dec 13 2014,0,Sacramento Kings,-5,90,10:00p,185,Detroit Pistons,95
Dec 14 2014,0,Denver Nuggets,-8,91,8:00p,190,San Antonio Spurs,99
Dec 14 2014,0,Miami Heat,-18,75,6:00p,168,Chicago Bulls,93
Dec 14 2014,0,Minnesota Timberwolves,-6,94,7:00p,194,Los Angeles Lakers,100
Dec 14 2014,0,New Orleans Pelicans,-6,122,6:00p,250,Golden State Warriors,128
Dec 14 2014,0,New York Knicks,-5,90,7:30p,185,Toronto Raptors,95
Dec 14 2014,1,Oklahoma City Thunder,24,112,7:00p,200,Phoenix Suns,88
Dec 14 2014,1,Washington Wizards,9,93,6:00p,177,Utah Jazz,84
Dec 15 2014,1,Atlanta Hawks,7,93,7:30p,179,Chicago Bulls,86
Dec 15 2014,1,Cleveland Cavaliers,9,97,7:00p,185,Charlotte Hornets,88
Dec 15 2014,1,Indiana Pacers,19,110,7:00p,201,Los Angeles Lakers,91
Dec 15 2014,1,Los Angeles Clippers,22,113,10:30p,204,Detroit Pistons,91
Dec 15 2014,0,Philadelphia 76ers,-18,87,7:00p,192,Boston Celtics,105
Dec 15 2014,0,Phoenix Suns,-2,94,9:00p,190,Milwaukee Bucks,96
Dec 15 2014,1,Portland Trail Blazers,13,108,10:00p,203,San Antonio Spurs,95
Dec 15 2014,1,Toronto Raptors,13,95,7:30p,177,Orlando Magic,82
Dec 16 2014,0,Brooklyn Nets,-4,91,7:30p,186,Miami Heat,95
Dec 16 2014,1,Memphis Grizzlies,7,105,8:00p,203,Golden State Warriors,98
Dec 16 2014,1,New Orleans Pelicans,8,119,8:00p,230,Utah Jazz,111
Dec 16 2014,0,New York Knicks,-20,87,8:00p,194,Dallas Mavericks,107
Dec 16 2014,0,Sacramento Kings,-12,92,10:30p,196,Oklahoma City Thunder,104
Dec 16 2014,1,Washington Wizards,14,109,7:00p,204,Minnesota Timberwolves,95
Dec 17 2014,1,Boston Celtics,17,109,7:30p,201,Orlando Magic,92
Dec 17 2014,0,Charlotte Hornets,-5,106,7:00p,217,Phoenix Suns,111
Dec 17 2014,0,Cleveland Cavaliers,-29,98,7:00p,225,Atlanta Hawks,127
Dec 17 2014,0,Denver Nuggets,-4,111,10:30p,226,Houston Rockets,115
Dec 17 2014,0,Detroit Pistons,-11,106,7:30p,223,Dallas Mavericks,117
Dec 17 2014,1,Los Angeles Clippers,2,102,10:30p,202,Indiana Pacers,100
Dec 17 2014,0,Miami Heat,-18,87,7:30p,192,Utah Jazz,105
Dec 17 2014,1,Portland Trail Blazers,7,104,10:00p,201,Milwaukee Bucks,97
Dec 17 2014,0,San Antonio Spurs,-1,116,8:30p,233,Memphis Grizzlies,117
Dec 17 2014,1,Toronto Raptors,16,105,8:00p,194,Brooklyn Nets,89
Dec 18 2014,1,Chicago Bulls,6,103,8:00p,200,New York Knicks,97
Dec 18 2014,1,Golden State Warriors,5,114,10:30p,223,Oklahoma City Thunder,109
Dec 18 2014,0,Houston Rockets,-9,90,8:30p,189,New Orleans Pelicans,99
Dec 18 2014,0,Sacramento Kings,-1,107,10:00p,215,Milwaukee Bucks,108
Dec 19 2014,1,Boston Celtics,16,114,7:30p,212,Minnesota Timberwolves,98
Dec 19 2014,1,Cleveland Cavaliers,4,95,7:30p,186,Brooklyn Nets,91
Dec 19 2014,1,Denver Nuggets,3,109,9:00p,215,Los Angeles Clippers,106
Dec 19 2014,0,Detroit Pistons,-10,100,7:30p,210,Toronto Raptors,110
Dec 19 2014,0,Los Angeles Lakers,-1,103,10:30p,207,Oklahoma City Thunder,104
Dec 19 2014,0,Memphis Grizzlies,-6,97,8:00p,200,Chicago Bulls,103
Dec 19 2014,0,Miami Heat,-2,103,7:30p,208,Washington Wizards,105
Dec 19 2014,0,Orlando Magic,-7,94,7:00p,195,Utah Jazz,101
Dec 19 2014,0,Philadelphia 76ers,-18,91,7:00p,200,Charlotte Hornets,109
Dec 19 2014,0,San Antonio Spurs,-10,119,8:00p,248,Portland Trail Blazers,129
Dec 20 2014,1,Charlotte Hornets,18,104,7:00p,190,Utah Jazz,86
Dec 20 2014,1,Dallas Mavericks,6,99,8:30p,192,San Antonio Spurs,93
Dec 20 2014,1,Denver Nuggets,3,76,9:00p,149,Indiana Pacers,73
Dec 20 2014,0,Houston Rockets,-7,97,8:00p,201,Atlanta Hawks,104
Dec 20 2014,1,Los Angeles Clippers,4,106,10:30p,208,Milwaukee Bucks,102
Dec 20 2014,0,New Orleans Pelicans,-26,88,7:00p,202,Portland Trail Blazers,114
Dec 20 2014,0,New York Knicks,-9,90,1:00p,189,Phoenix Suns,99
Dec 21 2014,1,Brooklyn Nets,5,110,6:00p,215,Detroit Pistons,105
Dec 21 2014,1,Cleveland Cavaliers,14,105,4:30p,196,Memphis Grizzlies,91
Dec 21 2014,1,Miami Heat,16,100,6:00p,184,Boston Celtics,84
Dec 21 2014,0,Minnesota Timberwolves,-4,96,7:00p,196,Indiana Pacers,100
Dec 21 2014,0,Oklahoma City Thunder,-2,99,7:00p,200,New Orleans Pelicans,101
Dec 21 2014,0,Orlando Magic,-8,88,6:00p,184,Philadelphia 76ers,96
Dec 21 2014,1,Sacramento Kings,7,108,6:00p,209,Los Angeles Lakers,101
Dec 21 2014,1,Toronto Raptors,10,118,3:30p,226,New York Knicks,108
Dec 21 2014,0,Washington Wizards,-12,92,6:00p,196,Phoenix Suns,104
Dec 22 2014,1,Chicago Bulls,9,129,8:00p,249,Toronto Raptors,120
Dec 22 2014,1,Charlotte Hornets,28,110,7:00p,192,Denver Nuggets,82
Dec 22 2014,0,Dallas Mavericks,-3,102,8:30p,207,Atlanta Hawks,105
Dec 22 2014,1,Golden State Warriors,20,128,10:30p,236,Sacramento Kings,108
Dec 22 2014,1,Houston Rockets,15,110,8:00p,205,Portland Trail Blazers,95
Dec 22 2014,0,Memphis Grizzlies,-6,91,8:00p,188,Utah Jazz,97
Dec 22 2014,1,San Antonio Spurs,7,125,8:30p,243,Los Angeles Clippers,118
Dec 23 2014,1,Atlanta Hawks,3,107,7:30p,211,Los Angeles Clippers,104
Dec 23 2014,1,Brooklyn Nets,6,102,7:30p,198,Denver Nuggets,96
Dec 23 2014,1,Cleveland Cavaliers,21,125,7:00p,229,Minnesota Timberwolves,104
Dec 23 2014,1,Indiana Pacers,12,96,7:00p,180,New Orleans Pelicans,84
Dec 23 2014,1,Los Angeles Lakers,10,115,10:30p,220,Golden State Warriors,105
Dec 23 2014,0,Miami Heat,-4,87,7:30p,178,Philadelphia 76ers,91
Dec 23 2014,0,Milwaukee Bucks,-7,101,8:00p,209,Charlotte Hornets,108
Dec 23 2014,0,Oklahoma City Thunder,-4,111,8:00p,226,Portland Trail Blazers,115
Dec 23 2014,1,Orlando Magic,5,100,7:00p,195,Boston Celtics,95
Dec 23 2014,1,Phoenix Suns,9,124,9:00p,239,Dallas Mavericks,115
Dec 23 2014,0,Washington Wizards,-8,91,7:00p,190,Chicago Bulls,99
Dec 25 2014,1,Chicago Bulls,20,113,8:00p,206,Los Angeles Lakers,93
Dec 25 2014,1,Los Angeles Clippers,14,100,10:30p,186,Golden State Warriors,86
Dec 25 2014,1,Miami Heat,10,101,5:00p,192,Cleveland Cavaliers,91
Dec 25 2014,0,New York Knicks,-11,91,12:00p,193,Washington Wizards,102
Dec 25 2014,0,San Antonio Spurs,-8,106,2:30p,220,Oklahoma City Thunder,114
Dec 26 2014,0,Atlanta Hawks,-30,77,7:30p,184,Milwaukee Bucks,107
Dec 26 2014,0,Boston Celtics,-2,107,1:00p,216,Brooklyn Nets,109
Dec 26 2014,1,Dallas Mavericks,4,102,8:30p,200,Los Angeles Lakers,98
Dec 26 2014,1,Denver Nuggets,4,106,9:00p,208,Minnesota Timberwolves,102
Dec 26 2014,1,Detroit Pistons,10,119,7:30p,228,Indiana Pacers,109
Dec 26 2014,0,Memphis Grizzlies,-6,111,8:00p,228,Houston Rockets,117
Dec 26 2014,1,New Orleans Pelicans,7,97,8:00p,187,San Antonio Spurs,90
Dec 26 2014,1,Oklahoma City Thunder,23,98,8:00p,173,Charlotte Hornets,75
Dec 26 2014,0,Orlando Magic,-9,89,7:00p,187,Cleveland Cavaliers,98
Dec 26 2014,1,Portland Trail Blazers,21,114,10:00p,207,Philadelphia 76ers,93
Dec 26 2014,0,Sacramento Kings,-9,106,10:00p,221,Phoenix Suns,115
Dec 27 2014,0,Brooklyn Nets,-25,85,8:00p,195,Indiana Pacers,110
Dec 27 2014,1,Chicago Bulls,7,107,8:00p,207,New Orleans Pelicans,100
Dec 27 2014,0,Charlotte Hornets,-8,94,7:00p,196,Orlando Magic,102
Dec 27 2014,1,Golden State Warriors,13,110,10:30p,207,Minnesota Timberwolves,97
Dec 27 2014,0,Los Angeles Clippers,-12,98,3:30p,208,Toronto Raptors,110
Dec 27 2014,0,Miami Heat,-8,95,7:30p,198,Memphis Grizzlies,103
Dec 27 2014,0,Milwaukee Bucks,-5,85,8:30p,175,Atlanta Hawks,90
Dec 27 2014,1,Sacramento Kings,6,135,10:00p,264,New York Knicks,129
Dec 27 2014,1,Utah Jazz,17,88,9:00p,159,Philadelphia 76ers,71
Dec 27 2014,1,Washington Wizards,13,101,7:00p,189,Boston Celtics,88
Dec 28 2014,0,Cleveland Cavaliers,-23,80,4:30p,183,Detroit Pistons,103
Dec 28 2014,1,Dallas Mavericks,5,112,7:30p,219,Oklahoma City Thunder,107
Dec 28 2014,0,Denver Nuggets,-14,102,9:00p,218,Toronto Raptors,116
Dec 28 2014,0,Los Angeles Lakers,-9,107,9:30p,223,Phoenix Suns,116
Dec 28 2014,1,Portland Trail Blazers,22,101,9:00p,180,New York Knicks,79
Dec 28 2014,1,San Antonio Spurs,4,110,7:00p,216,Houston Rockets,106
Dec 29 2014,1,Brooklyn Nets,8,107,7:30p,206,Sacramento Kings,99
Dec 29 2014,0,Charlotte Hornets,-10,94,7:00p,198,Milwaukee Bucks,104
Dec 29 2014,0,Houston Rockets,-1,103,8:00p,207,Washington Wizards,104
Dec 29 2014,0,Indiana Pacers,-2,90,7:00p,182,Chicago Bulls,92
Dec 29 2014,1,Los Angeles Clippers,4,101,10:30p,198,Utah Jazz,97
Dec 29 2014,0,Miami Heat,-1,101,7:30p,203,Orlando Magic,102
Dec 30 2014,1,Atlanta Hawks,8,109,7:30p,210,Cleveland Cavaliers,101
Dec 30 2014,0,Chicago Bulls,-14,82,8:00p,178,Brooklyn Nets,96
Dec 30 2014,1,Dallas Mavericks,27,114,8:30p,201,Washington Wizards,87
Dec 30 2014,0,Denver Nuggets,-8,103,9:00p,214,Los Angeles Lakers,111
Dec 30 2014,1,Golden State Warriors,40,126,10:30p,212,Philadelphia 76ers,86
Dec 30 2014,1,Memphis Grizzlies,8,95,8:00p,182,San Antonio Spurs,87
Dec 30 2014,1,New Orleans Pelicans,4,110,8:00p,216,Phoenix Suns,106
Dec 30 2014,0,Orlando Magic,-23,86,7:00p,195,Detroit Pistons,109
Dec 30 2014,1,Portland Trail Blazers,5,102,10:00p,199,Toronto Raptors,97
Dec 30 2014,1,Utah Jazz,6,100,9:00p,194,Minnesota Timberwolves,94
Dec 31 2014,1,Boston Celtics,22,106,1:00p,190,Sacramento Kings,84
Dec 31 2014,0,Cleveland Cavaliers,-16,80,7:00p,176,Milwaukee Bucks,96
Dec 31 2014,1,Houston Rockets,19,102,7:00p,185,Charlotte Hornets,83
Dec 31 2014,1,Indiana Pacers,11,106,3:00p,201,Miami Heat,95
Dec 31 2014,1,Los Angeles Clippers,21,99,6:00p,177,New York Knicks,78
Dec 31 2014,1,Oklahoma City Thunder,3,137,8:00p,271,Phoenix Suns,134
Dec 31 2014,1,San Antonio Spurs,2,95,7:00p,188,New Orleans Pelicans,93
Jan 1 2015,1,Chicago Bulls,5,106,8:00p,207,Denver Nuggets,101
Jan 1 2015,0,Minnesota Timberwolves,-3,107,8:00p,217,Sacramento Kings,110
Jan 2 2015,0,Boston Celtics,-18,101,7:30p,220,Dallas Mavericks,119
Jan 2 2015,0,Charlotte Hornets,-4,87,7:00p,178,Cleveland Cavaliers,91
Jan 2 2015,1,Golden State Warriors,21,126,10:30p,231,Toronto Raptors,105
Jan 2 2015,0,Los Angeles Lakers,-3,106,10:30p,215,Memphis Grizzlies,109
Jan 2 2015,0,Milwaukee Bucks,-3,91,8:30p,185,Indiana Pacers,94
Jan 2 2015,1,New Orleans Pelicans,28,111,8:00p,194,Houston Rockets,83
Jan 2 2015,0,New York Knicks,-16,81,7:30p,178,Detroit Pistons,97
Jan 2 2015,1,Oklahoma City Thunder,7,109,8:00p,211,Washington Wizards,102
Jan 2 2015,0,Orlando Magic,-2,98,7:00p,198,Brooklyn Nets,100
Jan 2 2015,1,Phoenix Suns,16,112,9:00p,208,Philadelphia 76ers,96
Jan 2 2015,0,Utah Jazz,-6,92,9:00p,190,Atlanta Hawks,98
Jan 3 2015,1,Chicago Bulls,5,109,8:00p,213,Boston Celtics,104
Jan 3 2015,1,Denver Nuggets,29,114,9:00p,199,Memphis Grizzlies,85
Jan 3 2015,1,Houston Rockets,36,115,8:00p,194,Miami Heat,79
Jan 3 2015,1,Los Angeles Clippers,36,127,10:30p,218,Philadelphia 76ers,91
Jan 3 2015,0,Minnesota Timberwolves,-12,89,8:00p,190,Utah Jazz,101
Jan 3 2015,0,Orlando Magic,-8,90,7:00p,188,Charlotte Hornets,98
Jan 3 2015,0,Portland Trail Blazers,-8,107,10:00p,222,Atlanta Hawks,115
Jan 3 2015,1,San Antonio Spurs,9,101,8:30p,193,Washington Wizards,92
Jan 4 2015,0,Cleveland Cavaliers,-19,90,1:00p,199,Dallas Mavericks,109
Jan 4 2015,1,Detroit Pistons,19,114,6:00p,209,Sacramento Kings,95
Jan 4 2015,1,Los Angeles Lakers,1,88,9:30p,175,Indiana Pacers,87
Jan 4 2015,1,Miami Heat,4,88,6:00p,172,Brooklyn Nets,84
Jan 4 2015,0,New York Knicks,-13,82,7:30p,177,Milwaukee Bucks,95
Jan 4 2015,1,Phoenix Suns,16,125,8:00p,234,Toronto Raptors,109
Jan 5 2015,0,Boston Celtics,-9,95,7:30p,199,Charlotte Hornets,104
Jan 5 2015,0,Brooklyn Nets,-8,88,7:30p,184,Dallas Mavericks,96
Jan 5 2015,1,Chicago Bulls,9,114,8:00p,219,Houston Rockets,105
Jan 5 2015,1,Golden State Warriors,26,117,10:30p,208,Oklahoma City Thunder,91
Jan 5 2015,0,Los Angeles Clippers,-9,98,10:30p,205,Atlanta Hawks,107
Jan 5 2015,1,Memphis Grizzlies,22,105,8:00p,188,New York Knicks,83
Jan 5 2015,0,Minnesota Timberwolves,-9,101,8:00p,211,Denver Nuggets,110
Jan 5 2015,0,New Orleans Pelicans,-7,85,8:00p,177,Washington Wizards,92
Jan 5 2015,1,Philadelphia 76ers,3,95,7:00p,187,Cleveland Cavaliers,92
Jan 5 2015,1,Portland Trail Blazers,4,98,10:00p,192,Los Angeles Lakers,94
Jan 5 2015,0,Utah Jazz,-4,101,9:00p,206,Indiana Pacers,105
Jan 6 2015,0,Milwaukee Bucks,-6,96,8:00p,198,Phoenix Suns,102
Jan 6 2015,0,San Antonio Spurs,-1,104,8:30p,209,Detroit Pistons,105
Jan 7 2015,1,Atlanta Hawks,10,96,7:30p,182,Memphis Grizzlies,86
Jan 7 2015,0,Brooklyn Nets,-8,81,7:30p,170,Boston Celtics,89
Jan 7 2015,0,Chicago Bulls,-20,77,8:00p,174,Utah Jazz,97
Jan 7 2015,1,Charlotte Hornets,4,98,7:00p,192,New Orleans Pelicans,94
Jan 7 2015,0,Cleveland Cavaliers,-12,93,7:00p,198,Houston Rockets,105
Jan 7 2015,0,Dallas Mavericks,-13,95,8:30p,203,Detroit Pistons,108
Jan 7 2015,1,Denver Nuggets,3,93,9:00p,183,Orlando Magic,90
Jan 7 2015,1,Golden State Warriors,15,117,10:30p,219,Indiana Pacers,102
Jan 7 2015,1,Los Angeles Clippers,25,114,10:30p,203,Los Angeles Lakers,89
Jan 7 2015,0,Minnesota Timberwolves,-2,111,9:30p,224,Phoenix Suns,113
Jan 7 2015,0,Philadelphia 76ers,-20,77,7:00p,174,Milwaukee Bucks,97
Jan 7 2015,1,Sacramento Kings,21,104,10:00p,187,Oklahoma City Thunder,83
Jan 7 2015,1,Washington Wizards,10,101,7:00p,192,New York Knicks,91
Jan 8 2015,0,New York Knicks,-24,96,8:00p,216,Houston Rockets,120
Jan 8 2015,1,Portland Trail Blazers,16,99,10:30p,182,Miami Heat,83
Jan 8 2015,0,Toronto Raptors,-8,95,7:30p,198,Charlotte Hornets,103
Jan 9 2015,0,Brooklyn Nets,-2,88,7:30p,178,Philadelphia 76ers,90
Jan 9 2015,0,Detroit Pistons,-3,103,7:30p,209,Atlanta Hawks,106
Jan 9 2015,1,Golden State Warriors,18,112,10:30p,206,Cleveland Cavaliers,94
Jan 9 2015,1,Indiana Pacers,4,107,7:00p,210,Boston Celtics,103
Jan 9 2015,1,Los Angeles Lakers,17,101,10:30p,185,Orlando Magic,84
Jan 9 2015,1,Milwaukee Bucks,14,98,8:30p,182,Minnesota Timberwolves,84
Jan 9 2015,1,New Orleans Pelicans,11,106,8:00p,201,Memphis Grizzlies,95
Jan 9 2015,1,Oklahoma City Thunder,5,99,8:00p,193,Utah Jazz,94
Jan 9 2015,0,Sacramento Kings,-10,108,10:00p,226,Denver Nuggets,118
Jan 9 2015,1,San Antonio Spurs,5,100,8:30p,195,Phoenix Suns,95
Jan 9 2015,1,Washington Wizards,16,102,8:00p,188,Chicago Bulls,86
Jan 10 2015,1,Chicago Bulls,8,95,8:00p,182,Milwaukee Bucks,87
Jan 10 2015,1,Detroit Pistons,5,98,7:30p,191,Brooklyn Nets,93
Jan 10 2015,1,Houston Rockets,15,97,8:00p,179,Utah Jazz,82
Jan 10 2015,1,Los Angeles Clippers,20,120,3:30p,220,Dallas Mavericks,100
Jan 10 2015,0,Minnesota Timberwolves,-15,93,8:00p,201,San Antonio Spurs,108
Jan 10 2015,0,New York Knicks,-28,82,1:00p,192,Charlotte Hornets,110
Jan 10 2015,1,Philadelphia 76ers,1,93,7:30p,185,Indiana Pacers,92
Jan 10 2015,1,Portland Trail Blazers,11,103,10:00p,195,Orlando Magic,92
Jan 10 2015,1,Toronto Raptors,13,109,7:30p,205,Boston Celtics,96
Jan 11 2015,1,Atlanta Hawks,31,120,3:00p,209,Washington Wizards,89
Jan 11 2015,0,Los Angeles Clippers,-14,90,3:30p,194,Miami Heat,104
Jan 11 2015,0,Los Angeles Lakers,-12,94,9:30p,200,Portland Trail Blazers,106
Jan 11 2015,1,Memphis Grizzlies,12,122,6:00p,232,Phoenix Suns,110
Jan 11 2015,1,Sacramento Kings,19,103,9:00p,187,Cleveland Cavaliers,84
Jan 12 2015,1,Boston Celtics,8,108,7:30p,208,New Orleans Pelicans,100
Jan 12 2015,0,Brooklyn Nets,-14,99,7:30p,212,Houston Rockets,113
Jan 12 2015,0,Chicago Bulls,-7,114,8:00p,235,Orlando Magic,121
Jan 12 2015,0,Toronto Raptors,-3,111,7:30p,225,Detroit Pistons,114
Jan 13 2015,0,Indiana Pacers,-9,101,7:00p,211,Minnesota Timberwolves,110
Jan 13 2015,0,Los Angeles Lakers,-3,75,10:30p,153,Miami Heat,78
Jan 13 2015,0,Philadelphia 76ers,-18,87,7:00p,192,Atlanta Hawks,105
Jan 13 2015,1,Phoenix Suns,7,107,9:00p,207,Cleveland Cavaliers,100
Jan 13 2015,0,Sacramento Kings,-4,104,10:00p,212,Dallas Mavericks,108
Jan 13 2015,0,Utah Jazz,-11,105,9:00p,221,Golden State Warriors,116
Jan 13 2015,1,Washington Wizards,8,101,7:00p,194,San Antonio Spurs,93
Jan 14 2015,0,Boston Celtics,-14,91,8:00p,196,Atlanta Hawks,105
Jan 14 2015,0,Brooklyn Nets,-11,92,7:30p,195,Memphis Grizzlies,103
Jan 14 2015,0,Chicago Bulls,-6,99,8:00p,204,Washington Wizards,105
Jan 14 2015,0,Charlotte Hornets,-5,93,7:00p,191,San Antonio Spurs,98
Jan 14 2015,1,Denver Nuggets,7,114,9:00p,221,Dallas Mavericks,107
Jan 14 2015,0,Detroit Pistons,-11,94,7:30p,199,New Orleans Pelicans,105
Jan 14 2015,1,Golden State Warriors,15,104,10:30p,193,Miami Heat,89
Jan 14 2015,1,Orlando Magic,7,120,7:00p,233,Houston Rockets,113
Jan 14 2015,0,Portland Trail Blazers,-6,94,10:30p,194,Los Angeles Clippers,100
Jan 14 2015,1,Toronto Raptors,16,100,7:30p,184,Philadelphia 76ers,84
Jan 15 2015,1,Houston Rockets,11,112,8:00p,213,Oklahoma City Thunder,101
Jan 15 2015,0,Los Angeles Lakers,-7,102,10:30p,211,Cleveland Cavaliers,109
Jan 15 2015,1,Milwaukee Bucks,16,95,3:00p,174,New York Knicks,79
Jan 16 2015,0,Boston Celtics,-16,103,7:30p,222,Chicago Bulls,119
Jan 16 2015,1,Dallas Mavericks,8,97,8:30p,186,Denver Nuggets,89
Jan 16 2015,0,Indiana Pacers,-2,96,7:00p,194,Detroit Pistons,98
Jan 16 2015,0,Los Angeles Clippers,-5,121,10:30p,247,Cleveland Cavaliers,126
Jan 16 2015,1,Oklahoma City Thunder,12,127,8:00p,242,Golden State Warriors,115
Jan 16 2015,0,Orlando Magic,-10,96,7:00p,202,Memphis Grizzlies,106
Jan 16 2015,1,Philadelphia 76ers,15,96,7:00p,177,New Orleans Pelicans,81
Jan 16 2015,1,Phoenix Suns,11,110,9:00p,209,Minnesota Timberwolves,99
Jan 16 2015,0,Sacramento Kings,-12,83,10:00p,178,Miami Heat,95
Jan 16 2015,1,San Antonio Spurs,14,110,8:30p,206,Portland Trail Blazers,96
Jan 16 2015,0,Toronto Raptors,-21,89,7:30p,199,Atlanta Hawks,110
Jan 16 2015,1,Utah Jazz,9,94,9:00p,179,Los Angeles Lakers,85
Jan 16 2015,0,Washington Wizards,-22,80,7:00p,182,Brooklyn Nets,102
Jan 17 2015,0,Brooklyn Nets,-9,90,8:00p,189,Washington Wizards,99
Jan 17 2015,0,Chicago Bulls,-8,99,8:00p,206,Atlanta Hawks,107
Jan 17 2015,1,Charlotte Hornets,9,80,7:00p,151,Indiana Pacers,71
Jan 17 2015,0,Denver Nuggets,-8,105,9:00p,218,Minnesota Timberwolves,113
Jan 17 2015,1,Detroit Pistons,18,107,7:30p,196,Philadelphia 76ers,89
Jan 17 2015,0,Houston Rockets,-25,106,8:00p,237,Golden State Warriors,131
Jan 17 2015,1,Memphis Grizzlies,4,102,9:00p,200,Portland Trail Blazers,98
Jan 17 2015,0,Sacramento Kings,-9,108,10:00p,225,Los Angeles Clippers,117
Jan 18 2015,0,Orlando Magic,-28,99,6:00p,226,Oklahoma City Thunder,127
Jan 18 2015,1,San Antonio Spurs,20,89,7:00p,158,Utah Jazz,69
Jan 18 2015,0,Toronto Raptors,-2,93,3:30p,188,New Orleans Pelicans,95
Jan 19 2015,1,Atlanta Hawks,11,93,2:30p,175,Detroit Pistons,82
Jan 19 2015,1,Charlotte Hornets,25,105,2:00p,185,Minnesota Timberwolves,80
Jan 19 2015,1,Cleveland Cavaliers,14,108,7:30p,202,Chicago Bulls,94
Jan 19 2015,1,Golden State Warriors,43,122,4:00p,201,Denver Nuggets,79
Jan 19 2015,1,Houston Rockets,12,110,5:30p,208,Indiana Pacers,98
Jan 19 2015,1,Los Angeles Clippers,9,102,3:30p,195,Boston Celtics,93
Jan 19 2015,0,Memphis Grizzlies,-8,95,5:00p,198,Dallas Mavericks,103
Jan 19 2015,0,Milwaukee Bucks,-3,89,8:00p,181,Toronto Raptors,92
Jan 19 2015,1,New York Knicks,7,99,5:30p,191,New Orleans Pelicans,92
Jan 19 2015,1,Phoenix Suns,15,115,10:00p,215,Los Angeles Lakers,100
Jan 19 2015,1,Portland Trail Blazers,4,98,10:00p,192,Sacramento Kings,94
Jan 19 2015,1,Washington Wizards,35,111,2:00p,187,Philadelphia 76ers,76
Jan 20 2015,0,Denver Nuggets,-10,99,9:00p,208,San Antonio Spurs,109
Jan 20 2015,0,Miami Heat,-8,86,7:30p,180,Oklahoma City Thunder,94
Jan 21 2015,1,Atlanta Hawks,19,110,7:30p,201,Indiana Pacers,91
Jan 21 2015,1,Charlotte Hornets,2,78,7:00p,154,Miami Heat,76
Jan 21 2015,1,Cleveland Cavaliers,14,106,7:00p,198,Utah Jazz,92
Jan 21 2015,1,Detroit Pistons,10,128,7:30p,246,Orlando Magic,118
Jan 21 2015,1,Golden State Warriors,13,126,10:30p,239,Houston Rockets,113
Jan 21 2015,1,Memphis Grizzlies,6,92,8:00p,178,Toronto Raptors,86
Jan 21 2015,0,Minnesota Timberwolves,-23,75,8:00p,173,Dallas Mavericks,98
Jan 21 2015,1,New Orleans Pelicans,16,96,8:00p,176,Los Angeles Lakers,80
Jan 21 2015,0,Philadelphia 76ers,-7,91,7:00p,189,New York Knicks,98
Jan 21 2015,1,Phoenix Suns,5,118,9:00p,231,Portland Trail Blazers,113
Jan 21 2015,0,Sacramento Kings,-3,100,10:00p,203,Brooklyn Nets,103
Jan 21 2015,0,Washington Wizards,-2,103,8:00p,208,Oklahoma City Thunder,105
Jan 22 2015,1,Chicago Bulls,23,104,8:00p,185,San Antonio Spurs,81
Jan 22 2015,1,Los Angeles Clippers,39,123,10:30p,207,Brooklyn Nets,84
Jan 22 2015,0,Milwaukee Bucks,-2,99,8:00p,200,Utah Jazz,101
Jan 22 2015,0,Portland Trail Blazers,-1,89,10:00p,179,Boston Celtics,90
Jan 23 2015,1,Atlanta Hawks,10,103,7:30p,196,Oklahoma City Thunder,93
Jan 23 2015,1,Cleveland Cavaliers,39,129,7:30p,219,Charlotte Hornets,90
Jan 23 2015,0,Dallas Mavericks,-4,98,8:00p,200,Chicago Bulls,102
Jan 23 2015,0,Denver Nuggets,-1,99,9:00p,199,Boston Celtics,100
Jan 23 2015,1,Golden State Warriors,25,126,10:30p,227,Sacramento Kings,101
Jan 23 2015,1,Miami Heat,2,89,7:30p,176,Indiana Pacers,87
Jan 23 2015,0,Minnesota Timberwolves,-8,84,8:00p,176,New Orleans Pelicans,92
Jan 23 2015,1,New York Knicks,7,113,7:30p,219,Orlando Magic,106
Jan 23 2015,0,Philadelphia 76ers,-5,86,7:00p,177,Toronto Raptors,91
Jan 23 2015,0,Phoenix Suns,-2,111,9:00p,224,Houston Rockets,113
Jan 23 2015,1,San Antonio Spurs,14,99,8:30p,184,Los Angeles Lakers,85
Jan 24 2015,1,Charlotte Hornets,5,76,7:00p,147,New York Knicks,71
Jan 24 2015,1,Memphis Grizzlies,18,101,8:00p,184,Philadelphia 76ers,83
Jan 24 2015,1,Milwaukee Bucks,15,101,7:30p,187,Detroit Pistons,86
Jan 24 2015,1,Portland Trail Blazers,7,103,10:00p,199,Washington Wizards,96
Jan 24 2015,1,Utah Jazz,35,108,9:00p,181,Brooklyn Nets,73
Jan 25 2015,1,Atlanta Hawks,12,112,6:00p,212,Minnesota Timberwolves,100
Jan 25 2015,0,Chicago Bulls,-12,84,1:00p,180,Miami Heat,96
Jan 25 2015,1,Cleveland Cavaliers,10,108,3:30p,206,Oklahoma City Thunder,98
Jan 25 2015,0,Denver Nuggets,-2,115,8:00p,232,Washington Wizards,117
Jan 25 2015,1,Golden State Warriors,3,114,8:00p,225,Boston Celtics,111
Jan 25 2015,0,Los Angeles Lakers,-12,87,9:30p,186,Houston Rockets,99
Jan 25 2015,1,New Orleans Pelicans,3,109,6:00p,215,Dallas Mavericks,106
Jan 25 2015,0,Orlando Magic,-7,99,6:00p,205,Indiana Pacers,106
Jan 25 2015,0,Phoenix Suns,-20,100,6:00p,220,Los Angeles Clippers,120
Jan 25 2015,1,San Antonio Spurs,6,101,7:00p,196,Milwaukee Bucks,95
Jan 25 2015,1,Toronto Raptors,4,114,7:00p,224,Detroit Pistons,110
Jan 26 2015,1,Los Angeles Clippers,4,102,10:30p,200,Denver Nuggets,98
Jan 26 2015,1,Memphis Grizzlies,9,103,8:00p,197,Orlando Magic,94
Jan 26 2015,1,New Orleans Pelicans,25,99,8:00p,173,Philadelphia 76ers,74
Jan 26 2015,1,Oklahoma City Thunder,8,92,8:00p,176,Minnesota Timberwolves,84
Jan 26 2015,0,Utah Jazz,-9,90,9:00p,189,Boston Celtics,99
Jan 27 2015,0,Dallas Mavericks,-19,90,8:30p,199,Memphis Grizzlies,109
Jan 27 2015,0,Detroit Pistons,-8,95,7:30p,198,Cleveland Cavaliers,103
Jan 27 2015,0,Golden State Warriors,-2,111,10:30p,224,Chicago Bulls,113
Jan 27 2015,0,Indiana Pacers,-13,91,7:00p,195,Toronto Raptors,104
Jan 27 2015,0,Los Angeles Lakers,-6,92,10:30p,190,Washington Wizards,98
Jan 27 2015,0,Miami Heat,-7,102,7:30p,211,Milwaukee Bucks,109
Jan 28 2015,1,Atlanta Hawks,11,113,8:00p,215,Brooklyn Nets,102
Jan 28 2015,1,Cleveland Cavaliers,5,99,7:00p,193,Portland Trail Blazers,94
Jan 28 2015,1,Houston Rockets,5,99,8:00p,193,Dallas Mavericks,94
Jan 28 2015,1,Minnesota Timberwolves,12,110,8:00p,208,Boston Celtics,98
Jan 28 2015,0,New Orleans Pelicans,-8,85,8:00p,178,Denver Nuggets,93
Jan 28 2015,1,New York Knicks,8,100,8:00p,192,Oklahoma City Thunder,92
Jan 28 2015,1,Philadelphia 76ers,20,89,7:00p,158,Detroit Pistons,69
Jan 28 2015,1,Phoenix Suns,8,106,10:30p,204,Washington Wizards,98
Jan 28 2015,1,San Antonio Spurs,9,95,8:30p,181,Charlotte Hornets,86
Jan 28 2015,1,Toronto Raptors,17,119,7:30p,221,Sacramento Kings,102
Jan 28 2015,0,Utah Jazz,-5,89,9:00p,183,Los Angeles Clippers,94
Jan 29 2015,1,Indiana Pacers,21,103,7:00p,185,New York Knicks,82
Jan 29 2015,1,Los Angeles Lakers,5,123,10:30p,241,Chicago Bulls,118
Jan 29 2015,1,Memphis Grizzlies,30,99,8:00p,168,Denver Nuggets,69
Jan 29 2015,0,Orlando Magic,-15,100,7:00p,215,Milwaukee Bucks,115
Jan 30 2015,1,Atlanta Hawks,6,105,7:30p,204,Portland Trail Blazers,99
Jan 30 2015,0,Boston Celtics,-6,87,7:30p,180,Houston Rockets,93
Jan 30 2015,0,Brooklyn Nets,-5,122,7:30p,249,Toronto Raptors,127
Jan 30 2015,1,Cleveland Cavaliers,11,101,7:30p,191,Sacramento Kings,90
Jan 30 2015,0,Miami Heat,-21,72,8:00p,165,Dallas Mavericks,93
Jan 30 2015,1,New Orleans Pelicans,5,108,8:00p,211,Los Angeles Clippers,103
Jan 30 2015,1,Philadelphia 76ers,9,103,7:00p,197,Minnesota Timberwolves,94
Jan 30 2015,1,Phoenix Suns,6,99,10:30p,192,Chicago Bulls,93
Jan 30 2015,1,Utah Jazz,10,110,9:00p,210,Golden State Warriors,100
Jan 31 2015,1,Atlanta Hawks,6,91,7:30p,176,Philadelphia 76ers,85
Jan 31 2015,0,Denver Nuggets,-18,86,9:00p,190,Charlotte Hornets,104
Jan 31 2015,1,Detroit Pistons,13,114,7:30p,215,Houston Rockets,101
Jan 31 2015,1,Golden State Warriors,19,106,10:30p,193,Phoenix Suns,87
Jan 31 2015,0,Indiana Pacers,-5,94,7:00p,193,Sacramento Kings,99
Jan 31 2015,1,Memphis Grizzlies,11,85,8:00p,159,Oklahoma City Thunder,74
Jan 31 2015,1,Milwaukee Bucks,7,95,8:30p,183,Portland Trail Blazers,88
Jan 31 2015,0,Minnesota Timberwolves,-16,90,8:00p,196,Cleveland Cavaliers,106
Jan 31 2015,0,Orlando Magic,-15,93,7:00p,201,Dallas Mavericks,108
Jan 31 2015,0,San Antonio Spurs,-20,85,9:00p,190,Los Angeles Clippers,105
Jan 31 2015,0,Washington Wizards,-4,116,7:00p,236,Toronto Raptors,120
Feb 1 2015,0,Boston Celtics,-8,75,1:00p,158,Miami Heat,83
Feb 1 2015,1,New York Knicks,12,92,2:00p,172,Los Angeles Lakers,80
Feb 2 2015,1,Brooklyn Nets,2,102,7:30p,202,Los Angeles Clippers,100
Feb 2 2015,1,Cleveland Cavaliers,13,97,7:00p,181,Philadelphia 76ers,84
Feb 2 2015,1,Dallas Mavericks,6,100,8:30p,194,Minnesota Timberwolves,94
Feb 2 2015,1,New Orleans Pelicans,15,115,8:00p,215,Atlanta Hawks,100
Feb 2 2015,1,Oklahoma City Thunder,7,104,8:00p,201,Orlando Magic,97
Feb 2 2015,0,Phoenix Suns,-1,101,9:00p,203,Memphis Grizzlies,102
Feb 2 2015,0,Toronto Raptors,-7,75,7:30p,157,Milwaukee Bucks,82
Feb 2 2015,0,Washington Wizards,-4,88,7:00p,180,Charlotte Hornets,92
Feb 3 2015,1,Detroit Pistons,17,108,7:30p,199,Miami Heat,91
Feb 3 2015,0,New York Knicks,-11,97,7:30p,205,Boston Celtics,108
Feb 3 2015,1,Philadelphia 76ers,7,105,7:00p,203,Denver Nuggets,98
Feb 3 2015,1,Portland Trail Blazers,1,103,10:00p,205,Utah Jazz,102
Feb 3 2015,0,Sacramento Kings,-25,96,10:00p,217,Golden State Warriors,121
Feb 4 2015,1,Atlanta Hawks,9,105,7:30p,201,Washington Wizards,96
Feb 4 2015,1,Boston Celtics,4,104,7:30p,204,Denver Nuggets,100
Feb 4 2015,1,Golden State Warriors,14,128,10:30p,242,Dallas Mavericks,114
Feb 4 2015,1,Houston Rockets,11,101,8:00p,191,Chicago Bulls,90
Feb 4 2015,1,Indiana Pacers,5,114,7:00p,223,Detroit Pistons,109
Feb 4 2015,1,Milwaukee Bucks,8,113,8:00p,218,Los Angeles Lakers,105
Feb 4 2015,1,Minnesota Timberwolves,1,102,8:00p,203,Miami Heat,101
Feb 4 2015,0,New Orleans Pelicans,-11,91,8:00p,193,Oklahoma City Thunder,102
Feb 4 2015,1,San Antonio Spurs,7,110,8:30p,213,Orlando Magic,103
Feb 4 2015,0,Toronto Raptors,-16,93,7:30p,202,Brooklyn Nets,109
Feb 4 2015,0,Utah Jazz,-10,90,9:00p,190,Memphis Grizzlies,100
Feb 5 2015,1,Charlotte Hornets,7,94,7:00p,181,Washington Wizards,87
Feb 5 2015,1,Cleveland Cavaliers,11,105,8:00p,199,Los Angeles Clippers,94
Feb 5 2015,1,Portland Trail Blazers,21,108,10:30p,195,Phoenix Suns,87
Feb 5 2015,0,Sacramento Kings,-23,78,10:00p,179,Dallas Mavericks,101
Feb 6 2015,1,Atlanta Hawks,8,124,7:30p,240,Golden State Warriors,116
Feb 6 2015,1,Boston Celtics,11,107,7:30p,203,Philadelphia 76ers,96
Feb 6 2015,1,Brooklyn Nets,4,92,7:00p,180,New York Knicks,88
Feb 6 2015,1,Detroit Pistons,10,98,7:30p,186,Denver Nuggets,88
Feb 6 2015,1,Houston Rockets,6,117,8:00p,228,Milwaukee Bucks,111
Feb 6 2015,1,Indiana Pacers,4,103,7:00p,202,Cleveland Cavaliers,99
Feb 6 2015,1,Minnesota Timberwolves,1,90,8:00p,179,Memphis Grizzlies,89
Feb 6 2015,0,Oklahoma City Thunder,-3,113,8:00p,229,New Orleans Pelicans,116
Feb 6 2015,1,Orlando Magic,6,103,7:00p,200,Los Angeles Lakers,97
Feb 6 2015,1,Phoenix Suns,7,100,9:00p,193,Utah Jazz,93
Feb 6 2015,1,San Antonio Spurs,13,98,9:30p,183,Miami Heat,85
Feb 6 2015,1,Toronto Raptors,16,123,7:00p,230,Los Angeles Clippers,107
Feb 7 2015,1,Dallas Mavericks,10,111,8:30p,212,Portland Trail Blazers,101
Feb 7 2015,1,Milwaukee Bucks,3,96,8:30p,189,Boston Celtics,93
Feb 7 2015,0,New Orleans Pelicans,-35,72,7:00p,179,Chicago Bulls,107
Feb 7 2015,0,New York Knicks,-14,92,7:30p,198,Golden State Warriors,106
Feb 7 2015,1,Philadelphia 76ers,8,89,7:30p,170,Charlotte Hornets,81
Feb 7 2015,1,Utah Jazz,12,102,9:00p,192,Sacramento Kings,90
Feb 7 2015,1,Washington Wizards,37,114,7:00p,191,Brooklyn Nets,77
Feb 8 2015,0,Charlotte Hornets,-1,102,6:00p,205,Indiana Pacers,103
Feb 8 2015,1,Cleveland Cavaliers,15,120,3:30p,225,Los Angeles Lakers,105
Feb 8 2015,0,Detroit Pistons,-11,101,6:00p,213,Minnesota Timberwolves,112
Feb 8 2015,0,Houston Rockets,-11,98,7:00p,207,Portland Trail Blazers,109
Feb 8 2015,1,Memphis Grizzlies,6,94,6:00p,182,Atlanta Hawks,88
Feb 8 2015,1,Oklahoma City Thunder,23,131,1:00p,239,Los Angeles Clippers,108
Feb 8 2015,0,Orlando Magic,-1,97,6:00p,195,Chicago Bulls,98
Feb 8 2015,1,Sacramento Kings,2,85,9:00p,168,Phoenix Suns,83
Feb 8 2015,1,Toronto Raptors,5,87,7:00p,169,San Antonio Spurs,82
Feb 9 2015,0,Dallas Mavericks,-17,98,8:30p,213,Los Angeles Clippers,115
Feb 9 2015,0,Denver Nuggets,-10,114,9:00p,238,Oklahoma City Thunder,124
Feb 9 2015,0,Indiana Pacers,-2,93,7:00p,188,San Antonio Spurs,95
Feb 9 2015,1,Miami Heat,14,109,7:30p,204,New York Knicks,95
Feb 9 2015,1,Milwaukee Bucks,6,103,8:00p,200,Brooklyn Nets,97
Feb 9 2015,0,Minnesota Timberwolves,-12,105,8:00p,222,Atlanta Hawks,117
Feb 9 2015,0,New Orleans Pelicans,-4,96,8:00p,196,Utah Jazz,100
Feb 9 2015,0,Philadelphia 76ers,-5,84,7:00p,173,Golden State Warriors,89
Feb 9 2015,1,Washington Wizards,16,96,7:00p,176,Orlando Magic,80
Feb 10 2015,1,Chicago Bulls,18,104,8:00p,190,Sacramento Kings,86
Feb 10 2015,0,Charlotte Hornets,-28,78,7:00p,184,Detroit Pistons,106
Feb 10 2015,0,Los Angeles Lakers,-10,96,10:30p,202,Denver Nuggets,106
Feb 10 2015,1,Memphis Grizzlies,9,95,8:00p,181,Brooklyn Nets,86
Feb 10 2015,0,Phoenix Suns,-9,118,8:00p,245,Houston Rockets,127
Feb 11 2015,1,Boston Celtics,1,89,7:30p,177,Atlanta Hawks,88
Feb 11 2015,1,Cleveland Cavaliers,20,113,8:00p,206,Miami Heat,93
Feb 11 2015,1,Dallas Mavericks,5,87,8:30p,169,Utah Jazz,82
Feb 11 2015,0,Detroit Pistons,-17,87,7:30p,191,San Antonio Spurs,104
Feb 11 2015,1,Los Angeles Clippers,15,110,10:30p,205,Houston Rockets,95
Feb 11 2015,1,Milwaukee Bucks,8,111,8:00p,214,Sacramento Kings,103
Feb 11 2015,0,Minnesota Timberwolves,-3,91,8:00p,185,Golden State Warriors,94
Feb 11 2015,0,New Orleans Pelicans,-13,93,8:00p,199,Indiana Pacers,106
Feb 11 2015,1,Oklahoma City Thunder,16,105,8:00p,194,Memphis Grizzlies,89
Feb 11 2015,1,Orlando Magic,6,89,7:00p,172,New York Knicks,83
Feb 11 2015,1,Portland Trail Blazers,16,102,10:00p,188,Los Angeles Lakers,86
Feb 11 2015,1,Toronto Raptors,2,95,7:30p,188,Washington Wizards,93
Feb 12 2015,1,Chicago Bulls,15,113,8:00p,211,Cleveland Cavaliers,98
Feb 19 2015,1,Los Angeles Clippers,4,119,10:30p,234,San Antonio Spurs,115
Feb 19 2015,1,Oklahoma City Thunder,15,104,8:00p,193,Dallas Mavericks,89
Feb 20 2015,0,Atlanta Hawks,-25,80,7:30p,185,Toronto Raptors,105
Feb 20 2015,1,Dallas Mavericks,11,111,8:30p,211,Houston Rockets,100
Feb 20 2015,1,Detroit Pistons,9,100,7:30p,191,Chicago Bulls,91
Feb 20 2015,1,Golden State Warriors,11,110,10:30p,209,San Antonio Spurs,99
Feb 20 2015,0,Los Angeles Lakers,-9,105,10:30p,219,Brooklyn Nets,114
Feb 20 2015,1,Milwaukee Bucks,8,89,8:30p,170,Denver Nuggets,81
Feb 20 2015,1,Minnesota Timberwolves,2,111,8:00p,220,Phoenix Suns,109
Feb 20 2015,0,New York Knicks,-24,87,7:30p,198,Miami Heat,111
Feb 20 2015,1,Orlando Magic,11,95,7:00p,179,New Orleans Pelicans,84
Feb 20 2015,0,Philadelphia 76ers,-11,95,7:00p,201,Indiana Pacers,106
Feb 20 2015,1,Sacramento Kings,8,109,10:00p,210,Boston Celtics,101
Feb 20 2015,1,Utah Jazz,16,92,9:00p,168,Portland Trail Blazers,76
Feb 20 2015,0,Washington Wizards,-38,89,8:00p,216,Cleveland Cavaliers,127
Feb 21 2015,1,Chicago Bulls,5,112,8:00p,219,Phoenix Suns,107
Feb 21 2015,0,Charlotte Hornets,-7,103,7:00p,213,Oklahoma City Thunder,110
Feb 21 2015,1,Houston Rockets,22,98,8:00p,174,Toronto Raptors,76
Feb 21 2015,1,Los Angeles Clippers,27,126,10:00p,225,Sacramento Kings,99
Feb 21 2015,0,Miami Heat,-14,91,7:30p,196,New Orleans Pelicans,105
Feb 22 2015,1,Dallas Mavericks,11,92,7:30p,173,Charlotte Hornets,81
Feb 22 2015,1,Detroit Pistons,17,106,3:30p,195,Washington Wizards,89
Feb 22 2015,1,Indiana Pacers,6,104,6:00p,202,Golden State Warriors,98
Feb 22 2015,1,Los Angeles Lakers,7,118,9:30p,229,Boston Celtics,111
Feb 22 2015,0,Milwaukee Bucks,-11,86,3:30p,183,Atlanta Hawks,97
Feb 22 2015,0,New York Knicks,-18,83,1:00p,184,Cleveland Cavaliers,101
Feb 22 2015,1,Oklahoma City Thunder,25,119,7:00p,213,Denver Nuggets,94
Feb 22 2015,1,Orlando Magic,5,103,6:00p,201,Philadelphia 76ers,98
Feb 22 2015,0,Portland Trail Blazers,-6,92,9:00p,190,Memphis Grizzlies,98
Feb 23 2015,1,Chicago Bulls,16,87,8:00p,158,Milwaukee Bucks,71
Feb 23 2015,0,Denver Nuggets,-28,82,9:00p,192,Brooklyn Nets,110
Feb 23 2015,1,Houston Rockets,11,113,8:00p,215,Minnesota Timberwolves,102
Feb 23 2015,0,Los Angeles Clippers,-3,87,10:30p,177,Memphis Grizzlies,90
Feb 23 2015,1,Miami Heat,11,119,7:30p,227,Philadelphia 76ers,108
Feb 23 2015,1,New Orleans Pelicans,3,100,8:00p,197,Toronto Raptors,97
Feb 23 2015,0,Phoenix Suns,-5,110,9:00p,225,Boston Celtics,115
Feb 23 2015,1,Utah Jazz,9,90,9:00p,171,San Antonio Spurs,81
Feb 24 2015,1,Dallas Mavericks,7,99,8:30p,191,Toronto Raptors,92
Feb 24 2015,0,Detroit Pistons,-9,93,7:30p,195,Cleveland Cavaliers,102
Feb 24 2015,1,Oklahoma City Thunder,13,105,8:00p,197,Indiana Pacers,92
Feb 24 2015,0,Washington Wizards,-7,107,7:00p,221,Golden State Warriors,114
Feb 25 2015,1,Atlanta Hawks,17,104,7:30p,191,Dallas Mavericks,87
Feb 25 2015,1,Boston Celtics,21,115,7:30p,209,New York Knicks,94
Feb 25 2015,0,Chicago Bulls,-12,86,8:00p,184,Charlotte Hornets,98
Feb 25 2015,0,Denver Nuggets,-14,96,9:00p,206,Phoenix Suns,110
Feb 25 2015,1,Houston Rockets,5,110,8:00p,215,Los Angeles Clippers,105
Feb 25 2015,1,Milwaukee Bucks,16,104,8:00p,192,Philadelphia 76ers,88
Feb 25 2015,1,Minnesota Timberwolves,20,97,8:00p,174,Washington Wizards,77
Feb 25 2015,1,New Orleans Pelicans,6,102,8:00p,198,Brooklyn Nets,96
Feb 25 2015,0,Orlando Magic,-3,90,7:00p,183,Miami Heat,93
Feb 25 2015,1,Portland Trail Blazers,16,111,10:30p,206,San Antonio Spurs,95
Feb 25 2015,1,Sacramento Kings,12,102,10:00p,192,Memphis Grizzlies,90
Feb 25 2015,0,Utah Jazz,-3,97,9:00p,197,Los Angeles Lakers,100
Feb 26 2015,1,Cleveland Cavaliers,11,110,8:00p,209,Golden State Warriors,99
Feb 26 2015,1,Phoenix Suns,4,117,10:30p,230,Oklahoma City Thunder,113
Feb 27 2015,1,Atlanta Hawks,7,95,7:30p,183,Orlando Magic,88
Feb 27 2015,1,Boston Celtics,8,106,7:30p,204,Charlotte Hornets,98
Feb 27 2015,1,Chicago Bulls,7,96,8:00p,185,Minnesota Timberwolves,89
Feb 27 2015,0,Denver Nuggets,-22,82,9:00p,186,Utah Jazz,104
Feb 27 2015,0,Detroit Pistons,-6,115,7:30p,236,New York Knicks,121
Feb 27 2015,1,Houston Rockets,4,102,8:00p,200,Brooklyn Nets,98
Feb 27 2015,1,Indiana Pacers,7,93,7:00p,179,Cleveland Cavaliers,86
Feb 27 2015,1,Los Angeles Lakers,8,101,10:30p,194,Milwaukee Bucks,93
Feb 27 2015,0,Memphis Grizzlies,-18,79,8:00p,176,Los Angeles Clippers,97
Feb 27 2015,1,New Orleans Pelicans,2,104,8:00p,206,Miami Heat,102
Feb 27 2015,1,Philadelphia 76ers,8,89,7:00p,170,Washington Wizards,81
Feb 27 2015,1,Portland Trail Blazers,3,115,10:30p,227,Oklahoma City Thunder,112
Feb 27 2015,0,Sacramento Kings,-11,96,10:00p,203,San Antonio Spurs,107
Feb 27 2015,0,Toronto Raptors,-24,89,7:30p,202,Golden State Warriors,113
Feb 28 2015,0,Dallas Mavericks,-10,94,8:30p,198,Brooklyn Nets,104
Feb 28 2015,0,Miami Heat,-2,91,7:30p,184,Atlanta Hawks,93
Feb 28 2015,0,Minnesota Timberwolves,-4,97,8:00p,198,Memphis Grizzlies,101
Feb 28 2015,1,New York Knicks,5,103,7:30p,201,Toronto Raptors,98
Feb 28 2015,0,Phoenix Suns,-27,74,9:00p,175,San Antonio Spurs,101
Feb 28 2015,1,Utah Jazz,7,82,9:00p,157,Milwaukee Bucks,75
Feb 28 2015,1,Washington Wizards,4,99,7:00p,194,Detroit Pistons,95
Mar 1 2015,0,Boston Celtics,-5,101,6:00p,207,Golden State Warriors,106
Mar 1 2015,0,Chicago Bulls,-10,86,1:00p,182,Los Angeles Clippers,96
Mar 1 2015,0,Denver Nuggets,-7,92,8:00p,191,New Orleans Pelicans,99
Mar 1 2015,1,Houston Rockets,2,105,3:30p,208,Cleveland Cavaliers,103
Mar 1 2015,1,Indiana Pacers,20,94,6:00p,168,Philadelphia 76ers,74
Mar 1 2015,0,Los Angeles Lakers,-7,101,6:30p,209,Oklahoma City Thunder,108
Mar 1 2015,0,Orlando Magic,-15,83,6:00p,181,Charlotte Hornets,98
Mar 1 2015,0,Sacramento Kings,-11,99,6:00p,209,Portland Trail Blazers,110
Mar 2 2015,1,Brooklyn Nets,2,110,7:30p,218,Golden State Warriors,108
Mar 2 2015,1,Dallas Mavericks,9,102,8:30p,195,New Orleans Pelicans,93
Mar 2 2015,1,Miami Heat,17,115,7:30p,213,Phoenix Suns,98
Mar 2 2015,0,Minnesota Timberwolves,-5,105,8:00p,215,Los Angeles Clippers,110
Mar 2 2015,0,Philadelphia 76ers,-11,103,7:00p,217,Toronto Raptors,114
Mar 3 2015,1,Atlanta Hawks,8,104,7:30p,200,Houston Rockets,96
Mar 3 2015,1,Chicago Bulls,5,97,8:00p,189,Washington Wizards,92
Mar 3 2015,1,Charlotte Hornets,1,104,7:00p,207,Los Angeles Lakers,103
Mar 3 2015,1,Cleveland Cavaliers,31,110,7:00p,189,Boston Celtics,79
Mar 3 2015,1,Denver Nuggets,11,106,9:00p,201,Milwaukee Bucks,95
Mar 3 2015,0,Memphis Grizzlies,-11,82,8:00p,175,Utah Jazz,93
Mar 3 2015,0,New York Knicks,-38,86,7:00p,210,Sacramento Kings,124
Mar 4 2015,1,Boston Celtics,1,85,7:30p,169,Utah Jazz,84
Mar 4 2015,0,Brooklyn Nets,-24,91,7:30p,206,Charlotte Hornets,115
Mar 4 2015,1,Golden State Warriors,9,102,10:30p,195,Milwaukee Bucks,93
Mar 4 2015,0,Houston Rockets,-2,100,8:00p,202,Memphis Grizzlies,102
Mar 4 2015,1,Indiana Pacers,23,105,7:00p,187,New York Knicks,82
Mar 4 2015,0,Los Angeles Clippers,-5,93,10:30p,191,Portland Trail Blazers,98
Mar 4 2015,1,Miami Heat,6,100,8:00p,194,Los Angeles Lakers,94
Mar 4 2015,0,Minnesota Timberwolves,-15,85,8:00p,185,Denver Nuggets,100
Mar 4 2015,1,New Orleans Pelicans,3,88,8:00p,173,Detroit Pistons,85
Mar 4 2015,1,Oklahoma City Thunder,5,123,8:00p,241,Philadelphia 76ers,118
Mar 4 2015,0,Orlando Magic,-5,100,7:00p,205,Phoenix Suns,105
Mar 4 2015,1,San Antonio Spurs,27,112,8:30p,197,Sacramento Kings,85
Mar 4 2015,0,Toronto Raptors,-8,112,7:30p,232,Cleveland Cavaliers,120
Mar 5 2015,1,Chicago Bulls,3,108,8:00p,213,Oklahoma City Thunder,105
Mar 5 2015,1,Portland Trail Blazers,19,94,10:30p,169,Dallas Mavericks,75
Mar 6 2015,1,Atlanta Hawks,9,106,7:30p,203,Cleveland Cavaliers,97
Mar 6 2015,0,Brooklyn Nets,-8,100,8:00p,208,Phoenix Suns,108
Mar 6 2015,1,Charlotte Hornets,9,103,7:00p,197,Toronto Raptors,94
Mar 6 2015,1,Golden State Warriors,15,104,10:30p,193,Dallas Mavericks,89
Mar 6 2015,1,Houston Rockets,10,103,8:00p,196,Detroit Pistons,93
Mar 6 2015,1,Indiana Pacers,14,98,7:00p,182,Chicago Bulls,84
Mar 6 2015,1,Memphis Grizzlies,7,97,8:00p,187,Los Angeles Lakers,90
Mar 6 2015,0,New Orleans Pelicans,-6,98,8:00p,202,Boston Celtics,104
Mar 6 2015,1,Orlando Magic,5,119,7:00p,233,Sacramento Kings,114
Mar 6 2015,0,Philadelphia 76ers,-6,83,7:00p,172,Utah Jazz,89
Mar 6 2015,1,San Antonio Spurs,9,120,8:30p,231,Denver Nuggets,111
Mar 6 2015,1,Washington Wizards,2,99,7:00p,196,Miami Heat,97
Mar 7 2015,1,Cleveland Cavaliers,10,89,7:30p,168,Phoenix Suns,79
Mar 7 2015,0,Denver Nuggets,-14,100,9:00p,214,Houston Rockets,114
Mar 7 2015,1,Miami Heat,5,114,7:30p,223,Sacramento Kings,109
Mar 7 2015,1,Milwaukee Bucks,6,91,8:30p,176,Washington Wizards,85
Mar 7 2015,1,Minnesota Timberwolves,8,121,8:00p,234,Portland Trail Blazers,113
Mar 7 2015,1,New Orleans Pelicans,6,95,7:00p,184,Memphis Grizzlies,89
Mar 7 2015,0,New York Knicks,-6,86,7:30p,178,Indiana Pacers,92
Mar 7 2015,1,Philadelphia 76ers,8,92,7:30p,176,Atlanta Hawks,84
Mar 8 2015,0,Brooklyn Nets,-7,88,6:00p,183,Utah Jazz,95
Mar 8 2015,0,Detroit Pistons,-7,101,6:00p,209,Charlotte Hornets,108
Mar 8 2015,1,Golden State Warriors,8,106,3:30p,204,Los Angeles Clippers,98
Mar 8 2015,0,Los Angeles Lakers,-7,93,9:30p,193,Dallas Mavericks,100
Mar 8 2015,1,Oklahoma City Thunder,4,108,7:00p,212,Toronto Raptors,104
Mar 8 2015,1,Orlando Magic,5,103,6:00p,201,Boston Celtics,98
Mar 8 2015,1,San Antonio Spurs,11,116,1:00p,221,Chicago Bulls,105
Mar 9 2015,1,Atlanta Hawks,25,130,7:30p,235,Sacramento Kings,105
Mar 9 2015,0,Chicago Bulls,-10,91,8:00p,192,Memphis Grizzlies,101
Mar 9 2015,0,Charlotte Hornets,-26,69,7:00p,164,Washington Wizards,95
Mar 9 2015,1,Denver Nuggets,28,106,9:00p,184,New York Knicks,78
Mar 9 2015,1,Los Angeles Clippers,13,89,10:30p,165,Minnesota Timberwolves,76
Mar 9 2015,0,Miami Heat,-10,90,7:30p,190,Boston Celtics,100
Mar 9 2015,0,Milwaukee Bucks,-11,103,8:00p,217,New Orleans Pelicans,114
Mar 9 2015,0,Phoenix Suns,-18,80,10:00p,178,Golden State Warriors,98
Mar 10 2015,0,Brooklyn Nets,-20,91,7:30p,202,New Orleans Pelicans,111
Mar 10 2015,0,Dallas Mavericks,-33,94,8:30p,221,Cleveland Cavaliers,127
Mar 10 2015,1,Indiana Pacers,32,118,7:00p,204,Orlando Magic,86
Mar 10 2015,1,Los Angeles Lakers,8,93,10:30p,178,Detroit Pistons,85
Mar 10 2015,1,San Antonio Spurs,10,117,8:30p,224,Toronto Raptors,107
Mar 10 2015,1,Utah Jazz,5,87,9:00p,169,New York Knicks,82
Mar 11 2015,1,Boston Celtics,3,95,7:30p,187,Memphis Grizzlies,92
Mar 11 2015,0,Charlotte Hornets,-7,106,7:00p,219,Sacramento Kings,113
Mar 11 2015,1,Denver Nuggets,13,115,9:00p,217,Atlanta Hawks,102
Mar 11 2015,1,Golden State Warriors,7,105,10:30p,203,Detroit Pistons,98
Mar 11 2015,1,Miami Heat,6,104,7:30p,202,Brooklyn Nets,98
Mar 11 2015,1,Milwaukee Bucks,6,97,8:00p,188,Orlando Magic,91
Mar 11 2015,0,Oklahoma City Thunder,-12,108,8:00p,228,Los Angeles Clippers,120
Mar 11 2015,0,Philadelphia 76ers,-9,95,7:00p,199,Chicago Bulls,104
Mar 11 2015,1,Phoenix Suns,9,106,10:00p,203,Minnesota Timberwolves,97
Mar 11 2015,1,Portland Trail Blazers,5,105,10:30p,205,Houston Rockets,100
Mar 12 2015,1,Indiana Pacers,6,109,7:00p,212,Milwaukee Bucks,103
Mar 12 2015,0,Los Angeles Lakers,-7,94,10:30p,195,New York Knicks,101
Mar 12 2015,0,San Antonio Spurs,-3,125,9:30p,253,Cleveland Cavaliers,128
Mar 12 2015,1,Utah Jazz,18,109,9:00p,200,Houston Rockets,91
Mar 12 2015,1,Washington Wizards,20,107,7:00p,194,Memphis Grizzlies,87
Mar 13 2015,1,Boston Celtics,7,95,7:30p,183,Orlando Magic,88
Mar 13 2015,1,Charlotte Hornets,10,101,7:00p,192,Chicago Bulls,91
Mar 13 2015,1,Dallas Mavericks,30,129,8:30p,228,Los Angeles Clippers,99
Mar 13 2015,1,Denver Nuggets,11,114,9:00p,217,Golden State Warriors,103
Mar 13 2015,1,Oklahoma City Thunder,14,113,8:00p,212,Minnesota Timberwolves,99
Mar 13 2015,1,Philadelphia 76ers,7,114,7:00p,221,Sacramento Kings,107
Mar 13 2015,0,Phoenix Suns,-9,87,10:00p,183,Atlanta Hawks,96
Mar 13 2015,1,Portland Trail Blazers,19,118,10:00p,217,Detroit Pistons,99
Mar 13 2015,1,Toronto Raptors,10,102,7:30p,194,Miami Heat,92
Mar 14 2015,1,Golden State Warriors,31,125,10:30p,219,New York Knicks,94
Mar 14 2015,0,Indiana Pacers,-4,89,7:00p,182,Boston Celtics,93
Mar 14 2015,1,Memphis Grizzlies,13,96,8:00p,179,Milwaukee Bucks,83
Mar 14 2015,0,Philadelphia 76ers,-7,87,7:30p,181,Brooklyn Nets,94
Mar 14 2015,1,Utah Jazz,3,88,9:00p,173,Detroit Pistons,85
Mar 14 2015,1,Washington Wizards,16,113,7:00p,210,Sacramento Kings,97
Mar 15 2015,0,Los Angeles Clippers,-2,98,3:30p,198,Houston Rockets,100
Mar 15 2015,0,Los Angeles Lakers,-5,86,9:30p,177,Atlanta Hawks,91
Mar 15 2015,0,New Orleans Pelicans,-7,111,6:00p,229,Denver Nuggets,118
Mar 15 2015,1,Oklahoma City Thunder,9,109,1:00p,209,Chicago Bulls,100
Mar 15 2015,0,Orlando Magic,-15,108,6:00p,231,Cleveland Cavaliers,123
Mar 15 2015,1,Phoenix Suns,13,102,9:00p,191,New York Knicks,89
Mar 15 2015,1,San Antonio Spurs,26,123,7:00p,220,Minnesota Timberwolves,97
Mar 15 2015,0,Toronto Raptors,-16,97,7:00p,210,Portland Trail Blazers,113
Mar 16 2015,1,Boston Celtics,19,108,7:30p,197,Philadelphia 76ers,89
Mar 16 2015,1,Dallas Mavericks,4,119,8:30p,234,Oklahoma City Thunder,115
Mar 16 2015,1,Golden State Warriors,3,108,10:30p,213,Los Angeles Lakers,105
Mar 16 2015,0,Indiana Pacers,-19,98,7:00p,215,Toronto Raptors,117
Mar 16 2015,1,Memphis Grizzlies,11,92,8:00p,173,Denver Nuggets,81
Mar 16 2015,1,Miami Heat,14,106,8:00p,198,Cleveland Cavaliers,92
Mar 16 2015,0,Minnesota Timberwolves,-16,106,8:00p,228,Brooklyn Nets,122
Mar 16 2015,0,Sacramento Kings,-7,103,10:00p,213,Atlanta Hawks,110
Mar 16 2015,1,Utah Jazz,28,94,9:00p,160,Charlotte Hornets,66
Mar 16 2015,1,Washington Wizards,8,105,7:00p,202,Portland Trail Blazers,97
Mar 17 2015,1,Detroit Pistons,10,105,7:30p,200,Memphis Grizzlies,95
Mar 17 2015,1,Houston Rockets,13,107,8:00p,201,Orlando Magic,94
Mar 17 2015,1,Los Angeles Clippers,7,99,10:30p,191,Charlotte Hornets,92
Mar 17 2015,1,New Orleans Pelicans,1,85,8:00p,169,Milwaukee Bucks,84
Mar 17 2015,1,New York Knicks,4,104,7:30p,204,San Antonio Spurs,100
Mar 18 2015,1,Chicago Bulls,17,103,8:00p,189,Indiana Pacers,86
Mar 18 2015,1,Cleveland Cavaliers,25,117,7:00p,209,Brooklyn Nets,92
Mar 18 2015,1,Dallas Mavericks,5,107,8:00p,209,Orlando Magic,102
Mar 18 2015,1,Golden State Warriors,19,114,10:30p,209,Atlanta Hawks,95
Mar 18 2015,1,Miami Heat,4,108,7:30p,212,Portland Trail Blazers,104
Mar 18 2015,0,Milwaukee Bucks,-11,103,8:00p,217,San Antonio Spurs,114
Mar 18 2015,1,Oklahoma City Thunder,4,122,8:00p,240,Boston Celtics,118
Mar 18 2015,1,Philadelphia 76ers,11,94,7:00p,177,Detroit Pistons,83
Mar 18 2015,0,Sacramento Kings,-11,105,10:00p,221,Los Angeles Clippers,116
Mar 18 2015,1,Toronto Raptors,5,105,7:30p,205,Minnesota Timberwolves,100
Mar 18 2015,0,Utah Jazz,-4,84,10:30p,172,Washington Wizards,88
Mar 19 2015,1,Houston Rockets,10,118,8:00p,226,Denver Nuggets,108
Mar 19 2015,0,Los Angeles Lakers,-7,73,10:30p,153,Utah Jazz,80
Mar 19 2015,0,New York Knicks,-3,92,7:30p,187,Minnesota Timberwolves,95
Mar 19 2015,1,Phoenix Suns,2,74,10:00p,146,New Orleans Pelicans,72
Mar 20 2015,1,Brooklyn Nets,2,129,7:30p,256,Milwaukee Bucks,127
Mar 20 2015,1,Chicago Bulls,16,108,8:00p,200,Toronto Raptors,92
Mar 20 2015,1,Cleveland Cavaliers,3,95,7:30p,187,Indiana Pacers,92
Mar 20 2015,0,Dallas Mavericks,-11,101,8:30p,213,Memphis Grizzlies,112
Mar 20 2015,1,Golden State Warriors,16,112,10:30p,208,New Orleans Pelicans,96
Mar 20 2015,1,Los Angeles Clippers,14,113,10:30p,212,Washington Wizards,99
Mar 20 2015,1,Miami Heat,17,108,7:30p,199,Denver Nuggets,91
Mar 20 2015,1,Oklahoma City Thunder,8,123,8:00p,238,Atlanta Hawks,115
Mar 20 2015,1,Orlando Magic,7,111,7:00p,215,Portland Trail Blazers,104
Mar 20 2015,1,Philadelphia 76ers,16,97,7:00p,178,New York Knicks,81
Mar 20 2015,1,Sacramento Kings,10,101,10:00p,192,Charlotte Hornets,91
Mar 20 2015,1,San Antonio Spurs,12,101,8:30p,190,Boston Celtics,89
Mar 21 2015,1,Detroit Pistons,16,107,7:30p,198,Chicago Bulls,91
Mar 21 2015,1,Golden State Warriors,15,106,10:30p,197,Utah Jazz,91
Mar 21 2015,0,Houston Rockets,-15,102,8:00p,219,Phoenix Suns,117
Mar 21 2015,0,Indiana Pacers,-12,111,7:00p,234,Brooklyn Nets,123
Mar 21 2015,1,Memphis Grizzlies,11,97,8:00p,183,Portland Trail Blazers,86
Mar 22 2015,0,Atlanta Hawks,-19,95,3:00p,209,San Antonio Spurs,114
Mar 22 2015,0,Boston Celtics,-8,97,6:00p,202,Detroit Pistons,105
Mar 22 2015,1,Los Angeles Clippers,7,107,3:30p,207,New Orleans Pelicans,100
Mar 22 2015,1,Los Angeles Lakers,14,101,9:30p,188,Philadelphia 76ers,87
Mar 22 2015,0,Milwaukee Bucks,-18,90,3:00p,198,Cleveland Cavaliers,108
Mar 22 2015,0,Minnesota Timberwolves,-11,98,7:00p,207,Charlotte Hornets,109
Mar 22 2015,1,Oklahoma City Thunder,18,93,3:00p,168,Miami Heat,75
Mar 22 2015,0,Orlando Magic,-19,100,6:00p,219,Denver Nuggets,119
Mar 22 2015,1,Phoenix Suns,6,98,9:00p,190,Dallas Mavericks,92
Mar 22 2015,1,Sacramento Kings,23,109,6:00p,195,Washington Wizards,86
Mar 22 2015,1,Toronto Raptors,17,106,4:00p,195,New York Knicks,89
Mar 23 2015,0,Brooklyn Nets,-19,91,7:30p,201,Boston Celtics,110
Mar 23 2015,1,Chicago Bulls,12,98,8:00p,184,Charlotte Hornets,86
Mar 23 2015,1,Golden State Warriors,31,107,10:30p,183,Washington Wizards,76
Mar 23 2015,0,Indiana Pacers,-10,100,7:00p,210,Houston Rockets,110
Mar 23 2015,0,New York Knicks,-21,82,7:30p,185,Memphis Grizzlies,103
Mar 23 2015,0,Utah Jazz,-2,104,9:00p,210,Minnesota Timberwolves,106
Mar 24 2015,1,Dallas Mavericks,7,101,8:00p,195,San Antonio Spurs,94
Mar 24 2015,1,Detroit Pistons,4,108,7:30p,212,Toronto Raptors,104
Mar 24 2015,1,Milwaukee Bucks,1,89,8:00p,177,Miami Heat,88
Mar 24 2015,1,Oklahoma City Thunder,10,127,8:00p,244,Los Angeles Lakers,117
Mar 24 2015,0,Portland Trail Blazers,-14,108,10:30p,230,Golden State Warriors,122
Mar 24 2015,1,Sacramento Kings,1,107,10:00p,213,Philadelphia 76ers,106
Mar 25 2015,0,Boston Celtics,-7,86,7:30p,179,Miami Heat,93
Mar 25 2015,0,Charlotte Hornets,-3,88,7:00p,179,Brooklyn Nets,91
Mar 25 2015,0,Denver Nuggets,-14,85,9:00p,184,Philadelphia 76ers,99
Mar 25 2015,0,Memphis Grizzlies,-22,89,8:00p,200,Cleveland Cavaliers,111
Mar 25 2015,0,Minnesota Timberwolves,-2,99,8:00p,200,Los Angeles Lakers,101
Mar 25 2015,0,New Orleans Pelicans,-2,93,8:00p,188,Houston Rockets,95
Mar 25 2015,0,New York Knicks,-31,80,7:00p,191,Los Angeles Clippers,111
Mar 25 2015,0,Orlando Magic,-12,83,7:00p,178,Atlanta Hawks,95
Mar 25 2015,0,Phoenix Suns,-9,99,10:00p,207,Sacramento Kings,108
Mar 25 2015,1,San Antonio Spurs,39,130,9:30p,221,Oklahoma City Thunder,91
Mar 25 2015,0,Toronto Raptors,-13,103,7:00p,219,Chicago Bulls,116
Mar 25 2015,0,Utah Jazz,-3,89,9:00p,181,Portland Trail Blazers,92
Mar 25 2015,0,Washington Wizards,-2,101,7:00p,204,Indiana Pacers,103
Mar 26 2015,1,Milwaukee Bucks,4,111,8:00p,218,Indiana Pacers,107
Mar 27 2015,1,Atlanta Hawks,13,99,7:30p,185,Miami Heat,86
Mar 27 2015,1,Brooklyn Nets,8,106,7:30p,204,Cleveland Cavaliers,98
Mar 27 2015,1,Denver Nuggets,16,107,9:00p,198,Utah Jazz,91
Mar 27 2015,1,Houston Rockets,10,120,8:00p,230,Minnesota Timberwolves,110
Mar 27 2015,0,Memphis Grizzlies,-23,84,8:00p,191,Golden State Warriors,107
Mar 27 2015,1,New Orleans Pelicans,14,102,8:00p,190,Sacramento Kings,88
Mar 27 2015,0,New York Knicks,-4,92,7:30p,188,Boston Celtics,96
Mar 27 2015,0,Orlando Magic,-14,97,7:00p,208,Detroit Pistons,111
Mar 27 2015,0,Philadelphia 76ers,-21,98,7:00p,217,Los Angeles Clippers,119
Mar 27 2015,0,Phoenix Suns,-6,81,10:00p,168,Portland Trail Blazers,87
Mar 27 2015,1,San Antonio Spurs,18,94,8:30p,170,Dallas Mavericks,76
Mar 27 2015,1,Toronto Raptors,11,94,7:30p,177,Los Angeles Lakers,83
Mar 27 2015,1,Washington Wizards,3,110,7:00p,217,Charlotte Hornets,107
Mar 28 2015,1,Chicago Bulls,31,111,8:00p,191,New York Knicks,80
Mar 28 2015,1,Charlotte Hornets,15,115,7:00p,215,Atlanta Hawks,100
Mar 28 2015,0,Milwaukee Bucks,-13,95,8:30p,203,Golden State Warriors,108
Mar 28 2015,1,Portland Trail Blazers,6,120,10:00p,234,Denver Nuggets,114
Mar 28 2015,1,Utah Jazz,5,94,9:00p,183,Oklahoma City Thunder,89
Mar 29 2015,0,Boston Celtics,-13,106,6:00p,225,Los Angeles Clippers,119
Mar 29 2015,1,Brooklyn Nets,8,107,3:30p,206,Los Angeles Lakers,99
Mar 29 2015,1,Cleveland Cavaliers,1,87,4:30p,173,Philadelphia 76ers,86
Mar 29 2015,1,Indiana Pacers,5,104,7:00p,203,Dallas Mavericks,99
Mar 29 2015,1,Miami Heat,7,109,6:00p,211,Detroit Pistons,102
Mar 29 2015,1,New Orleans Pelicans,22,110,4:00p,198,Minnesota Timberwolves,88
Mar 29 2015,0,Phoenix Suns,-12,97,9:00p,206,Oklahoma City Thunder,109
Mar 29 2015,1,San Antonio Spurs,14,103,7:00p,192,Memphis Grizzlies,89
Mar 29 2015,0,Washington Wizards,-8,91,12:30p,190,Houston Rockets,99
Mar 30 2015,1,Atlanta Hawks,13,101,7:30p,189,Milwaukee Bucks,88
Mar 30 2015,0,Charlotte Hornets,-12,104,7:00p,220,Boston Celtics,116
Mar 30 2015,1,Memphis Grizzlies,14,97,8:00p,180,Sacramento Kings,83
Mar 30 2015,0,Minnesota Timberwolves,-20,84,8:00p,188,Utah Jazz,104
Mar 30 2015,0,Philadelphia 76ers,-2,111,7:00p,224,Los Angeles Lakers,113
Mar 30 2015,1,Portland Trail Blazers,23,109,10:00p,195,Phoenix Suns,86
Mar 30 2015,1,Toronto Raptors,3,99,7:30p,195,Houston Rockets,96
Mar 31 2015,1,Brooklyn Nets,5,111,7:30p,217,Indiana Pacers,106
Mar 31 2015,1,Detroit Pistons,10,105,7:30p,200,Atlanta Hawks,95
Mar 31 2015,0,Los Angeles Clippers,-4,106,10:30p,216,Golden State Warriors,110
Mar 31 2015,0,Miami Heat,-14,81,8:00p,176,San Antonio Spurs,95