Away,HW,Home,Total_Runs,awayRuns,date,homeRuns
Pittsburgh Pirates,1,Cincinnati Reds,8,3,March 28 2019,5
Chicago White Sox,1,Kansas City Royals,8,3,March 28 2019,5
Arizona D'Backs,1,Los Angeles Dodgers,17,5,March 28 2019,12
Colorado Rockies,0,Miami Marlins,9,6,March 28 2019,3
St. Louis Cardinals,1,Milwaukee Brewers,9,4,March 28 2019,5
Cleveland Indians,1,Minnesota Twins,2,0,March 28 2019,2
Baltimore Orioles,1,New York Yankees,9,2,March 28 2019,7
Los Angeles Angels,1,Oakland Athletics,4,0,March 28 2019,4
Atlanta Braves,1,Philadelphia Phillies,14,4,March 28 2019,10
San Francisco Giants,1,San Diego Padres,2,0,March 28 2019,2
Boston Red Sox,1,Seattle Mariners,16,4,March 28 2019,12
Houston Astros,0,Tampa Bay Rays,6,5,March 28 2019,1
Chicago Cubs,0,Texas Rangers,16,12,March 28 2019,4
Detroit Tigers,0,Toronto Blue Jays,2,2,March 28 2019,0
New York Mets,0,Washington Nationals,2,2,March 28 2019,0
Arizona D'Backs,0,Los Angeles Dodgers,9,5,March 29 2019,4
Colorado Rockies,0,Miami Marlins,7,6,March 29 2019,1
St. Louis Cardinals,0,Milwaukee Brewers,14,9,March 29 2019,5
Los Angeles Angels,0,Oakland Athletics,8,6,March 29 2019,2
San Francisco Giants,1,San Diego Padres,5,1,March 29 2019,4
Boston Red Sox,0,Seattle Mariners,13,7,March 29 2019,6
Houston Astros,1,Tampa Bay Rays,6,2,March 29 2019,4
Detroit Tigers,1,Toronto Blue Jays,6,0,March 29 2019,6
Chicago White Sox,1,Kansas City Royals,14,6,March 30 2019,8
Arizona D'Backs,1,Los Angeles Dodgers,23,5,March 30 2019,18
Colorado Rockies,1,Miami Marlins,10,3,March 30 2019,7
St. Louis Cardinals,1,Milwaukee Brewers,6,2,March 30 2019,4
Cleveland Indians,0,Minnesota Twins,3,2,March 30 2019,1
Baltimore Orioles,0,New York Yankees,8,5,March 30 2019,3
Los Angeles Angels,1,Oakland Athletics,6,2,March 30 2019,4
Atlanta Braves,1,Philadelphia Phillies,14,6,March 30 2019,8
San Francisco Giants,0,San Diego Padres,5,3,March 30 2019,2
Boston Red Sox,1,Seattle Mariners,11,5,March 30 2019,6
Houston Astros,1,Tampa Bay Rays,4,1,March 30 2019,3
Chicago Cubs,1,Texas Rangers,14,6,March 30 2019,8
Detroit Tigers,1,Toronto Blue Jays,3,0,March 30 2019,3
New York Mets,0,Washington Nationals,19,11,March 30 2019,8
Pittsburgh Pirates,0,Cincinnati Reds,5,5,March 31 2019,0
Chicago White Sox,0,Kansas City Royals,9,6,March 31 2019,3
Arizona D'Backs,1,Los Angeles Dodgers,15,7,March 31 2019,8
Colorado Rockies,1,Miami Marlins,3,0,March 31 2019,3
St. Louis Cardinals,1,Milwaukee Brewers,9,4,March 31 2019,5
Cleveland Indians,1,Minnesota Twins,12,3,March 31 2019,9
Baltimore Orioles,0,New York Yankees,12,7,March 31 2019,5
Los Angeles Angels,1,Oakland Athletics,3,1,March 31 2019,2
Atlanta Braves,1,Philadelphia Phillies,6,1,March 31 2019,5
San Francisco Giants,1,San Diego Padres,4,1,March 31 2019,3
Boston Red Sox,1,Seattle Mariners,18,8,March 31 2019,10
Houston Astros,1,Tampa Bay Rays,4,1,March 31 2019,3
Chicago Cubs,1,Texas Rangers,21,10,March 31 2019,11
Detroit Tigers,0,Toronto Blue Jays,7,4,March 31 2019,3
New York Mets,1,Washington Nationals,11,5,March 31 2019,6
Chicago Cubs,1,Atlanta Braves,8,0,April 1 2019,8
Milwaukee Brewers,0,Cincinnati Reds,7,4,April 1 2019,3
Chicago White Sox,1,Cleveland Indians,8,3,April 1 2019,5
San Francisco Giants,0,Los Angeles Dodgers,6,4,April 1 2019,2
New York Mets,0,Miami Marlins,10,7,April 1 2019,3
Detroit Tigers,1,New York Yankees,4,1,April 1 2019,3
Boston Red Sox,1,Oakland Athletics,7,0,April 1 2019,7
St. Louis Cardinals,0,Pittsburgh Pirates,11,6,April 1 2019,5
Arizona D'Backs,0,San Diego Padres,13,10,April 1 2019,3
Los Angeles Angels,1,Seattle Mariners,9,3,April 1 2019,6
Colorado Rockies,1,Tampa Bay Rays,8,1,April 1 2019,7
Houston Astros,0,Texas Rangers,3,2,April 1 2019,1
Baltimore Orioles,0,Toronto Blue Jays,11,6,April 1 2019,5
Milwaukee Brewers,0,Cincinnati Reds,7,4,April 2 2019,3
Minnesota Twins,0,Kansas City Royals,9,5,April 2 2019,4
San Francisco Giants,1,Los Angeles Dodgers,11,5,April 2 2019,6
New York Mets,0,Miami Marlins,11,6,April 2 2019,5
Detroit Tigers,0,New York Yankees,4,3,April 2 2019,1
Boston Red Sox,1,Oakland Athletics,1,0,April 2 2019,1
Arizona D'Backs,0,San Diego Padres,13,8,April 2 2019,5
Los Angeles Angels,1,Seattle Mariners,3,1,April 2 2019,2
Colorado Rockies,1,Tampa Bay Rays,4,0,April 2 2019,4
Houston Astros,1,Texas Rangers,10,4,April 2 2019,6
Baltimore Orioles,0,Toronto Blue Jays,3,2,April 2 2019,1
Philadelphia Phillies,0,Washington Nationals,10,8,April 2 2019,2
Chicago Cubs,1,Atlanta Braves,10,4,April 3 2019,6
Milwaukee Brewers,0,Cincinnati Reds,1,1,April 3 2019,0
Chicago White Sox,0,Cleveland Indians,11,8,April 3 2019,3
Minnesota Twins,0,Kansas City Royals,13,7,April 3 2019,6
San Francisco Giants,1,Los Angeles Dodgers,8,3,April 3 2019,5
New York Mets,0,Miami Marlins,10,6,April 3 2019,4
Detroit Tigers,0,New York Yankees,3,2,April 3 2019,1
Boston Red Sox,0,Oakland Athletics,9,6,April 3 2019,3
St. Louis Cardinals,0,Pittsburgh Pirates,9,5,April 3 2019,4
Arizona D'Backs,1,San Diego Padres,5,1,April 3 2019,4
Colorado Rockies,0,Tampa Bay Rays,1,1,April 3 2019,0
Houston Astros,1,Texas Rangers,4,0,April 3 2019,4
Baltimore Orioles,1,Toronto Blue Jays,8,3,April 3 2019,5
Philadelphia Phillies,1,Washington Nationals,17,8,April 3 2019,9
Texas Rangers,0,Los Angeles Angels,15,11,April 4 2019,4
Chicago Cubs,1,Atlanta Braves,13,4,April 4 2019,9
New York Yankees,0,Baltimore Orioles,12,8,April 4 2019,4
Toronto Blue Jays,1,Cleveland Indians,5,1,April 4 2019,4
Kansas City Royals,1,Detroit Tigers,9,4,April 4 2019,5
Washington Nationals,0,New York Mets,4,4,April 4 2019,0
Boston Red Sox,1,Oakland Athletics,10,3,April 4 2019,7
Cincinnati Reds,1,Pittsburgh Pirates,2,0,April 4 2019,2
Texas Rangers,1,Los Angeles Angels,4,1,April 5 2019,3
Boston Red Sox,1,Arizona D'Backs,23,8,April 5 2019,15
Miami Marlins,1,Atlanta Braves,4,0,April 5 2019,4
Seattle Mariners,1,Chicago White Sox,18,8,April 5 2019,10
Toronto Blue Jays,1,Cleveland Indians,5,2,April 5 2019,3
Los Angeles Dodgers,0,Colorado Rockies,16,10,April 5 2019,6
Oakland Athletics,1,Houston Astros,5,2,April 5 2019,3
Chicago Cubs,1,Milwaukee Brewers,23,10,April 5 2019,13
Minnesota Twins,1,Philadelphia Phillies,14,4,April 5 2019,10
Cincinnati Reds,1,Pittsburgh Pirates,2,0,April 5 2019,2
Tampa Bay Rays,0,San Francisco Giants,7,5,April 5 2019,2
San Diego Padres,0,St. Louis Cardinals,8,5,April 5 2019,3
Texas Rangers,1,Los Angeles Angels,6,1,April 6 2019,5
Boston Red Sox,1,Arizona D'Backs,9,4,April 6 2019,5
Miami Marlins,0,Atlanta Braves,6,4,April 6 2019,2
New York Yankees,0,Baltimore Orioles,10,6,April 6 2019,4
Seattle Mariners,0,Chicago White Sox,11,9,April 6 2019,2
Toronto Blue Jays,1,Cleveland Indians,9,2,April 6 2019,7
Los Angeles Dodgers,0,Colorado Rockies,9,7,April 6 2019,2
Kansas City Royals,1,Detroit Tigers,11,4,April 6 2019,7
Oakland Athletics,1,Houston Astros,6,0,April 6 2019,6
Chicago Cubs,0,Milwaukee Brewers,22,14,April 6 2019,8
Washington Nationals,1,New York Mets,11,5,April 6 2019,6
Minnesota Twins,0,Philadelphia Phillies,8,6,April 6 2019,2
Cincinnati Reds,1,Pittsburgh Pirates,11,5,April 6 2019,6
Tampa Bay Rays,1,San Francisco Giants,10,4,April 6 2019,6
San Diego Padres,0,St. Louis Cardinals,10,6,April 6 2019,4
Texas Rangers,1,Los Angeles Angels,9,2,April 7 2019,7
Boston Red Sox,0,Arizona D'Backs,1,1,April 7 2019,0
Miami Marlins,1,Atlanta Braves,7,3,April 7 2019,4
New York Yankees,0,Baltimore Orioles,18,15,April 7 2019,3
Seattle Mariners,0,Chicago White Sox,17,12,April 7 2019,5
Toronto Blue Jays,1,Cleveland Indians,4,1,April 7 2019,3
Los Angeles Dodgers,0,Colorado Rockies,18,12,April 7 2019,6
Kansas City Royals,1,Detroit Tigers,4,1,April 7 2019,3
Oakland Athletics,1,Houston Astros,17,8,April 7 2019,9
Chicago Cubs,1,Milwaukee Brewers,6,2,April 7 2019,4
Washington Nationals,0,New York Mets,21,12,April 7 2019,9
Minnesota Twins,1,Philadelphia Phillies,3,1,April 7 2019,2
Cincinnati Reds,1,Pittsburgh Pirates,12,5,April 7 2019,7
Tampa Bay Rays,0,San Francisco Giants,3,3,April 7 2019,0
San Diego Padres,1,St. Louis Cardinals,5,1,April 7 2019,4
Milwaukee Brewers,1,Los Angeles Angels,7,2,April 8 2019,5
Oakland Athletics,1,Baltimore Orioles,16,4,April 8 2019,12
Tampa Bay Rays,0,Chicago White Sox,6,5,April 8 2019,1
Pittsburgh Pirates,1,Chicago Cubs,10,0,April 8 2019,10
Atlanta Braves,0,Colorado Rockies,14,8,April 8 2019,6
New York Yankees,1,Houston Astros,7,3,April 8 2019,4
Seattle Mariners,0,Kansas City Royals,18,13,April 8 2019,5
Washington Nationals,1,Philadelphia Phillies,7,3,April 8 2019,4
San Diego Padres,0,San Francisco Giants,11,6,April 8 2019,5
Los Angeles Dodgers,1,St. Louis Cardinals,7,3,April 8 2019,4
Milwaukee Brewers,1,Los Angeles Angels,19,8,April 9 2019,11
Texas Rangers,1,Arizona D'Backs,9,4,April 9 2019,5
Oakland Athletics,0,Baltimore Orioles,15,13,April 9 2019,2
Toronto Blue Jays,0,Boston Red Sox,12,7,April 9 2019,5
Tampa Bay Rays,0,Chicago White Sox,15,10,April 9 2019,5
Miami Marlins,1,Cincinnati Reds,14,0,April 9 2019,14
Atlanta Braves,0,Colorado Rockies,8,7,April 9 2019,1
Cleveland Indians,0,Detroit Tigers,10,8,April 9 2019,2
New York Yankees,1,Houston Astros,9,3,April 9 2019,6
Seattle Mariners,0,Kansas City Royals,9,6,April 9 2019,3
Minnesota Twins,0,New York Mets,22,14,April 9 2019,8
Washington Nationals,0,Philadelphia Phillies,16,10,April 9 2019,6
San Diego Padres,1,San Francisco Giants,9,2,April 9 2019,7
Los Angeles Dodgers,1,St. Louis Cardinals,4,0,April 9 2019,4
Milwaukee Brewers,1,Los Angeles Angels,6,2,April 10 2019,4
Texas Rangers,0,Arizona D'Backs,7,5,April 10 2019,2
Oakland Athletics,0,Baltimore Orioles,13,10,April 10 2019,3
Tampa Bay Rays,0,Chicago White Sox,10,9,April 10 2019,1
Pittsburgh Pirates,0,Chicago Cubs,7,5,April 10 2019,2
Miami Marlins,1,Cincinnati Reds,3,1,April 10 2019,2
Cleveland Indians,1,Detroit Tigers,5,1,April 10 2019,4
New York Yankees,1,Houston Astros,14,6,April 10 2019,8
Seattle Mariners,0,Kansas City Royals,11,6,April 10 2019,5
Minnesota Twins,1,New York Mets,15,6,April 10 2019,9
Washington Nationals,0,Philadelphia Phillies,16,15,April 10 2019,1
San Diego Padres,0,San Francisco Giants,4,3,April 10 2019,1
Los Angeles Dodgers,1,St. Louis Cardinals,9,2,April 10 2019,7
San Diego Padres,0,Arizona D'Backs,13,7,April 11 2019,6
New York Mets,0,Atlanta Braves,9,6,April 11 2019,3
Oakland Athletics,0,Baltimore Orioles,13,8,April 11 2019,5
Toronto Blue Jays,1,Boston Red Sox,13,6,April 11 2019,7
Pittsburgh Pirates,1,Chicago Cubs,2,0,April 11 2019,2
Miami Marlins,1,Cincinnati Reds,5,0,April 11 2019,5
Cleveland Indians,0,Detroit Tigers,4,4,April 11 2019,0
Seattle Mariners,0,Kansas City Royals,13,7,April 11 2019,6
Colorado Rockies,1,San Francisco Giants,1,0,April 11 2019,1
Los Angeles Dodgers,1,St. Louis Cardinals,18,7,April 11 2019,11
San Diego Padres,0,Arizona D'Backs,3,2,April 12 2019,1
New York Mets,0,Atlanta Braves,8,6,April 12 2019,2
Baltimore Orioles,1,Boston Red Sox,10,4,April 12 2019,6
Los Angeles Angels,1,Chicago Cubs,6,1,April 12 2019,5
Cleveland Indians,1,Kansas City Royals,9,1,April 12 2019,8
Milwaukee Brewers,0,Los Angeles Dodgers,13,8,April 12 2019,5
Philadelphia Phillies,0,Miami Marlins,10,9,April 12 2019,1
Chicago White Sox,0,New York Yankees,15,9,April 12 2019,6
Houston Astros,0,Seattle Mariners,16,10,April 12 2019,6
Colorado Rockies,1,San Francisco Giants,5,2,April 12 2019,3
Oakland Athletics,0,Texas Rangers,14,8,April 12 2019,6
Tampa Bay Rays,0,Toronto Blue Jays,18,11,April 12 2019,7
Pittsburgh Pirates,0,Washington Nationals,9,6,April 12 2019,3
San Diego Padres,0,Arizona D'Backs,9,5,April 13 2019,4
New York Mets,1,Atlanta Braves,18,7,April 13 2019,11
Baltimore Orioles,0,Boston Red Sox,14,9,April 13 2019,5
Los Angeles Angels,0,Chicago Cubs,11,6,April 13 2019,5
St. Louis Cardinals,1,Cincinnati Reds,7,2,April 13 2019,5
Cleveland Indians,1,Kansas City Royals,3,0,April 13 2019,3
Milwaukee Brewers,0,Los Angeles Dodgers,5,4,April 13 2019,1
Philadelphia Phillies,1,Miami Marlins,13,3,April 13 2019,10
Detroit Tigers,1,Minnesota Twins,7,3,April 13 2019,4
Chicago White Sox,1,New York Yankees,4,0,April 13 2019,4
Houston Astros,0,Seattle Mariners,4,3,April 13 2019,1
Colorado Rockies,1,San Francisco Giants,7,2,April 13 2019,5
Tampa Bay Rays,1,Toronto Blue Jays,4,1,April 13 2019,3
Pittsburgh Pirates,1,Washington Nationals,5,2,April 13 2019,3
San Diego Padres,1,Arizona D'Backs,12,4,April 14 2019,8
New York Mets,1,Atlanta Braves,10,3,April 14 2019,7
Baltimore Orioles,1,Boston Red Sox,4,0,April 14 2019,4
St. Louis Cardinals,0,Cincinnati Reds,14,9,April 14 2019,5
Cleveland Indians,1,Kansas City Royals,17,8,April 14 2019,9
Milwaukee Brewers,1,Los Angeles Dodgers,8,1,April 14 2019,7
Philadelphia Phillies,0,Miami Marlins,4,3,April 14 2019,1
Detroit Tigers,1,Minnesota Twins,10,4,April 14 2019,6
Chicago White Sox,0,New York Yankees,7,5,April 14 2019,2
Houston Astros,0,Seattle Mariners,5,3,April 14 2019,2
Colorado Rockies,0,San Francisco Giants,4,4,April 14 2019,0
Oakland Athletics,1,Texas Rangers,15,7,April 14 2019,8
Tampa Bay Rays,0,Toronto Blue Jays,12,8,April 14 2019,4
Pittsburgh Pirates,0,Washington Nationals,7,4,April 14 2019,3
Baltimore Orioles,0,Boston Red Sox,9,8,April 15 2019,1
Kansas City Royals,1,Chicago White Sox,9,4,April 15 2019,5
Cincinnati Reds,1,Los Angeles Dodgers,7,3,April 15 2019,4
Chicago Cubs,0,Miami Marlins,9,7,April 15 2019,2
St. Louis Cardinals,1,Milwaukee Brewers,17,7,April 15 2019,10
Toronto Blue Jays,0,Minnesota Twins,8,5,April 15 2019,3
New York Mets,0,Philadelphia Phillies,13,7,April 15 2019,6
Colorado Rockies,0,San Diego Padres,7,5,April 15 2019,2
Cleveland Indians,0,Seattle Mariners,10,6,April 15 2019,4
Los Angeles Angels,1,Texas Rangers,19,7,April 15 2019,12
Arizona D'Backs,0,Atlanta Braves,15,9,April 16 2019,6
Kansas City Royals,1,Chicago White Sox,6,1,April 16 2019,5
Pittsburgh Pirates,0,Detroit Tigers,8,5,April 16 2019,3
Cincinnati Reds,1,Los Angeles Dodgers,7,1,April 16 2019,6
Chicago Cubs,0,Miami Marlins,4,4,April 16 2019,0
St. Louis Cardinals,1,Milwaukee Brewers,12,4,April 16 2019,8
Toronto Blue Jays,0,Minnesota Twins,11,6,April 16 2019,5
Boston Red Sox,1,New York Yankees,8,0,April 16 2019,8
Houston Astros,0,Oakland Athletics,10,9,April 16 2019,1
New York Mets,1,Philadelphia Phillies,17,3,April 16 2019,14
Colorado Rockies,0,San Diego Padres,10,8,April 16 2019,2
Cleveland Indians,0,Seattle Mariners,6,4,April 16 2019,2
Baltimore Orioles,1,Tampa Bay Rays,6,2,April 16 2019,4
Los Angeles Angels,1,Texas Rangers,5,0,April 16 2019,5
San Francisco Giants,0,Washington Nationals,10,7,April 16 2019,3
Arizona D'Backs,0,Atlanta Braves,5,3,April 17 2019,2
Kansas City Royals,0,Chicago White Sox,7,4,April 17 2019,3
Pittsburgh Pirates,0,Detroit Tigers,5,3,April 17 2019,2
Cincinnati Reds,1,Los Angeles Dodgers,5,2,April 17 2019,3
Chicago Cubs,0,Miami Marlins,6,6,April 17 2019,0
St. Louis Cardinals,0,Milwaukee Brewers,9,6,April 17 2019,3
Toronto Blue Jays,1,Minnesota Twins,5,1,April 17 2019,4
Boston Red Sox,1,New York Yankees,8,3,April 17 2019,5
Houston Astros,1,Oakland Athletics,3,1,April 17 2019,2
New York Mets,1,Philadelphia Phillies,5,2,April 17 2019,3
Cleveland Indians,0,Seattle Mariners,1,1,April 17 2019,0
Baltimore Orioles,1,Tampa Bay Rays,9,1,April 17 2019,8
Los Angeles Angels,1,Texas Rangers,9,4,April 17 2019,5
San Francisco Giants,1,Washington Nationals,15,6,April 17 2019,9
Seattle Mariners,0,Los Angeles Angels,21,11,April 18 2019,10
Arizona D'Backs,0,Atlanta Braves,5,4,April 18 2019,1
Philadelphia Phillies,1,Colorado Rockies,8,2,April 18 2019,6
Chicago White Sox,1,Detroit Tigers,16,7,April 18 2019,9
Los Angeles Dodgers,0,Milwaukee Brewers,4,3,April 18 2019,1
Toronto Blue Jays,0,Minnesota Twins,11,7,April 18 2019,4
Kansas City Royals,0,New York Yankees,7,6,April 18 2019,1
Cincinnati Reds,0,San Diego Padres,5,4,April 18 2019,1
Baltimore Orioles,0,Tampa Bay Rays,11,6,April 18 2019,5
San Francisco Giants,1,Washington Nationals,6,2,April 18 2019,4
Seattle Mariners,0,Los Angeles Angels,8,5,April 19 2019,3
Arizona D'Backs,1,Chicago Cubs,6,1,April 19 2019,5
Philadelphia Phillies,1,Colorado Rockies,7,3,April 19 2019,4
Chicago White Sox,0,Detroit Tigers,10,7,April 19 2019,3
Washington Nationals,1,Miami Marlins,5,2,April 19 2019,3
Los Angeles Dodgers,0,Milwaukee Brewers,8,5,April 19 2019,3
Kansas City Royals,1,New York Yankees,8,2,April 19 2019,6
Toronto Blue Jays,0,Oakland Athletics,6,5,April 19 2019,1
San Francisco Giants,1,Pittsburgh Pirates,5,1,April 19 2019,4
Cincinnati Reds,0,San Diego Padres,5,3,April 19 2019,2
New York Mets,0,St. Louis Cardinals,9,5,April 19 2019,4
Boston Red Sox,0,Tampa Bay Rays,10,6,April 19 2019,4
Houston Astros,0,Texas Rangers,9,7,April 19 2019,2
Seattle Mariners,0,Los Angeles Angels,11,6,April 20 2019,5
Minnesota Twins,0,Baltimore Orioles,11,6,April 20 2019,5
Minnesota Twins,0,Baltimore Orioles,23,16,April 20 2019,7
Arizona D'Backs,0,Chicago Cubs,6,6,April 20 2019,0
Atlanta Braves,1,Cleveland Indians,12,4,April 20 2019,8
Atlanta Braves,0,Cleveland Indians,15,8,April 20 2019,7
Philadelphia Phillies,0,Colorado Rockies,13,8,April 20 2019,5
Washington Nationals,1,Miami Marlins,12,3,April 20 2019,9
Los Angeles Dodgers,1,Milwaukee Brewers,5,0,April 20 2019,5
Kansas City Royals,1,New York Yankees,11,2,April 20 2019,9
Toronto Blue Jays,0,Oakland Athletics,11,10,April 20 2019,1
San Francisco Giants,1,Pittsburgh Pirates,4,1,April 20 2019,3
Cincinnati Reds,0,San Diego Padres,6,4,April 20 2019,2
New York Mets,1,St. Louis Cardinals,12,2,April 20 2019,10
Boston Red Sox,0,Tampa Bay Rays,11,6,April 20 2019,5
Houston Astros,1,Texas Rangers,13,4,April 20 2019,9
Seattle Mariners,1,Los Angeles Angels,14,6,April 21 2019,8
Minnesota Twins,0,Baltimore Orioles,7,4,April 21 2019,3
Arizona D'Backs,1,Chicago Cubs,3,1,April 21 2019,2
Atlanta Braves,0,Cleveland Indians,16,11,April 21 2019,5
Philadelphia Phillies,1,Colorado Rockies,5,1,April 21 2019,4
Chicago White Sox,1,Detroit Tigers,7,3,April 21 2019,4
Washington Nationals,0,Miami Marlins,5,5,April 21 2019,0
Los Angeles Dodgers,0,Milwaukee Brewers,11,6,April 21 2019,5
Kansas City Royals,1,New York Yankees,13,6,April 21 2019,7
Toronto Blue Jays,0,Oakland Athletics,9,5,April 21 2019,4
San Francisco Giants,0,Pittsburgh Pirates,5,3,April 21 2019,2
Cincinnati Reds,1,San Diego Padres,7,3,April 21 2019,4
New York Mets,1,St. Louis Cardinals,10,4,April 21 2019,6
Boston Red Sox,0,Tampa Bay Rays,7,4,April 21 2019,3
Houston Astros,1,Texas Rangers,21,10,April 21 2019,11
New York Yankees,0,Los Angeles Angels,7,4,April 22 2019,3
Chicago White Sox,0,Baltimore Orioles,14,12,April 22 2019,2
Washington Nationals,1,Colorado Rockies,12,5,April 22 2019,7
Minnesota Twins,0,Houston Astros,14,9,April 22 2019,5
Philadelphia Phillies,1,New York Mets,6,1,April 22 2019,5
Texas Rangers,1,Oakland Athletics,7,1,April 22 2019,6
Arizona D'Backs,0,Pittsburgh Pirates,16,12,April 22 2019,4
Milwaukee Brewers,1,St. Louis Cardinals,18,5,April 22 2019,13
Kansas City Royals,1,Tampa Bay Rays,9,3,April 22 2019,6
New York Yankees,0,Los Angeles Angels,12,7,April 23 2019,5
Chicago White Sox,1,Baltimore Orioles,10,1,April 23 2019,9
Detroit Tigers,0,Boston Red Sox,11,7,April 23 2019,4
Detroit Tigers,0,Boston Red Sox,6,4,April 23 2019,2
Los Angeles Dodgers,1,Chicago Cubs,9,2,April 23 2019,7
Atlanta Braves,1,Cincinnati Reds,13,6,April 23 2019,7
Miami Marlins,0,Cleveland Indians,4,3,April 23 2019,1
Washington Nationals,0,Colorado Rockies,9,6,April 23 2019,3
Minnesota Twins,1,Houston Astros,14,4,April 23 2019,10
Philadelphia Phillies,1,New York Mets,9,0,April 23 2019,9
Texas Rangers,1,Oakland Athletics,16,5,April 23 2019,11
Arizona D'Backs,0,Pittsburgh Pirates,3,2,April 23 2019,1
Seattle Mariners,1,San Diego Padres,9,3,April 23 2019,6
Milwaukee Brewers,1,St. Louis Cardinals,7,3,April 23 2019,4
Kansas City Royals,1,Tampa Bay Rays,7,2,April 23 2019,5
San Francisco Giants,0,Toronto Blue Jays,13,7,April 23 2019,6
New York Yankees,0,Los Angeles Angels,11,6,April 24 2019,5
Chicago White Sox,1,Baltimore Orioles,7,3,April 24 2019,4
Detroit Tigers,1,Boston Red Sox,15,4,April 24 2019,11
Los Angeles Dodgers,1,Chicago Cubs,13,6,April 24 2019,7
Atlanta Braves,0,Cincinnati Reds,4,3,April 24 2019,1
Miami Marlins,1,Cleveland Indians,8,2,April 24 2019,6
Washington Nationals,1,Colorado Rockies,14,5,April 24 2019,9
Minnesota Twins,1,Houston Astros,8,1,April 24 2019,7
Philadelphia Phillies,0,New York Mets,6,6,April 24 2019,0
Texas Rangers,1,Oakland Athletics,11,5,April 24 2019,6
Arizona D'Backs,0,Pittsburgh Pirates,13,11,April 24 2019,2
Seattle Mariners,1,San Diego Padres,1,0,April 24 2019,1
Milwaukee Brewers,1,St. Louis Cardinals,7,2,April 24 2019,5
Kansas City Royals,0,Tampa Bay Rays,12,10,April 24 2019,2
San Francisco Giants,0,Toronto Blue Jays,4,4,April 24 2019,0
New York Yankees,1,Los Angeles Angels,16,5,April 25 2019,11
Detroit Tigers,1,Boston Red Sox,10,3,April 25 2019,7
Los Angeles Dodgers,0,Chicago Cubs,3,2,April 25 2019,1
Atlanta Braves,1,Cincinnati Reds,6,2,April 25 2019,4
Cleveland Indians,0,Houston Astros,3,2,April 25 2019,1
Miami Marlins,0,Philadelphia Phillies,4,3,April 25 2019,1
Arizona D'Backs,0,Pittsburgh Pirates,5,5,April 25 2019,0
Texas Rangers,1,Seattle Mariners,16,2,April 25 2019,14
Chicago Cubs,1,Arizona D'Backs,11,3,April 26 2019,8
Colorado Rockies,0,Atlanta Braves,12,8,April 26 2019,4
Detroit Tigers,1,Chicago White Sox,23,11,April 26 2019,12
Cleveland Indians,0,Houston Astros,9,6,April 26 2019,3
Los Angeles Angels,0,Kansas City Royals,6,5,April 26 2019,1
Pittsburgh Pirates,1,Los Angeles Dodgers,8,2,April 26 2019,6
Baltimore Orioles,1,Minnesota Twins,7,1,April 26 2019,6
Milwaukee Brewers,0,New York Mets,12,10,April 26 2019,2
Miami Marlins,1,Philadelphia Phillies,4,0,April 26 2019,4
Texas Rangers,1,Seattle Mariners,9,4,April 26 2019,5
New York Yankees,0,San Francisco Giants,10,7,April 26 2019,3
Cincinnati Reds,0,St. Louis Cardinals,13,12,April 26 2019,1
Oakland Athletics,1,Toronto Blue Jays,6,2,April 26 2019,4
San Diego Padres,0,Washington Nationals,7,4,April 26 2019,3
Chicago Cubs,0,Arizona D'Backs,10,9,April 27 2019,1
Colorado Rockies,0,Atlanta Braves,14,9,April 27 2019,5
Tampa Bay Rays,0,Boston Red Sox,3,2,April 27 2019,1
Cleveland Indians,1,Houston Astros,7,3,April 27 2019,4
Los Angeles Angels,1,Kansas City Royals,13,4,April 27 2019,9
Pittsburgh Pirates,1,Los Angeles Dodgers,4,1,April 27 2019,3
Baltimore Orioles,1,Minnesota Twins,11,2,April 27 2019,9
Milwaukee Brewers,0,New York Mets,14,8,April 27 2019,6
Miami Marlins,1,Philadelphia Phillies,21,9,April 27 2019,12
Texas Rangers,0,Seattle Mariners,16,15,April 27 2019,1
New York Yankees,0,San Francisco Giants,10,6,April 27 2019,4
Cincinnati Reds,1,St. Louis Cardinals,9,3,April 27 2019,6
Oakland Athletics,1,Toronto Blue Jays,8,1,April 27 2019,7
San Diego Padres,0,Washington Nationals,11,8,April 27 2019,3
Chicago Cubs,0,Arizona D'Backs,11,6,April 28 2019,5
Colorado Rockies,1,Atlanta Braves,15,7,April 28 2019,8
Tampa Bay Rays,0,Boston Red Sox,7,5,April 28 2019,2
Detroit Tigers,1,Chicago White Sox,5,1,April 28 2019,4
Cleveland Indians,1,Houston Astros,5,1,April 28 2019,4
Los Angeles Angels,0,Kansas City Royals,10,7,April 28 2019,3
Pittsburgh Pirates,1,Los Angeles Dodgers,13,6,April 28 2019,7
Baltimore Orioles,1,Minnesota Twins,5,1,April 28 2019,4
Milwaukee Brewers,1,New York Mets,7,2,April 28 2019,5
Miami Marlins,1,Philadelphia Phillies,6,1,April 28 2019,5
Texas Rangers,0,Seattle Mariners,15,14,April 28 2019,1
New York Yankees,0,San Francisco Giants,16,11,April 28 2019,5
Cincinnati Reds,1,St. Louis Cardinals,7,2,April 28 2019,5
Oakland Athletics,1,Toronto Blue Jays,9,4,April 28 2019,5
San Diego Padres,1,Washington Nationals,13,6,April 28 2019,7
St. Louis Cardinals,0,Washington Nationals,0,0,April 29 2019,0
Oakland Athletics,0,Boston Red Sox,0,0,April 29 2019,0
Cincinnati Reds,0,New York Mets,0,0,April 29 2019,0
San Diego Padres,0,Atlanta Braves,0,0,April 29 2019,0
Colorado Rockies,0,Milwaukee Brewers,0,0,April 29 2019,0
Houston Astros,0,Minnesota Twins,0,0,April 29 2019,0
Baltimore Orioles,0,Chicago White Sox,0,0,April 29 2019,0
Tampa Bay Rays,0,Kansas City Royals,0,0,April 29 2019,0
Los Angeles Dodgers,0,San Francisco Giants,0,0,April 29 2019,0
St. Louis Cardinals,0,Washington Nationals,0,0,April 30 2019,0
Detroit Tigers,0,Philadelphia Phillies,0,0,April 30 2019,0
Oakland Athletics,0,Boston Red Sox,0,0,April 30 2019,0
Cincinnati Reds,0,New York Mets,0,0,April 30 2019,0
Cleveland Indians,0,Miami Marlins,0,0,April 30 2019,0
San Diego Padres,0,Atlanta Braves,0,0,April 30 2019,0
Houston Astros,0,Minnesota Twins,0,0,April 30 2019,0
Colorado Rockies,0,Milwaukee Brewers,0,0,April 30 2019,0
Pittsburgh Pirates,0,Texas Rangers,0,0,April 30 2019,0
Baltimore Orioles,0,Chicago White Sox,0,0,April 30 2019,0
Tampa Bay Rays,0,Kansas City Royals,0,0,April 30 2019,0
New York Yankees,0,Arizona D'Backs,0,0,April 30 2019,0
Los Angeles Dodgers,0,San Francisco Giants,0,0,April 30 2019,0
Toronto Blue Jays,0,Los Angeles Angels,0,0,April 30 2019,0
Chicago Cubs,0,Seattle Mariners,0,0,April 30 2019,0
Oakland Athletics,0,Boston Red Sox,0,0,May 1 2019,0
Pittsburgh Pirates,0,Texas Rangers,0,0,May 1 2019,0
New York Yankees,0,Arizona D'Backs,0,0,May 1 2019,0
Chicago Cubs,0,Seattle Mariners,0,0,May 1 2019,0
St. Louis Cardinals,0,Washington Nationals,0,0,May 1 2019,0
Detroit Tigers,0,Philadelphia Phillies,0,0,May 1 2019,0
Cleveland Indians,0,Miami Marlins,0,0,May 1 2019,0
Cincinnati Reds,0,New York Mets,0,0,May 1 2019,0
San Diego Padres,0,Atlanta Braves,0,0,May 1 2019,0
Colorado Rockies,0,Milwaukee Brewers,0,0,May 1 2019,0
Houston Astros,0,Minnesota Twins,0,0,May 1 2019,0
Baltimore Orioles,0,Chicago White Sox,0,0,May 1 2019,0
Tampa Bay Rays,0,Kansas City Royals,0,0,May 1 2019,0
Los Angeles Dodgers,0,San Francisco Giants,0,0,May 1 2019,0
Toronto Blue Jays,0,Los Angeles Angels,0,0,May 1 2019,0
San Diego Padres,0,Atlanta Braves,0,0,May 2 2019,0
Cincinnati Reds,0,New York Mets,0,0,May 2 2019,0
Colorado Rockies,0,Milwaukee Brewers,0,0,May 2 2019,0
Houston Astros,0,Minnesota Twins,0,0,May 2 2019,0
Tampa Bay Rays,0,Kansas City Royals,0,0,May 2 2019,0
St. Louis Cardinals,0,Washington Nationals,0,0,May 2 2019,0
Boston Red Sox,0,Chicago White Sox,0,0,May 2 2019,0
Toronto Blue Jays,0,Los Angeles Angels,0,0,May 2 2019,0
St. Louis Cardinals,0,Chicago Cubs,0,0,May 3 2019,0
Tampa Bay Rays,0,Baltimore Orioles,0,0,May 3 2019,0
Oakland Athletics,0,Pittsburgh Pirates,0,0,May 3 2019,0
Washington Nationals,0,Philadelphia Phillies,0,0,May 3 2019,0
Minnesota Twins,0,New York Yankees,0,0,May 3 2019,0
Atlanta Braves,0,Miami Marlins,0,0,May 3 2019,0
Kansas City Royals,0,Detroit Tigers,0,0,May 3 2019,0
Seattle Mariners,0,Cleveland Indians,0,0,May 3 2019,0
San Francisco Giants,0,Cincinnati Reds,0,0,May 3 2019,0
Toronto Blue Jays,0,Texas Rangers,0,0,May 3 2019,0
New York Mets,0,Milwaukee Brewers,0,0,May 3 2019,0
Boston Red Sox,0,Chicago White Sox,0,0,May 3 2019,0
Arizona D'Backs,0,Colorado Rockies,0,0,May 3 2019,0
Los Angeles Dodgers,0,San Diego Padres,0,0,May 3 2019,0
Minnesota Twins,0,New York Yankees,0,0,May 4 2019,0
St. Louis Cardinals,0,Chicago Cubs,0,0,May 4 2019,0
Kansas City Royals,0,Detroit Tigers,0,0,May 4 2019,0
Seattle Mariners,0,Cleveland Indians,0,0,May 4 2019,0
Atlanta Braves,0,Miami Marlins,0,0,May 4 2019,0
Tampa Bay Rays,0,Baltimore Orioles,0,0,May 4 2019,0
Oakland Athletics,0,Pittsburgh Pirates,0,0,May 4 2019,0
Washington Nationals,0,Philadelphia Phillies,0,0,May 4 2019,0
New York Mets,0,Milwaukee Brewers,0,0,May 4 2019,0
Houston Astros,0,Los Angeles Angels,0,0,May 4 2019,0
San Francisco Giants,0,Cincinnati Reds,0,0,May 4 2019,0
Boston Red Sox,0,Chicago White Sox,0,0,May 4 2019,0
Toronto Blue Jays,0,Texas Rangers,0,0,May 4 2019,0
Arizona D'Backs,0,Colorado Rockies,0,0,May 4 2019,0
Los Angeles Dodgers,0,San Diego Padres,0,0,May 4 2019,0
Tampa Bay Rays,0,Baltimore Orioles,0,0,May 5 2019,0
Minnesota Twins,0,New York Yankees,0,0,May 5 2019,0
Kansas City Royals,0,Detroit Tigers,0,0,May 5 2019,0
Seattle Mariners,0,Cleveland Indians,0,0,May 5 2019,0
Atlanta Braves,0,Miami Marlins,0,0,May 5 2019,0
Oakland Athletics,0,Pittsburgh Pirates,0,0,May 5 2019,0
Washington Nationals,0,Philadelphia Phillies,0,0,May 5 2019,0
Boston Red Sox,0,Chicago White Sox,0,0,May 5 2019,0
New York Mets,0,Milwaukee Brewers,0,0,May 5 2019,0
Toronto Blue Jays,0,Texas Rangers,0,0,May 5 2019,0
Arizona D'Backs,0,Colorado Rockies,0,0,May 5 2019,0
San Francisco Giants,0,Cincinnati Reds,0,0,May 5 2019,0
Los Angeles Dodgers,0,San Diego Padres,0,0,May 5 2019,0
Houston Astros,0,Los Angeles Angels,0,0,May 5 2019,0
St. Louis Cardinals,0,Chicago Cubs,0,0,May 5 2019,0
San Francisco Giants,0,Cincinnati Reds,0,0,May 6 2019,0
Chicago White Sox,0,Cleveland Indians,0,0,May 6 2019,0
Seattle Mariners,0,New York Yankees,0,0,May 6 2019,0
Boston Red Sox,0,Baltimore Orioles,0,0,May 6 2019,0
Minnesota Twins,0,Toronto Blue Jays,0,0,May 6 2019,0
Arizona D'Backs,0,Tampa Bay Rays,0,0,May 6 2019,0
Washington Nationals,0,Milwaukee Brewers,0,0,May 6 2019,0
Miami Marlins,0,Chicago Cubs,0,0,May 6 2019,0
Philadelphia Phillies,0,St. Louis Cardinals,0,0,May 6 2019,0
Kansas City Royals,0,Houston Astros,0,0,May 6 2019,0
Atlanta Braves,0,Los Angeles Dodgers,0,0,May 6 2019,0
New York Mets,0,San Diego Padres,0,0,May 6 2019,0
Chicago White Sox,0,Cleveland Indians,0,0,May 7 2019,0
Seattle Mariners,0,New York Yankees,0,0,May 7 2019,0
Boston Red Sox,0,Baltimore Orioles,0,0,May 7 2019,0
Texas Rangers,0,Pittsburgh Pirates,0,0,May 7 2019,0
Minnesota Twins,0,Toronto Blue Jays,0,0,May 7 2019,0
Arizona D'Backs,0,Tampa Bay Rays,0,0,May 7 2019,0
Los Angeles Angels,0,Detroit Tigers,0,0,May 7 2019,0
Washington Nationals,0,Milwaukee Brewers,0,0,May 7 2019,0
Philadelphia Phillies,0,St. Louis Cardinals,0,0,May 7 2019,0
Miami Marlins,0,Chicago Cubs,0,0,May 7 2019,0
Kansas City Royals,0,Houston Astros,0,0,May 7 2019,0
San Francisco Giants,0,Colorado Rockies,0,0,May 7 2019,0
Cincinnati Reds,0,Oakland Athletics,0,0,May 7 2019,0
New York Mets,0,San Diego Padres,0,0,May 7 2019,0
Atlanta Braves,0,Los Angeles Dodgers,0,0,May 7 2019,0
Texas Rangers,0,Pittsburgh Pirates,0,0,May 8 2019,0
Washington Nationals,0,Milwaukee Brewers,0,0,May 8 2019,0
Arizona D'Backs,0,Tampa Bay Rays,0,0,May 8 2019,0
Philadelphia Phillies,0,St. Louis Cardinals,0,0,May 8 2019,0
New York Mets,0,San Diego Padres,0,0,May 8 2019,0
Chicago White Sox,0,Cleveland Indians,0,0,May 8 2019,0
Seattle Mariners,0,New York Yankees,0,0,May 8 2019,0
Boston Red Sox,0,Baltimore Orioles,0,0,May 8 2019,0
Minnesota Twins,0,Toronto Blue Jays,0,0,May 8 2019,0
Los Angeles Angels,0,Detroit Tigers,0,0,May 8 2019,0
Miami Marlins,0,Chicago Cubs,0,0,May 8 2019,0
Kansas City Royals,0,Houston Astros,0,0,May 8 2019,0
San Francisco Giants,0,Colorado Rockies,0,0,May 8 2019,0
Cincinnati Reds,0,Oakland Athletics,0,0,May 8 2019,0
Atlanta Braves,0,Los Angeles Dodgers,0,0,May 8 2019,0
Chicago White Sox,0,Cleveland Indians,0,0,May 9 2019,0
Los Angeles Angels,0,Detroit Tigers,0,0,May 9 2019,0
Miami Marlins,0,Chicago Cubs,0,0,May 9 2019,0
San Francisco Giants,0,Colorado Rockies,0,0,May 9 2019,0
Cincinnati Reds,0,Oakland Athletics,0,0,May 9 2019,0
Seattle Mariners,0,New York Yankees,0,0,May 9 2019,0
Pittsburgh Pirates,0,St. Louis Cardinals,0,0,May 9 2019,0
Texas Rangers,0,Houston Astros,0,0,May 9 2019,0
Atlanta Braves,0,Arizona D'Backs,0,0,May 9 2019,0
Washington Nationals,0,Los Angeles Dodgers,0,0,May 9 2019,0
Milwaukee Brewers,0,Chicago Cubs,0,0,May 10 2019,0
Los Angeles Angels,0,Baltimore Orioles,0,0,May 10 2019,0
Chicago White Sox,0,Toronto Blue Jays,0,0,May 10 2019,0
Seattle Mariners,0,Boston Red Sox,0,0,May 10 2019,0
Miami Marlins,0,New York Mets,0,0,May 10 2019,0
New York Yankees,0,Tampa Bay Rays,0,0,May 10 2019,0
Texas Rangers,0,Houston Astros,0,0,May 10 2019,0
Detroit Tigers,0,Minnesota Twins,0,0,May 10 2019,0
Philadelphia Phillies,0,Kansas City Royals,0,0,May 10 2019,0
Pittsburgh Pirates,0,St. Louis Cardinals,0,0,May 10 2019,0
San Diego Padres,0,Colorado Rockies,0,0,May 10 2019,0
Cleveland Indians,0,Oakland Athletics,0,0,May 10 2019,0
Atlanta Braves,0,Arizona D'Backs,0,0,May 10 2019,0
Washington Nationals,0,Los Angeles Dodgers,0,0,May 10 2019,0
Cincinnati Reds,0,San Francisco Giants,0,0,May 10 2019,0
Seattle Mariners,0,Boston Red Sox,0,0,May 11 2019,0
Detroit Tigers,0,Minnesota Twins,0,0,May 11 2019,0
Pittsburgh Pirates,0,St. Louis Cardinals,0,0,May 11 2019,0
Milwaukee Brewers,0,Chicago Cubs,0,0,May 11 2019,0
Chicago White Sox,0,Toronto Blue Jays,0,0,May 11 2019,0
Los Angeles Angels,0,Baltimore Orioles,0,0,May 11 2019,0
Cleveland Indians,0,Oakland Athletics,0,0,May 11 2019,0
New York Yankees,0,Tampa Bay Rays,0,0,May 11 2019,0
Miami Marlins,0,New York Mets,0,0,May 11 2019,0
Philadelphia Phillies,0,Kansas City Royals,0,0,May 11 2019,0
Texas Rangers,0,Houston Astros,0,0,May 11 2019,0
Detroit Tigers,0,Minnesota Twins,0,0,May 11 2019,0
San Diego Padres,0,Colorado Rockies,0,0,May 11 2019,0
Atlanta Braves,0,Arizona D'Backs,0,0,May 11 2019,0
Cincinnati Reds,0,San Francisco Giants,0,0,May 11 2019,0
Washington Nationals,0,Los Angeles Dodgers,0,0,May 11 2019,0
Los Angeles Angels,0,Baltimore Orioles,0,0,May 12 2019,0
Seattle Mariners,0,Boston Red Sox,0,0,May 12 2019,0
Chicago White Sox,0,Toronto Blue Jays,0,0,May 12 2019,0
New York Yankees,0,Tampa Bay Rays,0,0,May 12 2019,0
Miami Marlins,0,New York Mets,0,0,May 12 2019,0
Texas Rangers,0,Houston Astros,0,0,May 12 2019,0
Detroit Tigers,0,Minnesota Twins,0,0,May 12 2019,0
Pittsburgh Pirates,0,St. Louis Cardinals,0,0,May 12 2019,0
Philadelphia Phillies,0,Kansas City Royals,0,0,May 12 2019,0
San Diego Padres,0,Colorado Rockies,0,0,May 12 2019,0
Cincinnati Reds,0,San Francisco Giants,0,0,May 12 2019,0
Cleveland Indians,0,Oakland Athletics,0,0,May 12 2019,0
Washington Nationals,0,Los Angeles Dodgers,0,0,May 12 2019,0
Atlanta Braves,0,Arizona D'Backs,0,0,May 12 2019,0
Milwaukee Brewers,0,Chicago Cubs,0,0,May 12 2019,0
Baltimore Orioles,0,New York Yankees,0,0,May 13 2019,0
Milwaukee Brewers,0,Philadelphia Phillies,0,0,May 13 2019,0
Houston Astros,0,Detroit Tigers,0,0,May 13 2019,0
Los Angeles Angels,0,Minnesota Twins,0,0,May 13 2019,0
Cleveland Indians,0,Chicago White Sox,0,0,May 13 2019,0
Pittsburgh Pirates,0,Arizona D'Backs,0,0,May 13 2019,0
Oakland Athletics,0,Seattle Mariners,0,0,May 13 2019,0
Cleveland Indians,0,Chicago White Sox,0,0,May 14 2019,0
Baltimore Orioles,0,New York Yankees,0,0,May 14 2019,0
Chicago Cubs,0,Cincinnati Reds,0,0,May 14 2019,0
Milwaukee Brewers,0,Philadelphia Phillies,0,0,May 14 2019,0
New York Mets,0,Washington Nationals,0,0,May 14 2019,0
Colorado Rockies,0,Boston Red Sox,0,0,May 14 2019,0
Tampa Bay Rays,0,Miami Marlins,0,0,May 14 2019,0
Houston Astros,0,Detroit Tigers,0,0,May 14 2019,0
St. Louis Cardinals,0,Atlanta Braves,0,0,May 14 2019,0
Los Angeles Angels,0,Minnesota Twins,0,0,May 14 2019,0
Texas Rangers,0,Kansas City Royals,0,0,May 14 2019,0
Pittsburgh Pirates,0,Arizona D'Backs,0,0,May 14 2019,0
Toronto Blue Jays,0,San Francisco Giants,0,0,May 14 2019,0
Oakland Athletics,0,Seattle Mariners,0,0,May 14 2019,0
San Diego Padres,0,Los Angeles Dodgers,0,0,May 14 2019,0
Los Angeles Angels,0,Minnesota Twins,0,0,May 15 2019,0
Pittsburgh Pirates,0,Arizona D'Backs,0,0,May 15 2019,0
Toronto Blue Jays,0,San Francisco Giants,0,0,May 15 2019,0
Baltimore Orioles,0,New York Yankees,0,0,May 15 2019,0
Chicago Cubs,0,Cincinnati Reds,0,0,May 15 2019,0
Milwaukee Brewers,0,Philadelphia Phillies,0,0,May 15 2019,0
New York Mets,0,Washington Nationals,0,0,May 15 2019,0
Tampa Bay Rays,0,Miami Marlins,0,0,May 15 2019,0
Houston Astros,0,Detroit Tigers,0,0,May 15 2019,0
Colorado Rockies,0,Boston Red Sox,0,0,May 15 2019,0
St. Louis Cardinals,0,Atlanta Braves,0,0,May 15 2019,0
Texas Rangers,0,Kansas City Royals,0,0,May 15 2019,0
San Diego Padres,0,Los Angeles Dodgers,0,0,May 15 2019,0
New York Mets,0,Washington Nationals,0,0,May 16 2019,0
Milwaukee Brewers,0,Philadelphia Phillies,0,0,May 16 2019,0
Oakland Athletics,0,Detroit Tigers,0,0,May 16 2019,0
Texas Rangers,0,Kansas City Royals,0,0,May 16 2019,0
Baltimore Orioles,0,Cleveland Indians,0,0,May 16 2019,0
Chicago Cubs,0,Cincinnati Reds,0,0,May 16 2019,0
St. Louis Cardinals,0,Atlanta Braves,0,0,May 16 2019,0
Toronto Blue Jays,0,Chicago White Sox,0,0,May 16 2019,0
Pittsburgh Pirates,0,San Diego Padres,0,0,May 16 2019,0
Minnesota Twins,0,Seattle Mariners,0,0,May 16 2019,0
Chicago Cubs,0,Washington Nationals,0,0,May 17 2019,0
Colorado Rockies,0,Philadelphia Phillies,0,0,May 17 2019,0
Tampa Bay Rays,0,New York Yankees,0,0,May 17 2019,0
New York Mets,0,Miami Marlins,0,0,May 17 2019,0
Oakland Athletics,0,Detroit Tigers,0,0,May 17 2019,0
Baltimore Orioles,0,Cleveland Indians,0,0,May 17 2019,0
Los Angeles Dodgers,0,Cincinnati Reds,0,0,May 17 2019,0
Houston Astros,0,Boston Red Sox,0,0,May 17 2019,0
Milwaukee Brewers,0,Atlanta Braves,0,0,May 17 2019,0
St. Louis Cardinals,0,Texas Rangers,0,0,May 17 2019,0
Toronto Blue Jays,0,Chicago White Sox,0,0,May 17 2019,0
San Francisco Giants,0,Arizona D'Backs,0,0,May 17 2019,0
Kansas City Royals,0,Los Angeles Angels,0,0,May 17 2019,0
Pittsburgh Pirates,0,San Diego Padres,0,0,May 17 2019,0
Minnesota Twins,0,Seattle Mariners,0,0,May 17 2019,0
Tampa Bay Rays,0,New York Yankees,0,0,May 18 2019,0
Toronto Blue Jays,0,Chicago White Sox,0,0,May 18 2019,0
St. Louis Cardinals,0,Texas Rangers,0,0,May 18 2019,0
Colorado Rockies,0,Philadelphia Phillies,0,0,May 18 2019,0
Oakland Athletics,0,Detroit Tigers,0,0,May 18 2019,0
Los Angeles Dodgers,0,Cincinnati Reds,0,0,May 18 2019,0
Baltimore Orioles,0,Cleveland Indians,0,0,May 18 2019,0
New York Mets,0,Miami Marlins,0,0,May 18 2019,0
Chicago Cubs,0,Washington Nationals,0,0,May 18 2019,0
Houston Astros,0,Boston Red Sox,0,0,May 18 2019,0
Milwaukee Brewers,0,Atlanta Braves,0,0,May 18 2019,0
Pittsburgh Pirates,0,San Diego Padres,0,0,May 18 2019,0
Kansas City Royals,0,Los Angeles Angels,0,0,May 18 2019,0
Minnesota Twins,0,Seattle Mariners,0,0,May 18 2019,0
San Francisco Giants,0,Arizona D'Backs,0,0,May 18 2019,0
Tampa Bay Rays,0,New York Yankees,0,0,May 19 2019,0
Colorado Rockies,0,Philadelphia Phillies,0,0,May 19 2019,0
Houston Astros,0,Boston Red Sox,0,0,May 19 2019,0
New York Mets,0,Miami Marlins,0,0,May 19 2019,0
Baltimore Orioles,0,Cleveland Indians,0,0,May 19 2019,0
Los Angeles Dodgers,0,Cincinnati Reds,0,0,May 19 2019,0
Oakland Athletics,0,Detroit Tigers,0,0,May 19 2019,0
Milwaukee Brewers,0,Atlanta Braves,0,0,May 19 2019,0
Toronto Blue Jays,0,Chicago White Sox,0,0,May 19 2019,0
St. Louis Cardinals,0,Texas Rangers,0,0,May 19 2019,0
Kansas City Royals,0,Los Angeles Angels,0,0,May 19 2019,0
Pittsburgh Pirates,0,San Diego Padres,0,0,May 19 2019,0
Minnesota Twins,0,Seattle Mariners,0,0,May 19 2019,0
San Francisco Giants,0,Arizona D'Backs,0,0,May 19 2019,0
Chicago Cubs,0,Washington Nationals,0,0,May 19 2019,0
Boston Red Sox,0,Toronto Blue Jays,0,0,May 20 2019,0
Oakland Athletics,0,Cleveland Indians,0,0,May 20 2019,0
New York Yankees,0,Baltimore Orioles,0,0,May 20 2019,0
Washington Nationals,0,New York Mets,0,0,May 20 2019,0
Philadelphia Phillies,0,Chicago Cubs,0,0,May 20 2019,0
Seattle Mariners,0,Texas Rangers,0,0,May 20 2019,0
Chicago White Sox,0,Houston Astros,0,0,May 20 2019,0
Atlanta Braves,0,San Francisco Giants,0,0,May 20 2019,0
Minnesota Twins,0,Los Angeles Angels,0,0,May 20 2019,0
Arizona D'Backs,0,San Diego Padres,0,0,May 20 2019,0
Oakland Athletics,0,Cleveland Indians,0,0,May 21 2019,0
New York Yankees,0,Baltimore Orioles,0,0,May 21 2019,0
Philadelphia Phillies,0,Chicago Cubs,0,0,May 21 2019,0
Colorado Rockies,0,Pittsburgh Pirates,0,0,May 21 2019,0
Boston Red Sox,0,Toronto Blue Jays,0,0,May 21 2019,0
Los Angeles Dodgers,0,Tampa Bay Rays,0,0,May 21 2019,0
Washington Nationals,0,New York Mets,0,0,May 21 2019,0
Miami Marlins,0,Detroit Tigers,0,0,May 21 2019,0
Cincinnati Reds,0,Milwaukee Brewers,0,0,May 21 2019,0
Seattle Mariners,0,Texas Rangers,0,0,May 21 2019,0
Chicago White Sox,0,Houston Astros,0,0,May 21 2019,0
Kansas City Royals,0,St. Louis Cardinals,0,0,May 21 2019,0
Atlanta Braves,0,San Francisco Giants,0,0,May 21 2019,0
Minnesota Twins,0,Los Angeles Angels,0,0,May 21 2019,0
Arizona D'Backs,0,San Diego Padres,0,0,May 21 2019,0
Oakland Athletics,0,Cleveland Indians,0,0,May 22 2019,0
Cincinnati Reds,0,Milwaukee Brewers,0,0,May 22 2019,0
Kansas City Royals,0,St. Louis Cardinals,0,0,May 22 2019,0
Seattle Mariners,0,Texas Rangers,0,0,May 22 2019,0
Arizona D'Backs,0,San Diego Padres,0,0,May 22 2019,0
New York Yankees,0,Baltimore Orioles,0,0,May 22 2019,0
Colorado Rockies,0,Pittsburgh Pirates,0,0,May 22 2019,0
Boston Red Sox,0,Toronto Blue Jays,0,0,May 22 2019,0
Los Angeles Dodgers,0,Tampa Bay Rays,0,0,May 22 2019,0
Washington Nationals,0,New York Mets,0,0,May 22 2019,0
Miami Marlins,0,Detroit Tigers,0,0,May 22 2019,0
Philadelphia Phillies,0,Chicago Cubs,0,0,May 22 2019,0
Chicago White Sox,0,Houston Astros,0,0,May 22 2019,0
Minnesota Twins,0,Los Angeles Angels,0,0,May 22 2019,0
Atlanta Braves,0,San Francisco Giants,0,0,May 22 2019,0
Washington Nationals,0,New York Mets,0,0,May 23 2019,0
New York Yankees,0,Baltimore Orioles,0,0,May 23 2019,0
Colorado Rockies,0,Pittsburgh Pirates,0,0,May 23 2019,0
Boston Red Sox,0,Toronto Blue Jays,0,0,May 23 2019,0
Miami Marlins,0,Detroit Tigers,0,0,May 23 2019,0
Philadelphia Phillies,0,Chicago Cubs,0,0,May 23 2019,0
Atlanta Braves,0,San Francisco Giants,0,0,May 23 2019,0
Tampa Bay Rays,0,Cleveland Indians,0,0,May 23 2019,0
Chicago White Sox,0,Houston Astros,0,0,May 23 2019,0
Cincinnati Reds,0,Chicago Cubs,0,0,May 24 2019,0
Miami Marlins,0,Washington Nationals,0,0,May 24 2019,0
Los Angeles Dodgers,0,Pittsburgh Pirates,0,0,May 24 2019,0
San Diego Padres,0,Toronto Blue Jays,0,0,May 24 2019,0
Tampa Bay Rays,0,Cleveland Indians,0,0,May 24 2019,0
Detroit Tigers,0,New York Mets,0,0,May 24 2019,0
Chicago White Sox,0,Minnesota Twins,0,0,May 24 2019,0
Philadelphia Phillies,0,Milwaukee Brewers,0,0,May 24 2019,0
Boston Red Sox,0,Houston Astros,0,0,May 24 2019,0
New York Yankees,0,Kansas City Royals,0,0,May 24 2019,0
Atlanta Braves,0,St. Louis Cardinals,0,0,May 24 2019,0
Baltimore Orioles,0,Colorado Rockies,0,0,May 24 2019,0
Seattle Mariners,0,Oakland Athletics,0,0,May 24 2019,0
Texas Rangers,0,Los Angeles Angels,0,0,May 24 2019,0
Arizona D'Backs,0,San Francisco Giants,0,0,May 24 2019,0
Chicago White Sox,0,Minnesota Twins,0,0,May 25 2019,0
New York Yankees,0,Kansas City Royals,0,0,May 25 2019,0
Cincinnati Reds,0,Chicago Cubs,0,0,May 25 2019,0
San Diego Padres,0,Toronto Blue Jays,0,0,May 25 2019,0
Arizona D'Backs,0,San Francisco Giants,0,0,May 25 2019,0
Miami Marlins,0,Washington Nationals,0,0,May 25 2019,0
Seattle Mariners,0,Oakland Athletics,0,0,May 25 2019,0
Philadelphia Phillies,0,Milwaukee Brewers,0,0,May 25 2019,0
Detroit Tigers,0,New York Mets,0,0,May 25 2019,0
Tampa Bay Rays,0,Cleveland Indians,0,0,May 25 2019,0
Boston Red Sox,0,Houston Astros,0,0,May 25 2019,0
Los Angeles Dodgers,0,Pittsburgh Pirates,0,0,May 25 2019,0
Atlanta Braves,0,St. Louis Cardinals,0,0,May 25 2019,0
Baltimore Orioles,0,Colorado Rockies,0,0,May 25 2019,0
Texas Rangers,0,Los Angeles Angels,0,0,May 25 2019,0
San Diego Padres,0,Toronto Blue Jays,0,0,May 26 2019,0
Tampa Bay Rays,0,Cleveland Indians,0,0,May 26 2019,0
Detroit Tigers,0,New York Mets,0,0,May 26 2019,0
Miami Marlins,0,Washington Nationals,0,0,May 26 2019,0
Los Angeles Dodgers,0,Pittsburgh Pirates,0,0,May 26 2019,0
Chicago White Sox,0,Minnesota Twins,0,0,May 26 2019,0
Philadelphia Phillies,0,Milwaukee Brewers,0,0,May 26 2019,0
Boston Red Sox,0,Houston Astros,0,0,May 26 2019,0
New York Yankees,0,Kansas City Royals,0,0,May 26 2019,0
Cincinnati Reds,0,Chicago Cubs,0,0,May 26 2019,0
Baltimore Orioles,0,Colorado Rockies,0,0,May 26 2019,0
Arizona D'Backs,0,San Francisco Giants,0,0,May 26 2019,0
Seattle Mariners,0,Oakland Athletics,0,0,May 26 2019,0
Texas Rangers,0,Los Angeles Angels,0,0,May 26 2019,0
Atlanta Braves,0,St. Louis Cardinals,0,0,May 26 2019,0
Detroit Tigers,0,Baltimore Orioles,0,0,May 27 2019,0
San Diego Padres,0,New York Yankees,0,0,May 27 2019,0
Miami Marlins,0,Washington Nationals,0,0,May 27 2019,0
Pittsburgh Pirates,0,Cincinnati Reds,0,0,May 27 2019,0
Toronto Blue Jays,0,Tampa Bay Rays,0,0,May 27 2019,0
Chicago Cubs,0,Houston Astros,0,0,May 27 2019,0
Kansas City Royals,0,Chicago White Sox,0,0,May 27 2019,0
Arizona D'Backs,0,Colorado Rockies,0,0,May 27 2019,0
Cleveland Indians,0,Boston Red Sox,0,0,May 27 2019,0
Los Angeles Angels,0,Oakland Athletics,0,0,May 27 2019,0
Milwaukee Brewers,0,Minnesota Twins,0,0,May 27 2019,0
Pittsburgh Pirates,0,Cincinnati Reds,0,0,May 27 2019,0
New York Mets,0,Los Angeles Dodgers,0,0,May 27 2019,0
Texas Rangers,0,Seattle Mariners,0,0,May 27 2019,0
San Diego Padres,0,New York Yankees,0,0,May 28 2019,0
Pittsburgh Pirates,0,Cincinnati Reds,0,0,May 28 2019,0
Detroit Tigers,0,Baltimore Orioles,0,0,May 28 2019,0
St. Louis Cardinals,0,Philadelphia Phillies,0,0,May 28 2019,0
Toronto Blue Jays,0,Tampa Bay Rays,0,0,May 28 2019,0
Cleveland Indians,0,Boston Red Sox,0,0,May 28 2019,0
San Francisco Giants,0,Miami Marlins,0,0,May 28 2019,0
Washington Nationals,0,Atlanta Braves,0,0,May 28 2019,0
Chicago Cubs,0,Houston Astros,0,0,May 28 2019,0
Milwaukee Brewers,0,Minnesota Twins,0,0,May 28 2019,0
Kansas City Royals,0,Chicago White Sox,0,0,May 28 2019,0
Arizona D'Backs,0,Colorado Rockies,0,0,May 28 2019,0
Los Angeles Angels,0,Oakland Athletics,0,0,May 28 2019,0
Texas Rangers,0,Seattle Mariners,0,0,May 28 2019,0
New York Mets,0,Los Angeles Dodgers,0,0,May 28 2019,0
Pittsburgh Pirates,0,Cincinnati Reds,0,0,May 29 2019,0
San Diego Padres,0,New York Yankees,0,0,May 29 2019,0
Los Angeles Angels,0,Oakland Athletics,0,0,May 29 2019,0
Texas Rangers,0,Seattle Mariners,0,0,May 29 2019,0
Detroit Tigers,0,Baltimore Orioles,0,0,May 29 2019,0
St. Louis Cardinals,0,Philadelphia Phillies,0,0,May 29 2019,0
Toronto Blue Jays,0,Tampa Bay Rays,0,0,May 29 2019,0
Cleveland Indians,0,Boston Red Sox,0,0,May 29 2019,0
San Francisco Giants,0,Miami Marlins,0,0,May 29 2019,0
Washington Nationals,0,Atlanta Braves,0,0,May 29 2019,0
Chicago Cubs,0,Houston Astros,0,0,May 29 2019,0
Kansas City Royals,0,Chicago White Sox,0,0,May 29 2019,0
Arizona D'Backs,0,Colorado Rockies,0,0,May 29 2019,0
New York Mets,0,Los Angeles Dodgers,0,0,May 29 2019,0
St. Louis Cardinals,0,Philadelphia Phillies,0,0,May 30 2019,0
San Francisco Giants,0,Miami Marlins,0,0,May 30 2019,0
Arizona D'Backs,0,Colorado Rockies,0,0,May 30 2019,0
Boston Red Sox,0,New York Yankees,0,0,May 30 2019,0
Milwaukee Brewers,0,Pittsburgh Pirates,0,0,May 30 2019,0
Minnesota Twins,0,Tampa Bay Rays,0,0,May 30 2019,0
Kansas City Royals,0,Texas Rangers,0,0,May 30 2019,0
Cleveland Indians,0,Chicago White Sox,0,0,May 30 2019,0
Los Angeles Angels,0,Seattle Mariners,0,0,May 30 2019,0
New York Mets,0,Los Angeles Dodgers,0,0,May 30 2019,0
Boston Red Sox,0,New York Yankees,0,0,May 31 2019,0
San Francisco Giants,0,Baltimore Orioles,0,0,May 31 2019,0
Milwaukee Brewers,0,Pittsburgh Pirates,0,0,May 31 2019,0
Minnesota Twins,0,Tampa Bay Rays,0,0,May 31 2019,0
Washington Nationals,0,Cincinnati Reds,0,0,May 31 2019,0
Detroit Tigers,0,Atlanta Braves,0,0,May 31 2019,0
Kansas City Royals,0,Texas Rangers,0,0,May 31 2019,0
Cleveland Indians,0,Chicago White Sox,0,0,May 31 2019,0
Chicago Cubs,0,St. Louis Cardinals,0,0,May 31 2019,0
Toronto Blue Jays,0,Colorado Rockies,0,0,May 31 2019,0
New York Mets,0,Arizona D'Backs,0,0,May 31 2019,0
Houston Astros,0,Oakland Athletics,0,0,May 31 2019,0
Philadelphia Phillies,0,Los Angeles Dodgers,0,0,May 31 2019,0
Miami Marlins,0,San Diego Padres,0,0,May 31 2019,0
Los Angeles Angels,0,Seattle Mariners,0,0,May 31 2019,0
Minnesota Twins,0,Tampa Bay Rays,0,0,June 1 2019,0
Cleveland Indians,0,Chicago White Sox,0,0,June 1 2019,0
Kansas City Royals,0,Texas Rangers,0,0,June 1 2019,0
San Francisco Giants,0,Baltimore Orioles,0,0,June 1 2019,0
Milwaukee Brewers,0,Pittsburgh Pirates,0,0,June 1 2019,0
Detroit Tigers,0,Atlanta Braves,0,0,June 1 2019,0
Washington Nationals,0,Cincinnati Reds,0,0,June 1 2019,0
Chicago Cubs,0,St. Louis Cardinals,0,0,June 1 2019,0
Los Angeles Angels,0,Seattle Mariners,0,0,June 1 2019,0
Boston Red Sox,0,New York Yankees,0,0,June 1 2019,0
Toronto Blue Jays,0,Colorado Rockies,0,0,June 1 2019,0
Houston Astros,0,Oakland Athletics,0,0,June 1 2019,0
Miami Marlins,0,San Diego Padres,0,0,June 1 2019,0
Philadelphia Phillies,0,Los Angeles Dodgers,0,0,June 1 2019,0
New York Mets,0,Arizona D'Backs,0,0,June 1 2019,0
San Francisco Giants,0,Baltimore Orioles,0,0,June 2 2019,0
Washington Nationals,0,Cincinnati Reds,0,0,June 2 2019,0
Minnesota Twins,0,Tampa Bay Rays,0,0,June 2 2019,0
Detroit Tigers,0,Atlanta Braves,0,0,June 2 2019,0
Milwaukee Brewers,0,Pittsburgh Pirates,0,0,June 2 2019,0
Cleveland Indians,0,Chicago White Sox,0,0,June 2 2019,0
Chicago Cubs,0,St. Louis Cardinals,0,0,June 2 2019,0
Kansas City Royals,0,Texas Rangers,0,0,June 2 2019,0
Toronto Blue Jays,0,Colorado Rockies,0,0,June 2 2019,0
Houston Astros,0,Oakland Athletics,0,0,June 2 2019,0
Los Angeles Angels,0,Seattle Mariners,0,0,June 2 2019,0
New York Mets,0,Arizona D'Backs,0,0,June 2 2019,0
Philadelphia Phillies,0,Los Angeles Dodgers,0,0,June 2 2019,0
Miami Marlins,0,San Diego Padres,0,0,June 2 2019,0
Boston Red Sox,0,New York Yankees,0,0,June 2 2019,0
Los Angeles Angels,0,Chicago Cubs,0,0,June 3 2019,0
Los Angeles Dodgers,0,Arizona D'Backs,0,0,June 3 2019,0
Philadelphia Phillies,0,San Diego Padres,0,0,June 3 2019,0
Houston Astros,0,Seattle Mariners,0,0,June 3 2019,0
Chicago White Sox,0,Washington Nationals,0,0,June 4 2019,0
Atlanta Braves,0,Pittsburgh Pirates,0,0,June 4 2019,0
New York Yankees,0,Toronto Blue Jays,0,0,June 4 2019,0
San Francisco Giants,0,New York Mets,0,0,June 4 2019,0
Tampa Bay Rays,0,Detroit Tigers,0,0,June 4 2019,0
Minnesota Twins,0,Cleveland Indians,0,0,June 4 2019,0
Miami Marlins,0,Milwaukee Brewers,0,0,June 4 2019,0
Colorado Rockies,0,Chicago Cubs,0,0,June 4 2019,0
Baltimore Orioles,0,Texas Rangers,0,0,June 4 2019,0
Boston Red Sox,0,Kansas City Royals,0,0,June 4 2019,0
Cincinnati Reds,0,St. Louis Cardinals,0,0,June 4 2019,0
Los Angeles Dodgers,0,Arizona D'Backs,0,0,June 4 2019,0
Oakland Athletics,0,Los Angeles Angels,0,0,June 4 2019,0
Philadelphia Phillies,0,San Diego Padres,0,0,June 4 2019,0
Houston Astros,0,Seattle Mariners,0,0,June 4 2019,0
Chicago White Sox,0,Washington Nationals,0,0,June 5 2019,0
Los Angeles Dodgers,0,Arizona D'Backs,0,0,June 5 2019,0
Philadelphia Phillies,0,San Diego Padres,0,0,June 5 2019,0
Atlanta Braves,0,Pittsburgh Pirates,0,0,June 5 2019,0
New York Yankees,0,Toronto Blue Jays,0,0,June 5 2019,0
San Francisco Giants,0,New York Mets,0,0,June 5 2019,0
Tampa Bay Rays,0,Detroit Tigers,0,0,June 5 2019,0
Minnesota Twins,0,Cleveland Indians,0,0,June 5 2019,0
Miami Marlins,0,Milwaukee Brewers,0,0,June 5 2019,0
Baltimore Orioles,0,Texas Rangers,0,0,June 5 2019,0
Colorado Rockies,0,Chicago Cubs,0,0,June 5 2019,0
Boston Red Sox,0,Kansas City Royals,0,0,June 5 2019,0
Cincinnati Reds,0,St. Louis Cardinals,0,0,June 5 2019,0
Oakland Athletics,0,Los Angeles Angels,0,0,June 5 2019,0
Houston Astros,0,Seattle Mariners,0,0,June 5 2019,0
San Francisco Giants,0,New York Mets,0,0,June 6 2019,0
Atlanta Braves,0,Pittsburgh Pirates,0,0,June 6 2019,0
Tampa Bay Rays,0,Detroit Tigers,0,0,June 6 2019,0
Cincinnati Reds,0,St. Louis Cardinals,0,0,June 6 2019,0
Boston Red Sox,0,Kansas City Royals,0,0,June 6 2019,0
Miami Marlins,0,Milwaukee Brewers,0,0,June 6 2019,0
Colorado Rockies,0,Chicago Cubs,0,0,June 6 2019,0
Houston Astros,0,Seattle Mariners,0,0,June 6 2019,0
New York Yankees,0,Toronto Blue Jays,0,0,June 6 2019,0
Minnesota Twins,0,Cleveland Indians,0,0,June 6 2019,0
Baltimore Orioles,0,Texas Rangers,0,0,June 6 2019,0
Oakland Athletics,0,Los Angeles Angels,0,0,June 6 2019,0
Washington Nationals,0,San Diego Padres,0,0,June 6 2019,0
St. Louis Cardinals,0,Chicago Cubs,0,0,June 7 2019,0
Cincinnati Reds,0,Philadelphia Phillies,0,0,June 7 2019,0
Arizona D'Backs,0,Toronto Blue Jays,0,0,June 7 2019,0
Colorado Rockies,0,New York Mets,0,0,June 7 2019,0
Atlanta Braves,0,Miami Marlins,0,0,June 7 2019,0
Tampa Bay Rays,0,Boston Red Sox,0,0,June 7 2019,0
Minnesota Twins,0,Detroit Tigers,0,0,June 7 2019,0
New York Yankees,0,Cleveland Indians,0,0,June 7 2019,0
Oakland Athletics,0,Texas Rangers,0,0,June 7 2019,0
Baltimore Orioles,0,Houston Astros,0,0,June 7 2019,0
Pittsburgh Pirates,0,Milwaukee Brewers,0,0,June 7 2019,0
Chicago White Sox,0,Kansas City Royals,0,0,June 7 2019,0
Seattle Mariners,0,Los Angeles Angels,0,0,June 7 2019,0
Washington Nationals,0,San Diego Padres,0,0,June 7 2019,0
Los Angeles Dodgers,0,San Francisco Giants,0,0,June 7 2019,0
Tampa Bay Rays,0,Boston Red Sox,0,0,June 8 2019,0
Oakland Athletics,0,Texas Rangers,0,0,June 8 2019,0
Chicago White Sox,0,Kansas City Royals,0,0,June 8 2019,0
Arizona D'Backs,0,Toronto Blue Jays,0,0,June 8 2019,0
Cincinnati Reds,0,Philadelphia Phillies,0,0,June 8 2019,0
Pittsburgh Pirates,0,Milwaukee Brewers,0,0,June 8 2019,0
Atlanta Braves,0,Miami Marlins,0,0,June 8 2019,0
Baltimore Orioles,0,Houston Astros,0,0,June 8 2019,0
Minnesota Twins,0,Detroit Tigers,0,0,June 8 2019,0
New York Yankees,0,Cleveland Indians,0,0,June 8 2019,0
Tampa Bay Rays,0,Boston Red Sox,0,0,June 8 2019,0
Colorado Rockies,0,New York Mets,0,0,June 8 2019,0
St. Louis Cardinals,0,Chicago Cubs,0,0,June 8 2019,0
Los Angeles Dodgers,0,San Francisco Giants,0,0,June 8 2019,0
Oakland Athletics,0,Texas Rangers,0,0,June 8 2019,0
Seattle Mariners,0,Los Angeles Angels,0,0,June 8 2019,0
Washington Nationals,0,San Diego Padres,0,0,June 8 2019,0
Tampa Bay Rays,0,Boston Red Sox,0,0,June 9 2019,0
Cincinnati Reds,0,Philadelphia Phillies,0,0,June 9 2019,0
Arizona D'Backs,0,Toronto Blue Jays,0,0,June 9 2019,0
Colorado Rockies,0,New York Mets,0,0,June 9 2019,0
Atlanta Braves,0,Miami Marlins,0,0,June 9 2019,0
Minnesota Twins,0,Detroit Tigers,0,0,June 9 2019,0
New York Yankees,0,Cleveland Indians,0,0,June 9 2019,0
Baltimore Orioles,0,Houston Astros,0,0,June 9 2019,0
Pittsburgh Pirates,0,Milwaukee Brewers,0,0,June 9 2019,0
Chicago White Sox,0,Kansas City Royals,0,0,June 9 2019,0
St. Louis Cardinals,0,Chicago Cubs,0,0,June 9 2019,0
Oakland Athletics,0,Texas Rangers,0,0,June 9 2019,0
Los Angeles Dodgers,0,San Francisco Giants,0,0,June 9 2019,0
Seattle Mariners,0,Los Angeles Angels,0,0,June 9 2019,0
Washington Nationals,0,San Diego Padres,0,0,June 9 2019,0
New York Mets,0,New York Yankees,0,0,June 10 2019,0
Arizona D'Backs,0,Philadelphia Phillies,0,0,June 10 2019,0
Texas Rangers,0,Boston Red Sox,0,0,June 10 2019,0
St. Louis Cardinals,0,Miami Marlins,0,0,June 10 2019,0
Oakland Athletics,0,Tampa Bay Rays,0,0,June 10 2019,0
Pittsburgh Pirates,0,Atlanta Braves,0,0,June 10 2019,0
Washington Nationals,0,Chicago White Sox,0,0,June 10 2019,0
Chicago Cubs,0,Colorado Rockies,0,0,June 10 2019,0
Los Angeles Dodgers,0,Los Angeles Angels,0,0,June 10 2019,0
Toronto Blue Jays,0,Baltimore Orioles,0,0,June 11 2019,0
Arizona D'Backs,0,Philadelphia Phillies,0,0,June 11 2019,0
New York Mets,0,New York Yankees,0,0,June 11 2019,0
Oakland Athletics,0,Tampa Bay Rays,0,0,June 11 2019,0
Texas Rangers,0,Boston Red Sox,0,0,June 11 2019,0
Cincinnati Reds,0,Cleveland Indians,0,0,June 11 2019,0
St. Louis Cardinals,0,Miami Marlins,0,0,June 11 2019,0
Pittsburgh Pirates,0,Atlanta Braves,0,0,June 11 2019,0
Seattle Mariners,0,Minnesota Twins,0,0,June 11 2019,0
Milwaukee Brewers,0,Houston Astros,0,0,June 11 2019,0
Washington Nationals,0,Chicago White Sox,0,0,June 11 2019,0
Detroit Tigers,0,Kansas City Royals,0,0,June 11 2019,0
Chicago Cubs,0,Colorado Rockies,0,0,June 11 2019,0
San Diego Padres,0,San Francisco Giants,0,0,June 11 2019,0
Los Angeles Dodgers,0,Los Angeles Angels,0,0,June 11 2019,0
Oakland Athletics,0,Tampa Bay Rays,0,0,June 12 2019,0
Cincinnati Reds,0,Cleveland Indians,0,0,June 12 2019,0
Chicago Cubs,0,Colorado Rockies,0,0,June 12 2019,0
Toronto Blue Jays,0,Baltimore Orioles,0,0,June 12 2019,0
Arizona D'Backs,0,Philadelphia Phillies,0,0,June 12 2019,0
Texas Rangers,0,Boston Red Sox,0,0,June 12 2019,0
St. Louis Cardinals,0,Miami Marlins,0,0,June 12 2019,0
Pittsburgh Pirates,0,Atlanta Braves,0,0,June 12 2019,0
Seattle Mariners,0,Minnesota Twins,0,0,June 12 2019,0
Milwaukee Brewers,0,Houston Astros,0,0,June 12 2019,0
Detroit Tigers,0,Kansas City Royals,0,0,June 12 2019,0
San Diego Padres,0,San Francisco Giants,0,0,June 12 2019,0
Pittsburgh Pirates,0,Atlanta Braves,0,0,June 13 2019,0
Seattle Mariners,0,Minnesota Twins,0,0,June 13 2019,0
Arizona D'Backs,0,Washington Nationals,0,0,June 13 2019,0
Toronto Blue Jays,0,Baltimore Orioles,0,0,June 13 2019,0
Texas Rangers,0,Boston Red Sox,0,0,June 13 2019,0
St. Louis Cardinals,0,New York Mets,0,0,June 13 2019,0
Los Angeles Angels,0,Tampa Bay Rays,0,0,June 13 2019,0
Detroit Tigers,0,Kansas City Royals,0,0,June 13 2019,0
New York Yankees,0,Chicago White Sox,0,0,June 13 2019,0
San Diego Padres,0,Colorado Rockies,0,0,June 13 2019,0
Chicago Cubs,0,Los Angeles Dodgers,0,0,June 13 2019,0
Arizona D'Backs,0,Washington Nationals,0,0,June 14 2019,0
Boston Red Sox,0,Baltimore Orioles,0,0,June 14 2019,0
Los Angeles Angels,0,Tampa Bay Rays,0,0,June 14 2019,0
Texas Rangers,0,Cincinnati Reds,0,0,June 14 2019,0
St. Louis Cardinals,0,New York Mets,0,0,June 14 2019,0
Cleveland Indians,0,Detroit Tigers,0,0,June 14 2019,0
Pittsburgh Pirates,0,Miami Marlins,0,0,June 14 2019,0
Philadelphia Phillies,0,Atlanta Braves,0,0,June 14 2019,0
Toronto Blue Jays,0,Houston Astros,0,0,June 14 2019,0
Kansas City Royals,0,Minnesota Twins,0,0,June 14 2019,0
New York Yankees,0,Chicago White Sox,0,0,June 14 2019,0
San Diego Padres,0,Colorado Rockies,0,0,June 14 2019,0
Seattle Mariners,0,Oakland Athletics,0,0,June 14 2019,0
Chicago Cubs,0,Los Angeles Dodgers,0,0,June 14 2019,0
Milwaukee Brewers,0,San Francisco Giants,0,0,June 14 2019,0
Los Angeles Angels,0,Tampa Bay Rays,0,0,June 15 2019,0
Arizona D'Backs,0,Washington Nationals,0,0,June 15 2019,0
Boston Red Sox,0,Baltimore Orioles,0,0,June 15 2019,0
Milwaukee Brewers,0,San Francisco Giants,0,0,June 15 2019,0
Toronto Blue Jays,0,Houston Astros,0,0,June 15 2019,0
Pittsburgh Pirates,0,Miami Marlins,0,0,June 15 2019,0
Cleveland Indians,0,Detroit Tigers,0,0,June 15 2019,0
Texas Rangers,0,Cincinnati Reds,0,0,June 15 2019,0
New York Yankees,0,Chicago White Sox,0,0,June 15 2019,0
Kansas City Royals,0,Minnesota Twins,0,0,June 15 2019,0
St. Louis Cardinals,0,New York Mets,0,0,June 15 2019,0
Philadelphia Phillies,0,Atlanta Braves,0,0,June 15 2019,0
San Diego Padres,0,Colorado Rockies,0,0,June 15 2019,0
Seattle Mariners,0,Oakland Athletics,0,0,June 15 2019,0
Chicago Cubs,0,Los Angeles Dodgers,0,0,June 15 2019,0
Boston Red Sox,0,Baltimore Orioles,0,0,June 16 2019,0
Los Angeles Angels,0,Tampa Bay Rays,0,0,June 16 2019,0
Texas Rangers,0,Cincinnati Reds,0,0,June 16 2019,0
St. Louis Cardinals,0,New York Mets,0,0,June 16 2019,0
Cleveland Indians,0,Detroit Tigers,0,0,June 16 2019,0
Pittsburgh Pirates,0,Miami Marlins,0,0,June 16 2019,0
Philadelphia Phillies,0,Atlanta Braves,0,0,June 16 2019,0
Arizona D'Backs,0,Washington Nationals,0,0,June 16 2019,0
Toronto Blue Jays,0,Houston Astros,0,0,June 16 2019,0
Kansas City Royals,0,Minnesota Twins,0,0,June 16 2019,0
New York Yankees,0,Chicago White Sox,0,0,June 16 2019,0
San Diego Padres,0,Colorado Rockies,0,0,June 16 2019,0
Milwaukee Brewers,0,San Francisco Giants,0,0,June 16 2019,0
Seattle Mariners,0,Oakland Athletics,0,0,June 16 2019,0
Chicago Cubs,0,Los Angeles Dodgers,0,0,June 16 2019,0
Philadelphia Phillies,0,Washington Nationals,0,0,June 17 2019,0
Tampa Bay Rays,0,New York Yankees,0,0,June 17 2019,0
Los Angeles Angels,0,Toronto Blue Jays,0,0,June 17 2019,0
Houston Astros,0,Cincinnati Reds,0,0,June 17 2019,0
New York Mets,0,Atlanta Braves,0,0,June 17 2019,0
Cleveland Indians,0,Texas Rangers,0,0,June 17 2019,0
Boston Red Sox,0,Minnesota Twins,0,0,June 17 2019,0
Miami Marlins,0,St. Louis Cardinals,0,0,June 17 2019,0
Baltimore Orioles,0,Oakland Athletics,0,0,June 17 2019,0
Kansas City Royals,0,Seattle Mariners,0,0,June 17 2019,0
San Francisco Giants,0,Los Angeles Dodgers,0,0,June 17 2019,0
Milwaukee Brewers,0,San Diego Padres,0,0,June 17 2019,0
Philadelphia Phillies,0,Washington Nationals,0,0,June 18 2019,0
Detroit Tigers,0,Pittsburgh Pirates,0,0,June 18 2019,0
Tampa Bay Rays,0,New York Yankees,0,0,June 18 2019,0
Los Angeles Angels,0,Toronto Blue Jays,0,0,June 18 2019,0
Houston Astros,0,Cincinnati Reds,0,0,June 18 2019,0
New York Mets,0,Atlanta Braves,0,0,June 18 2019,0
Chicago White Sox,0,Chicago Cubs,0,0,June 18 2019,0
Cleveland Indians,0,Texas Rangers,0,0,June 18 2019,0
Boston Red Sox,0,Minnesota Twins,0,0,June 18 2019,0
Miami Marlins,0,St. Louis Cardinals,0,0,June 18 2019,0
Colorado Rockies,0,Arizona D'Backs,0,0,June 18 2019,0
Baltimore Orioles,0,Oakland Athletics,0,0,June 18 2019,0
Kansas City Royals,0,Seattle Mariners,0,0,June 18 2019,0
Milwaukee Brewers,0,San Diego Padres,0,0,June 18 2019,0
San Francisco Giants,0,Los Angeles Dodgers,0,0,June 18 2019,0
Houston Astros,0,Cincinnati Reds,0,0,June 19 2019,0
Tampa Bay Rays,0,New York Yankees,0,0,June 19 2019,0
Baltimore Orioles,0,Oakland Athletics,0,0,June 19 2019,0
Milwaukee Brewers,0,San Diego Padres,0,0,June 19 2019,0
Kansas City Royals,0,Seattle Mariners,0,0,June 19 2019,0
Detroit Tigers,0,Pittsburgh Pirates,0,0,June 19 2019,0
Philadelphia Phillies,0,Washington Nationals,0,0,June 19 2019,0
Los Angeles Angels,0,Toronto Blue Jays,0,0,June 19 2019,0
New York Mets,0,Atlanta Braves,0,0,June 19 2019,0
Chicago White Sox,0,Chicago Cubs,0,0,June 19 2019,0
Cleveland Indians,0,Texas Rangers,0,0,June 19 2019,0
Boston Red Sox,0,Minnesota Twins,0,0,June 19 2019,0
Miami Marlins,0,St. Louis Cardinals,0,0,June 19 2019,0
Colorado Rockies,0,Arizona D'Backs,0,0,June 19 2019,0
San Francisco Giants,0,Los Angeles Dodgers,0,0,June 19 2019,0
Cleveland Indians,0,Texas Rangers,0,0,June 20 2019,0
Colorado Rockies,0,Arizona D'Backs,0,0,June 20 2019,0
Philadelphia Phillies,0,Washington Nationals,0,0,June 20 2019,0
Houston Astros,0,New York Yankees,0,0,June 20 2019,0
Los Angeles Angels,0,Toronto Blue Jays,0,0,June 20 2019,0
Miami Marlins,0,St. Louis Cardinals,0,0,June 20 2019,0
New York Mets,0,Chicago Cubs,0,0,June 20 2019,0
Cincinnati Reds,0,Milwaukee Brewers,0,0,June 20 2019,0
Minnesota Twins,0,Kansas City Royals,0,0,June 20 2019,0
Tampa Bay Rays,0,Oakland Athletics,0,0,June 20 2019,0
San Francisco Giants,0,Los Angeles Dodgers,0,0,June 20 2019,0
Baltimore Orioles,0,Seattle Mariners,0,0,June 20 2019,0
New York Mets,0,Chicago Cubs,0,0,June 21 2019,0
Atlanta Braves,0,Washington Nationals,0,0,June 21 2019,0
San Diego Padres,0,Pittsburgh Pirates,0,0,June 21 2019,0
Miami Marlins,0,Philadelphia Phillies,0,0,June 21 2019,0
Houston Astros,0,New York Yankees,0,0,June 21 2019,0
Toronto Blue Jays,0,Boston Red Sox,0,0,June 21 2019,0
Detroit Tigers,0,Cleveland Indians,0,0,June 21 2019,0
Chicago White Sox,0,Texas Rangers,0,0,June 21 2019,0
Cincinnati Reds,0,Milwaukee Brewers,0,0,June 21 2019,0
Minnesota Twins,0,Kansas City Royals,0,0,June 21 2019,0
Los Angeles Angels,0,St. Louis Cardinals,0,0,June 21 2019,0
San Francisco Giants,0,Arizona D'Backs,0,0,June 21 2019,0
Tampa Bay Rays,0,Oakland Athletics,0,0,June 21 2019,0
Baltimore Orioles,0,Seattle Mariners,0,0,June 21 2019,0
Colorado Rockies,0,Los Angeles Dodgers,0,0,June 21 2019,0
Los Angeles Angels,0,St. Louis Cardinals,0,0,June 22 2019,0
Minnesota Twins,0,Kansas City Royals,0,0,June 22 2019,0
New York Mets,0,Chicago Cubs,0,0,June 22 2019,0
Miami Marlins,0,Philadelphia Phillies,0,0,June 22 2019,0
San Diego Padres,0,Pittsburgh Pirates,0,0,June 22 2019,0
Toronto Blue Jays,0,Boston Red Sox,0,0,June 22 2019,0
Tampa Bay Rays,0,Oakland Athletics,0,0,June 22 2019,0
Detroit Tigers,0,Cleveland Indians,0,0,June 22 2019,0
Cincinnati Reds,0,Milwaukee Brewers,0,0,June 22 2019,0
Baltimore Orioles,0,Seattle Mariners,0,0,June 22 2019,0
Atlanta Braves,0,Washington Nationals,0,0,June 22 2019,0
Houston Astros,0,New York Yankees,0,0,June 22 2019,0
Colorado Rockies,0,Los Angeles Dodgers,0,0,June 22 2019,0
Chicago White Sox,0,Texas Rangers,0,0,June 22 2019,0
San Francisco Giants,0,Arizona D'Backs,0,0,June 22 2019,0
Toronto Blue Jays,0,Boston Red Sox,0,0,June 23 2019,0
Miami Marlins,0,Philadelphia Phillies,0,0,June 23 2019,0
Detroit Tigers,0,Cleveland Indians,0,0,June 23 2019,0
Atlanta Braves,0,Washington Nationals,0,0,June 23 2019,0
San Diego Padres,0,Pittsburgh Pirates,0,0,June 23 2019,0
Houston Astros,0,New York Yankees,0,0,June 23 2019,0
Cincinnati Reds,0,Milwaukee Brewers,0,0,June 23 2019,0
Minnesota Twins,0,Kansas City Royals,0,0,June 23 2019,0
Los Angeles Angels,0,St. Louis Cardinals,0,0,June 23 2019,0
New York Mets,0,Chicago Cubs,0,0,June 23 2019,0
Chicago White Sox,0,Texas Rangers,0,0,June 23 2019,0
Tampa Bay Rays,0,Oakland Athletics,0,0,June 23 2019,0
Colorado Rockies,0,Los Angeles Dodgers,0,0,June 23 2019,0
Baltimore Orioles,0,Seattle Mariners,0,0,June 23 2019,0
San Francisco Giants,0,Arizona D'Backs,0,0,June 23 2019,0
Toronto Blue Jays,0,New York Yankees,0,0,June 24 2019,0
New York Mets,0,Philadelphia Phillies,0,0,June 24 2019,0
Chicago White Sox,0,Boston Red Sox,0,0,June 24 2019,0
Kansas City Royals,0,Cleveland Indians,0,0,June 24 2019,0
Atlanta Braves,0,Chicago Cubs,0,0,June 24 2019,0
Los Angeles Dodgers,0,Arizona D'Backs,0,0,June 24 2019,0
Colorado Rockies,0,San Francisco Giants,0,0,June 24 2019,0
New York Mets,0,Philadelphia Phillies,0,0,June 25 2019,0
San Diego Padres,0,Baltimore Orioles,0,0,June 25 2019,0
Toronto Blue Jays,0,New York Yankees,0,0,June 25 2019,0
Kansas City Royals,0,Cleveland Indians,0,0,June 25 2019,0
Chicago White Sox,0,Boston Red Sox,0,0,June 25 2019,0
Texas Rangers,0,Detroit Tigers,0,0,June 25 2019,0
Washington Nationals,0,Miami Marlins,0,0,June 25 2019,0
Atlanta Braves,0,Chicago Cubs,0,0,June 25 2019,0
Seattle Mariners,0,Milwaukee Brewers,0,0,June 25 2019,0
Pittsburgh Pirates,0,Houston Astros,0,0,June 25 2019,0
Tampa Bay Rays,0,Minnesota Twins,0,0,June 25 2019,0
Oakland Athletics,0,St. Louis Cardinals,0,0,June 25 2019,0
Los Angeles Dodgers,0,Arizona D'Backs,0,0,June 25 2019,0
Colorado Rockies,0,San Francisco Giants,0,0,June 25 2019,0
Cincinnati Reds,0,Los Angeles Angels,0,0,June 25 2019,0
Toronto Blue Jays,0,New York Yankees,0,0,June 26 2019,0
Chicago White Sox,0,Boston Red Sox,0,0,June 26 2019,0
Kansas City Royals,0,Cleveland Indians,0,0,June 26 2019,0
San Diego Padres,0,Baltimore Orioles,0,0,June 26 2019,0
Los Angeles Dodgers,0,Arizona D'Backs,0,0,June 26 2019,0
Colorado Rockies,0,San Francisco Giants,0,0,June 26 2019,0
New York Mets,0,Philadelphia Phillies,0,0,June 26 2019,0
Texas Rangers,0,Detroit Tigers,0,0,June 26 2019,0
Washington Nationals,0,Miami Marlins,0,0,June 26 2019,0
Oakland Athletics,0,St. Louis Cardinals,0,0,June 26 2019,0
Atlanta Braves,0,Chicago Cubs,0,0,June 26 2019,0
Cincinnati Reds,0,Los Angeles Angels,0,0,June 26 2019,0
Tampa Bay Rays,0,Minnesota Twins,0,0,June 26 2019,0
Seattle Mariners,0,Milwaukee Brewers,0,0,June 26 2019,0
Pittsburgh Pirates,0,Houston Astros,0,0,June 26 2019,0
New York Mets,0,Philadelphia Phillies,0,0,June 27 2019,0
Texas Rangers,0,Detroit Tigers,0,0,June 27 2019,0
Tampa Bay Rays,0,Minnesota Twins,0,0,June 27 2019,0
Pittsburgh Pirates,0,Houston Astros,0,0,June 27 2019,0
Seattle Mariners,0,Milwaukee Brewers,0,0,June 27 2019,0
Atlanta Braves,0,Chicago Cubs,0,0,June 27 2019,0
Washington Nationals,0,Miami Marlins,0,0,June 27 2019,0
Los Angeles Dodgers,0,Colorado Rockies,0,0,June 27 2019,0
Arizona D'Backs,0,San Francisco Giants,0,0,June 27 2019,0
Oakland Athletics,0,Los Angeles Angels,0,0,June 27 2019,0
Cleveland Indians,0,Baltimore Orioles,0,0,June 28 2019,0
Kansas City Royals,0,Toronto Blue Jays,0,0,June 28 2019,0
Texas Rangers,0,Tampa Bay Rays,0,0,June 28 2019,0
Atlanta Braves,0,New York Mets,0,0,June 28 2019,0
Philadelphia Phillies,0,Miami Marlins,0,0,June 28 2019,0
Washington Nationals,0,Detroit Tigers,0,0,June 28 2019,0
Chicago Cubs,0,Cincinnati Reds,0,0,June 28 2019,0
Seattle Mariners,0,Houston Astros,0,0,June 28 2019,0
Pittsburgh Pirates,0,Milwaukee Brewers,0,0,June 28 2019,0
Minnesota Twins,0,Chicago White Sox,0,0,June 28 2019,0
Los Angeles Dodgers,0,Colorado Rockies,0,0,June 28 2019,0
Oakland Athletics,0,Los Angeles Angels,0,0,June 28 2019,0
St. Louis Cardinals,0,San Diego Padres,0,0,June 28 2019,0
Arizona D'Backs,0,San Francisco Giants,0,0,June 28 2019,0
New York Yankees,0,Boston Red Sox,0,0,June 29 2019,0
Cleveland Indians,0,Baltimore Orioles,0,0,June 29 2019,0
Kansas City Royals,0,Toronto Blue Jays,0,0,June 29 2019,0
Chicago Cubs,0,Cincinnati Reds,0,0,June 29 2019,0
Texas Rangers,0,Tampa Bay Rays,0,0,June 29 2019,0
Washington Nationals,0,Detroit Tigers,0,0,June 29 2019,0
Atlanta Braves,0,New York Mets,0,0,June 29 2019,0
Philadelphia Phillies,0,Miami Marlins,0,0,June 29 2019,0
Minnesota Twins,0,Chicago White Sox,0,0,June 29 2019,0
Pittsburgh Pirates,0,Milwaukee Brewers,0,0,June 29 2019,0
Seattle Mariners,0,Houston Astros,0,0,June 29 2019,0
Los Angeles Dodgers,0,Colorado Rockies,0,0,June 29 2019,0
Arizona D'Backs,0,San Francisco Giants,0,0,June 29 2019,0
Oakland Athletics,0,Los Angeles Angels,0,0,June 29 2019,0
St. Louis Cardinals,0,San Diego Padres,0,0,June 29 2019,0
New York Yankees,0,Boston Red Sox,0,0,June 30 2019,0
Cleveland Indians,0,Baltimore Orioles,0,0,June 30 2019,0
Kansas City Royals,0,Toronto Blue Jays,0,0,June 30 2019,0
Texas Rangers,0,Tampa Bay Rays,0,0,June 30 2019,0
Chicago Cubs,0,Cincinnati Reds,0,0,June 30 2019,0
Washington Nationals,0,Detroit Tigers,0,0,June 30 2019,0
Philadelphia Phillies,0,Miami Marlins,0,0,June 30 2019,0
Pittsburgh Pirates,0,Milwaukee Brewers,0,0,June 30 2019,0
Seattle Mariners,0,Houston Astros,0,0,June 30 2019,0
Minnesota Twins,0,Chicago White Sox,0,0,June 30 2019,0
Los Angeles Dodgers,0,Colorado Rockies,0,0,June 30 2019,0
Arizona D'Backs,0,San Francisco Giants,0,0,June 30 2019,0
Oakland Athletics,0,Los Angeles Angels,0,0,June 30 2019,0
St. Louis Cardinals,0,San Diego Padres,0,0,June 30 2019,0
Atlanta Braves,0,New York Mets,0,0,June 30 2019,0
Kansas City Royals,0,Toronto Blue Jays,0,0,July 1 2019,0
Chicago Cubs,0,Pittsburgh Pirates,0,0,July 1 2019,0
Milwaukee Brewers,0,Cincinnati Reds,0,0,July 1 2019,0
Baltimore Orioles,0,Tampa Bay Rays,0,0,July 1 2019,0
Los Angeles Angels,0,Texas Rangers,0,0,July 1 2019,0
San Francisco Giants,0,San Diego Padres,0,0,July 1 2019,0
Miami Marlins,0,Washington Nationals,0,0,July 2 2019,0
Chicago Cubs,0,Pittsburgh Pirates,0,0,July 2 2019,0
Boston Red Sox,0,Toronto Blue Jays,0,0,July 2 2019,0
Milwaukee Brewers,0,Cincinnati Reds,0,0,July 2 2019,0
Baltimore Orioles,0,Tampa Bay Rays,0,0,July 2 2019,0
New York Yankees,0,New York Mets,0,0,July 2 2019,0
Philadelphia Phillies,0,Atlanta Braves,0,0,July 2 2019,0
Los Angeles Angels,0,Texas Rangers,0,0,July 2 2019,0
Houston Astros,0,Colorado Rockies,0,0,July 2 2019,0
Detroit Tigers,0,Chicago White Sox,0,0,July 2 2019,0
Cleveland Indians,0,Kansas City Royals,0,0,July 2 2019,0
Minnesota Twins,0,Oakland Athletics,0,0,July 2 2019,0
Arizona D'Backs,0,Los Angeles Dodgers,0,0,July 2 2019,0
San Francisco Giants,0,San Diego Padres,0,0,July 2 2019,0
St. Louis Cardinals,0,Seattle Mariners,0,0,July 2 2019,0
Detroit Tigers,0,Chicago White Sox,0,0,July 3 2019,0
Miami Marlins,0,Washington Nationals,0,0,July 3 2019,0
Chicago Cubs,0,Pittsburgh Pirates,0,0,July 3 2019,0
Boston Red Sox,0,Toronto Blue Jays,0,0,July 3 2019,0
Milwaukee Brewers,0,Cincinnati Reds,0,0,July 3 2019,0
Baltimore Orioles,0,Tampa Bay Rays,0,0,July 3 2019,0
New York Yankees,0,New York Mets,0,0,July 3 2019,0
Philadelphia Phillies,0,Atlanta Braves,0,0,July 3 2019,0
Los Angeles Angels,0,Texas Rangers,0,0,July 3 2019,0
Houston Astros,0,Colorado Rockies,0,0,July 3 2019,0
Detroit Tigers,0,Chicago White Sox,0,0,July 3 2019,0
Cleveland Indians,0,Kansas City Royals,0,0,July 3 2019,0
Minnesota Twins,0,Oakland Athletics,0,0,July 3 2019,0
San Francisco Giants,0,San Diego Padres,0,0,July 3 2019,0
Arizona D'Backs,0,Los Angeles Dodgers,0,0,July 3 2019,0
St. Louis Cardinals,0,Seattle Mariners,0,0,July 3 2019,0
Miami Marlins,0,Washington Nationals,0,0,July 4 2019,0
Cleveland Indians,0,Kansas City Royals,0,0,July 4 2019,0
Detroit Tigers,0,Chicago White Sox,0,0,July 4 2019,0
Milwaukee Brewers,0,Cincinnati Reds,0,0,July 4 2019,0
Chicago Cubs,0,Pittsburgh Pirates,0,0,July 4 2019,0
Minnesota Twins,0,Oakland Athletics,0,0,July 4 2019,0
St. Louis Cardinals,0,Seattle Mariners,0,0,July 4 2019,0
New York Yankees,0,Tampa Bay Rays,0,0,July 4 2019,0
Boston Red Sox,0,Toronto Blue Jays,0,0,July 4 2019,0
Philadelphia Phillies,0,Atlanta Braves,0,0,July 4 2019,0
Los Angeles Angels,0,Texas Rangers,0,0,July 4 2019,0
San Diego Padres,0,Los Angeles Dodgers,0,0,July 4 2019,0
Kansas City Royals,0,Washington Nationals,0,0,July 5 2019,0
Milwaukee Brewers,0,Pittsburgh Pirates,0,0,July 5 2019,0
Baltimore Orioles,0,Toronto Blue Jays,0,0,July 5 2019,0
New York Yankees,0,Tampa Bay Rays,0,0,July 5 2019,0
Philadelphia Phillies,0,New York Mets,0,0,July 5 2019,0
Boston Red Sox,0,Detroit Tigers,0,0,July 5 2019,0
Miami Marlins,0,Atlanta Braves,0,0,July 5 2019,0
Texas Rangers,0,Minnesota Twins,0,0,July 5 2019,0
Los Angeles Angels,0,Houston Astros,0,0,July 5 2019,0
Colorado Rockies,0,Arizona D'Backs,0,0,July 5 2019,0
San Diego Padres,0,Los Angeles Dodgers,0,0,July 5 2019,0
Oakland Athletics,0,Seattle Mariners,0,0,July 5 2019,0
St. Louis Cardinals,0,San Francisco Giants,0,0,July 5 2019,0
Texas Rangers,0,Minnesota Twins,0,0,July 6 2019,0
Baltimore Orioles,0,Toronto Blue Jays,0,0,July 6 2019,0
Milwaukee Brewers,0,Pittsburgh Pirates,0,0,July 6 2019,0
Kansas City Royals,0,Washington Nationals,0,0,July 6 2019,0
Boston Red Sox,0,Detroit Tigers,0,0,July 6 2019,0
Miami Marlins,0,Atlanta Braves,0,0,July 6 2019,0
New York Yankees,0,Tampa Bay Rays,0,0,July 6 2019,0
Cleveland Indians,0,Cincinnati Reds,0,0,July 6 2019,0
Chicago Cubs,0,Chicago White Sox,0,0,July 6 2019,0
Philadelphia Phillies,0,New York Mets,0,0,July 6 2019,0
Los Angeles Angels,0,Houston Astros,0,0,July 6 2019,0
St. Louis Cardinals,0,San Francisco Giants,0,0,July 6 2019,0
Oakland Athletics,0,Seattle Mariners,0,0,July 6 2019,0
San Diego Padres,0,Los Angeles Dodgers,0,0,July 6 2019,0
Colorado Rockies,0,Arizona D'Backs,0,0,July 6 2019,0
Baltimore Orioles,0,Toronto Blue Jays,0,0,July 7 2019,0
Cleveland Indians,0,Cincinnati Reds,0,0,July 7 2019,0
Boston Red Sox,0,Detroit Tigers,0,0,July 7 2019,0
New York Yankees,0,Tampa Bay Rays,0,0,July 7 2019,0
Philadelphia Phillies,0,New York Mets,0,0,July 7 2019,0
Miami Marlins,0,Atlanta Braves,0,0,July 7 2019,0
Kansas City Royals,0,Washington Nationals,0,0,July 7 2019,0
Milwaukee Brewers,0,Pittsburgh Pirates,0,0,July 7 2019,0
Texas Rangers,0,Minnesota Twins,0,0,July 7 2019,0
Los Angeles Angels,0,Houston Astros,0,0,July 7 2019,0
Chicago Cubs,0,Chicago White Sox,0,0,July 7 2019,0
St. Louis Cardinals,0,San Francisco Giants,0,0,July 7 2019,0
San Diego Padres,0,Los Angeles Dodgers,0,0,July 7 2019,0
Oakland Athletics,0,Seattle Mariners,0,0,July 7 2019,0
Colorado Rockies,0,Arizona D'Backs,0,0,July 7 2019,0
Houston Astros,0,Texas Rangers,0,0,July 11 2019,0
Pittsburgh Pirates,0,Chicago Cubs,0,0,July 12 2019,0
Washington Nationals,0,Philadelphia Phillies,0,0,July 12 2019,0
Tampa Bay Rays,0,Baltimore Orioles,0,0,July 12 2019,0
Toronto Blue Jays,0,New York Yankees,0,0,July 12 2019,0
New York Mets,0,Miami Marlins,0,0,July 12 2019,0
Los Angeles Dodgers,0,Boston Red Sox,0,0,July 12 2019,0
Minnesota Twins,0,Cleveland Indians,0,0,July 12 2019,0
Houston Astros,0,Texas Rangers,0,0,July 12 2019,0
San Francisco Giants,0,Milwaukee Brewers,0,0,July 12 2019,0
Detroit Tigers,0,Kansas City Royals,0,0,July 12 2019,0
Arizona D'Backs,0,St. Louis Cardinals,0,0,July 12 2019,0
Cincinnati Reds,0,Colorado Rockies,0,0,July 12 2019,0
Chicago White Sox,0,Oakland Athletics,0,0,July 12 2019,0
Seattle Mariners,0,Los Angeles Angels,0,0,July 12 2019,0
Atlanta Braves,0,San Diego Padres,0,0,July 12 2019,0
Toronto Blue Jays,0,New York Yankees,0,0,July 13 2019,0
Pittsburgh Pirates,0,Chicago Cubs,0,0,July 13 2019,0
Chicago White Sox,0,Oakland Athletics,0,0,July 13 2019,0
New York Mets,0,Miami Marlins,0,0,July 13 2019,0
Tampa Bay Rays,0,Baltimore Orioles,0,0,July 13 2019,0
Minnesota Twins,0,Cleveland Indians,0,0,July 13 2019,0
Los Angeles Dodgers,0,Boston Red Sox,0,0,July 13 2019,0
Detroit Tigers,0,Kansas City Royals,0,0,July 13 2019,0
Washington Nationals,0,Philadelphia Phillies,0,0,July 13 2019,0
San Francisco Giants,0,Milwaukee Brewers,0,0,July 13 2019,0
Arizona D'Backs,0,St. Louis Cardinals,0,0,July 13 2019,0
Houston Astros,0,Texas Rangers,0,0,July 13 2019,0
Cincinnati Reds,0,Colorado Rockies,0,0,July 13 2019,0
Atlanta Braves,0,San Diego Padres,0,0,July 13 2019,0
Seattle Mariners,0,Los Angeles Angels,0,0,July 13 2019,0
Tampa Bay Rays,0,Baltimore Orioles,0,0,July 14 2019,0
Washington Nationals,0,Philadelphia Phillies,0,0,July 14 2019,0
Toronto Blue Jays,0,New York Yankees,0,0,July 14 2019,0
New York Mets,0,Miami Marlins,0,0,July 14 2019,0
Minnesota Twins,0,Cleveland Indians,0,0,July 14 2019,0
San Francisco Giants,0,Milwaukee Brewers,0,0,July 14 2019,0
Arizona D'Backs,0,St. Louis Cardinals,0,0,July 14 2019,0
Detroit Tigers,0,Kansas City Royals,0,0,July 14 2019,0
Pittsburgh Pirates,0,Chicago Cubs,0,0,July 14 2019,0
Houston Astros,0,Texas Rangers,0,0,July 14 2019,0
Cincinnati Reds,0,Colorado Rockies,0,0,July 14 2019,0
Chicago White Sox,0,Oakland Athletics,0,0,July 14 2019,0
Seattle Mariners,0,Los Angeles Angels,0,0,July 14 2019,0
Atlanta Braves,0,San Diego Padres,0,0,July 14 2019,0
Los Angeles Dodgers,0,Boston Red Sox,0,0,July 14 2019,0
Los Angeles Dodgers,0,Philadelphia Phillies,0,0,July 15 2019,0
Tampa Bay Rays,0,New York Yankees,0,0,July 15 2019,0
Toronto Blue Jays,0,Boston Red Sox,0,0,July 15 2019,0
Detroit Tigers,0,Cleveland Indians,0,0,July 15 2019,0
Cincinnati Reds,0,Chicago Cubs,0,0,July 15 2019,0
Atlanta Braves,0,Milwaukee Brewers,0,0,July 15 2019,0
Pittsburgh Pirates,0,St. Louis Cardinals,0,0,July 15 2019,0
Chicago White Sox,0,Kansas City Royals,0,0,July 15 2019,0
San Francisco Giants,0,Colorado Rockies,0,0,July 15 2019,0
Houston Astros,0,Los Angeles Angels,0,0,July 15 2019,0
Washington Nationals,0,Baltimore Orioles,0,0,July 16 2019,0
Los Angeles Dodgers,0,Philadelphia Phillies,0,0,July 16 2019,0
Tampa Bay Rays,0,New York Yankees,0,0,July 16 2019,0
San Diego Padres,0,Miami Marlins,0,0,July 16 2019,0
Toronto Blue Jays,0,Boston Red Sox,0,0,July 16 2019,0
Detroit Tigers,0,Cleveland Indians,0,0,July 16 2019,0
Arizona D'Backs,0,Texas Rangers,0,0,July 16 2019,0
Cincinnati Reds,0,Chicago Cubs,0,0,July 16 2019,0
Atlanta Braves,0,Milwaukee Brewers,0,0,July 16 2019,0
New York Mets,0,Minnesota Twins,0,0,July 16 2019,0
Chicago White Sox,0,Kansas City Royals,0,0,July 16 2019,0
Pittsburgh Pirates,0,St. Louis Cardinals,0,0,July 16 2019,0
San Francisco Giants,0,Colorado Rockies,0,0,July 16 2019,0
Seattle Mariners,0,Oakland Athletics,0,0,July 16 2019,0
Houston Astros,0,Los Angeles Angels,0,0,July 16 2019,0
New York Mets,0,Minnesota Twins,0,0,July 17 2019,0
Pittsburgh Pirates,0,St. Louis Cardinals,0,0,July 17 2019,0
Atlanta Braves,0,Milwaukee Brewers,0,0,July 17 2019,0
Cincinnati Reds,0,Chicago Cubs,0,0,July 17 2019,0
San Francisco Giants,0,Colorado Rockies,0,0,July 17 2019,0
Seattle Mariners,0,Oakland Athletics,0,0,July 17 2019,0
Los Angeles Dodgers,0,Philadelphia Phillies,0,0,July 17 2019,0
Washington Nationals,0,Baltimore Orioles,0,0,July 17 2019,0
Tampa Bay Rays,0,New York Yankees,0,0,July 17 2019,0
Detroit Tigers,0,Cleveland Indians,0,0,July 17 2019,0
Toronto Blue Jays,0,Boston Red Sox,0,0,July 17 2019,0
San Diego Padres,0,Miami Marlins,0,0,July 17 2019,0
Arizona D'Backs,0,Texas Rangers,0,0,July 17 2019,0
Chicago White Sox,0,Kansas City Royals,0,0,July 17 2019,0
Houston Astros,0,Los Angeles Angels,0,0,July 17 2019,0
San Diego Padres,0,Miami Marlins,0,0,July 18 2019,0
Los Angeles Dodgers,0,Philadelphia Phillies,0,0,July 18 2019,0
Toronto Blue Jays,0,Boston Red Sox,0,0,July 18 2019,0
Chicago White Sox,0,Kansas City Royals,0,0,July 18 2019,0
Tampa Bay Rays,0,New York Yankees,0,0,July 18 2019,0
St. Louis Cardinals,0,Cincinnati Reds,0,0,July 18 2019,0
Detroit Tigers,0,Cleveland Indians,0,0,July 18 2019,0
Washington Nationals,0,Atlanta Braves,0,0,July 18 2019,0
Oakland Athletics,0,Minnesota Twins,0,0,July 18 2019,0
Houston Astros,0,Los Angeles Angels,0,0,July 18 2019,0
Milwaukee Brewers,0,Arizona D'Backs,0,0,July 18 2019,0
New York Mets,0,San Francisco Giants,0,0,July 18 2019,0
San Diego Padres,0,Chicago Cubs,0,0,July 19 2019,0
Boston Red Sox,0,Baltimore Orioles,0,0,July 19 2019,0
Philadelphia Phillies,0,Pittsburgh Pirates,0,0,July 19 2019,0
Colorado Rockies,0,New York Yankees,0,0,July 19 2019,0
Chicago White Sox,0,Tampa Bay Rays,0,0,July 19 2019,0
St. Louis Cardinals,0,Cincinnati Reds,0,0,July 19 2019,0
Kansas City Royals,0,Cleveland Indians,0,0,July 19 2019,0
Toronto Blue Jays,0,Detroit Tigers,0,0,July 19 2019,0
Washington Nationals,0,Atlanta Braves,0,0,July 19 2019,0
Oakland Athletics,0,Minnesota Twins,0,0,July 19 2019,0
Texas Rangers,0,Houston Astros,0,0,July 19 2019,0
Milwaukee Brewers,0,Arizona D'Backs,0,0,July 19 2019,0
Miami Marlins,0,Los Angeles Dodgers,0,0,July 19 2019,0
Los Angeles Angels,0,Seattle Mariners,0,0,July 19 2019,0
New York Mets,0,San Francisco Giants,0,0,July 19 2019,0
Colorado Rockies,0,New York Yankees,0,0,July 20 2019,0
San Diego Padres,0,Chicago Cubs,0,0,July 20 2019,0
New York Mets,0,San Francisco Giants,0,0,July 20 2019,0
Chicago White Sox,0,Tampa Bay Rays,0,0,July 20 2019,0
Toronto Blue Jays,0,Detroit Tigers,0,0,July 20 2019,0
Boston Red Sox,0,Baltimore Orioles,0,0,July 20 2019,0
Philadelphia Phillies,0,Pittsburgh Pirates,0,0,July 20 2019,0
Oakland Athletics,0,Minnesota Twins,0,0,July 20 2019,0
Texas Rangers,0,Houston Astros,0,0,July 20 2019,0
Kansas City Royals,0,Cleveland Indians,0,0,July 20 2019,0
St. Louis Cardinals,0,Cincinnati Reds,0,0,July 20 2019,0
Washington Nationals,0,Atlanta Braves,0,0,July 20 2019,0
Milwaukee Brewers,0,Arizona D'Backs,0,0,July 20 2019,0
Miami Marlins,0,Los Angeles Dodgers,0,0,July 20 2019,0
Los Angeles Angels,0,Seattle Mariners,0,0,July 20 2019,0
Boston Red Sox,0,Baltimore Orioles,0,0,July 21 2019,0
Colorado Rockies,0,New York Yankees,0,0,July 21 2019,0
Chicago White Sox,0,Tampa Bay Rays,0,0,July 21 2019,0
St. Louis Cardinals,0,Cincinnati Reds,0,0,July 21 2019,0
Kansas City Royals,0,Cleveland Indians,0,0,July 21 2019,0
Toronto Blue Jays,0,Detroit Tigers,0,0,July 21 2019,0
Washington Nationals,0,Atlanta Braves,0,0,July 21 2019,0
Philadelphia Phillies,0,Pittsburgh Pirates,0,0,July 21 2019,0
Oakland Athletics,0,Minnesota Twins,0,0,July 21 2019,0
Texas Rangers,0,Houston Astros,0,0,July 21 2019,0
San Diego Padres,0,Chicago Cubs,0,0,July 21 2019,0
New York Mets,0,San Francisco Giants,0,0,July 21 2019,0
Miami Marlins,0,Los Angeles Dodgers,0,0,July 21 2019,0
Los Angeles Angels,0,Seattle Mariners,0,0,July 21 2019,0
Milwaukee Brewers,0,Arizona D'Backs,0,0,July 21 2019,0
Colorado Rockies,0,Washington Nationals,0,0,July 22 2019,0
St. Louis Cardinals,0,Pittsburgh Pirates,0,0,July 22 2019,0
Cleveland Indians,0,Toronto Blue Jays,0,0,July 22 2019,0
Boston Red Sox,0,Tampa Bay Rays,0,0,July 22 2019,0
Oakland Athletics,0,Houston Astros,0,0,July 22 2019,0
Cincinnati Reds,0,Milwaukee Brewers,0,0,July 22 2019,0
New York Yankees,0,Minnesota Twins,0,0,July 22 2019,0
Miami Marlins,0,Chicago White Sox,0,0,July 22 2019,0
Baltimore Orioles,0,Arizona D'Backs,0,0,July 22 2019,0
Chicago Cubs,0,San Francisco Giants,0,0,July 22 2019,0
Texas Rangers,0,Seattle Mariners,0,0,July 22 2019,0
Colorado Rockies,0,Washington Nationals,0,0,July 23 2019,0
St. Louis Cardinals,0,Pittsburgh Pirates,0,0,July 23 2019,0
Cleveland Indians,0,Toronto Blue Jays,0,0,July 23 2019,0
Philadelphia Phillies,0,Detroit Tigers,0,0,July 23 2019,0
Boston Red Sox,0,Tampa Bay Rays,0,0,July 23 2019,0
San Diego Padres,0,New York Mets,0,0,July 23 2019,0
Kansas City Royals,0,Atlanta Braves,0,0,July 23 2019,0
New York Yankees,0,Minnesota Twins,0,0,July 23 2019,0
Cincinnati Reds,0,Milwaukee Brewers,0,0,July 23 2019,0
Oakland Athletics,0,Houston Astros,0,0,July 23 2019,0
Miami Marlins,0,Chicago White Sox,0,0,July 23 2019,0
Baltimore Orioles,0,Arizona D'Backs,0,0,July 23 2019,0
Chicago Cubs,0,San Francisco Giants,0,0,July 23 2019,0
Los Angeles Angels,0,Los Angeles Dodgers,0,0,July 23 2019,0
Texas Rangers,0,Seattle Mariners,0,0,July 23 2019,0
Boston Red Sox,0,Tampa Bay Rays,0,0,July 24 2019,0
Philadelphia Phillies,0,Detroit Tigers,0,0,July 24 2019,0
Oakland Athletics,0,Houston Astros,0,0,July 24 2019,0
Cincinnati Reds,0,Milwaukee Brewers,0,0,July 24 2019,0
Baltimore Orioles,0,Arizona D'Backs,0,0,July 24 2019,0
Texas Rangers,0,Seattle Mariners,0,0,July 24 2019,0
Chicago Cubs,0,San Francisco Giants,0,0,July 24 2019,0
St. Louis Cardinals,0,Pittsburgh Pirates,0,0,July 24 2019,0
Colorado Rockies,0,Washington Nationals,0,0,July 24 2019,0
Cleveland Indians,0,Toronto Blue Jays,0,0,July 24 2019,0
San Diego Padres,0,New York Mets,0,0,July 24 2019,0
Kansas City Royals,0,Atlanta Braves,0,0,July 24 2019,0
Miami Marlins,0,Chicago White Sox,0,0,July 24 2019,0
New York Yankees,0,Minnesota Twins,0,0,July 24 2019,0
Los Angeles Angels,0,Los Angeles Dodgers,0,0,July 24 2019,0
San Diego Padres,0,New York Mets,0,0,July 25 2019,0
St. Louis Cardinals,0,Pittsburgh Pirates,0,0,July 25 2019,0
Colorado Rockies,0,Washington Nationals,0,0,July 25 2019,0
New York Yankees,0,Boston Red Sox,0,0,July 25 2019,0
Minnesota Twins,0,Chicago White Sox,0,0,July 25 2019,0
Cleveland Indians,0,Kansas City Royals,0,0,July 25 2019,0
Baltimore Orioles,0,Los Angeles Angels,0,0,July 25 2019,0
Texas Rangers,0,Oakland Athletics,0,0,July 25 2019,0
Detroit Tigers,0,Seattle Mariners,0,0,July 25 2019,0
Colorado Rockies,0,Cincinnati Reds,0,0,July 26 2019,0
Los Angeles Dodgers,0,Washington Nationals,0,0,July 26 2019,0
Atlanta Braves,0,Philadelphia Phillies,0,0,July 26 2019,0
Tampa Bay Rays,0,Toronto Blue Jays,0,0,July 26 2019,0
Pittsburgh Pirates,0,New York Mets,0,0,July 26 2019,0
Arizona D'Backs,0,Miami Marlins,0,0,July 26 2019,0
New York Yankees,0,Boston Red Sox,0,0,July 26 2019,0
Chicago Cubs,0,Milwaukee Brewers,0,0,July 26 2019,0
Minnesota Twins,0,Chicago White Sox,0,0,July 26 2019,0
Cleveland Indians,0,Kansas City Royals,0,0,July 26 2019,0
Houston Astros,0,St. Louis Cardinals,0,0,July 26 2019,0
Texas Rangers,0,Oakland Athletics,0,0,July 26 2019,0
Baltimore Orioles,0,Los Angeles Angels,0,0,July 26 2019,0
San Francisco Giants,0,San Diego Padres,0,0,July 26 2019,0
Detroit Tigers,0,Seattle Mariners,0,0,July 26 2019,0
Tampa Bay Rays,0,Toronto Blue Jays,0,0,July 27 2019,0
Los Angeles Dodgers,0,Washington Nationals,0,0,July 27 2019,0
New York Yankees,0,Boston Red Sox,0,0,July 27 2019,0
Detroit Tigers,0,Seattle Mariners,0,0,July 27 2019,0
Arizona D'Backs,0,Miami Marlins,0,0,July 27 2019,0
Atlanta Braves,0,Philadelphia Phillies,0,0,July 27 2019,0
Pittsburgh Pirates,0,New York Mets,0,0,July 27 2019,0
Chicago Cubs,0,Milwaukee Brewers,0,0,July 27 2019,0
Colorado Rockies,0,Cincinnati Reds,0,0,July 27 2019,0
Minnesota Twins,0,Chicago White Sox,0,0,July 27 2019,0
Cleveland Indians,0,Kansas City Royals,0,0,July 27 2019,0
Houston Astros,0,St. Louis Cardinals,0,0,July 27 2019,0
San Francisco Giants,0,San Diego Padres,0,0,July 27 2019,0
Texas Rangers,0,Oakland Athletics,0,0,July 27 2019,0
Baltimore Orioles,0,Los Angeles Angels,0,0,July 27 2019,0
Atlanta Braves,0,Philadelphia Phillies,0,0,July 28 2019,0
Tampa Bay Rays,0,Toronto Blue Jays,0,0,July 28 2019,0
Pittsburgh Pirates,0,New York Mets,0,0,July 28 2019,0
Colorado Rockies,0,Cincinnati Reds,0,0,July 28 2019,0
Arizona D'Backs,0,Miami Marlins,0,0,July 28 2019,0
Los Angeles Dodgers,0,Washington Nationals,0,0,July 28 2019,0
Chicago Cubs,0,Milwaukee Brewers,0,0,July 28 2019,0
Minnesota Twins,0,Chicago White Sox,0,0,July 28 2019,0
Cleveland Indians,0,Kansas City Royals,0,0,July 28 2019,0
Houston Astros,0,St. Louis Cardinals,0,0,July 28 2019,0
Texas Rangers,0,Oakland Athletics,0,0,July 28 2019,0
Baltimore Orioles,0,Los Angeles Angels,0,0,July 28 2019,0
San Francisco Giants,0,San Diego Padres,0,0,July 28 2019,0
Detroit Tigers,0,Seattle Mariners,0,0,July 28 2019,0
New York Yankees,0,Boston Red Sox,0,0,July 28 2019,0
Atlanta Braves,0,Washington Nationals,0,0,July 29 2019,0
Pittsburgh Pirates,0,Cincinnati Reds,0,0,July 29 2019,0
Arizona D'Backs,0,Miami Marlins,0,0,July 29 2019,0
Toronto Blue Jays,0,Kansas City Royals,0,0,July 29 2019,0
Los Angeles Dodgers,0,Colorado Rockies,0,0,July 29 2019,0
Detroit Tigers,0,Los Angeles Angels,0,0,July 29 2019,0
Baltimore Orioles,0,San Diego Padres,0,0,July 29 2019,0
Baltimore Orioles,0,San Diego Padres,0,0,July 30 2019,0
Atlanta Braves,0,Washington Nationals,0,0,July 30 2019,0
San Francisco Giants,0,Philadelphia Phillies,0,0,July 30 2019,0
Arizona D'Backs,0,New York Yankees,0,0,July 30 2019,0
Minnesota Twins,0,Miami Marlins,0,0,July 30 2019,0
Houston Astros,0,Cleveland Indians,0,0,July 30 2019,0
Pittsburgh Pirates,0,Cincinnati Reds,0,0,July 30 2019,0
Tampa Bay Rays,0,Boston Red Sox,0,0,July 30 2019,0
Seattle Mariners,0,Texas Rangers,0,0,July 30 2019,0
New York Mets,0,Chicago White Sox,0,0,July 30 2019,0
Toronto Blue Jays,0,Kansas City Royals,0,0,July 30 2019,0
Chicago Cubs,0,St. Louis Cardinals,0,0,July 30 2019,0
Los Angeles Dodgers,0,Colorado Rockies,0,0,July 30 2019,0
Milwaukee Brewers,0,Oakland Athletics,0,0,July 30 2019,0
Detroit Tigers,0,Los Angeles Angels,0,0,July 30 2019,0
Atlanta Braves,0,Washington Nationals,0,0,July 31 2019,0
Pittsburgh Pirates,0,Cincinnati Reds,0,0,July 31 2019,0
Arizona D'Backs,0,New York Yankees,0,0,July 31 2019,0
Toronto Blue Jays,0,Kansas City Royals,0,0,July 31 2019,0
Los Angeles Dodgers,0,Colorado Rockies,0,0,July 31 2019,0
Detroit Tigers,0,Los Angeles Angels,0,0,July 31 2019,0
San Francisco Giants,0,Philadelphia Phillies,0,0,July 31 2019,0
Houston Astros,0,Cleveland Indians,0,0,July 31 2019,0
Tampa Bay Rays,0,Boston Red Sox,0,0,July 31 2019,0
Minnesota Twins,0,Miami Marlins,0,0,July 31 2019,0
Seattle Mariners,0,Texas Rangers,0,0,July 31 2019,0
New York Mets,0,Chicago White Sox,0,0,July 31 2019,0
Chicago Cubs,0,St. Louis Cardinals,0,0,July 31 2019,0
Milwaukee Brewers,0,Oakland Athletics,0,0,July 31 2019,0
Minnesota Twins,0,Miami Marlins,0,0,August 1 2019,0
San Francisco Giants,0,Philadelphia Phillies,0,0,August 1 2019,0
New York Mets,0,Chicago White Sox,0,0,August 1 2019,0
Milwaukee Brewers,0,Oakland Athletics,0,0,August 1 2019,0
Toronto Blue Jays,0,Baltimore Orioles,0,0,August 1 2019,0
Tampa Bay Rays,0,Boston Red Sox,0,0,August 1 2019,0
Houston Astros,0,Cleveland Indians,0,0,August 1 2019,0
Chicago Cubs,0,St. Louis Cardinals,0,0,August 1 2019,0
Cincinnati Reds,0,Atlanta Braves,0,0,August 1 2019,0
San Diego Padres,0,Los Angeles Dodgers,0,0,August 1 2019,0
Milwaukee Brewers,0,Chicago Cubs,0,0,August 2 2019,0
Toronto Blue Jays,0,Baltimore Orioles,0,0,August 2 2019,0
New York Mets,0,Pittsburgh Pirates,0,0,August 2 2019,0
Chicago White Sox,0,Philadelphia Phillies,0,0,August 2 2019,0
Boston Red Sox,0,New York Yankees,0,0,August 2 2019,0
Los Angeles Angels,0,Cleveland Indians,0,0,August 2 2019,0
Cincinnati Reds,0,Atlanta Braves,0,0,August 2 2019,0
Detroit Tigers,0,Texas Rangers,0,0,August 2 2019,0
Kansas City Royals,0,Minnesota Twins,0,0,August 2 2019,0
Seattle Mariners,0,Houston Astros,0,0,August 2 2019,0
San Francisco Giants,0,Colorado Rockies,0,0,August 2 2019,0
Washington Nationals,0,Arizona D'Backs,0,0,August 2 2019,0
San Diego Padres,0,Los Angeles Dodgers,0,0,August 2 2019,0
Milwaukee Brewers,0,Chicago Cubs,0,0,August 3 2019,0
Boston Red Sox,0,New York Yankees,0,0,August 3 2019,0
Miami Marlins,0,Tampa Bay Rays,0,0,August 3 2019,0
New York Mets,0,Pittsburgh Pirates,0,0,August 3 2019,0
Chicago White Sox,0,Philadelphia Phillies,0,0,August 3 2019,0
Toronto Blue Jays,0,Baltimore Orioles,0,0,August 3 2019,0
Los Angeles Angels,0,Cleveland Indians,0,0,August 3 2019,0
Seattle Mariners,0,Houston Astros,0,0,August 3 2019,0
Kansas City Royals,0,Minnesota Twins,0,0,August 3 2019,0
Cincinnati Reds,0,Atlanta Braves,0,0,August 3 2019,0
Detroit Tigers,0,Texas Rangers,0,0,August 3 2019,0
Washington Nationals,0,Arizona D'Backs,0,0,August 3 2019,0
San Francisco Giants,0,Colorado Rockies,0,0,August 3 2019,0
St. Louis Cardinals,0,Oakland Athletics,0,0,August 3 2019,0
San Diego Padres,0,Los Angeles Dodgers,0,0,August 3 2019,0
Chicago White Sox,0,Philadelphia Phillies,0,0,August 4 2019,0
Toronto Blue Jays,0,Baltimore Orioles,0,0,August 4 2019,0
Los Angeles Angels,0,Cleveland Indians,0,0,August 4 2019,0
Miami Marlins,0,Tampa Bay Rays,0,0,August 4 2019,0
Cincinnati Reds,0,Atlanta Braves,0,0,August 4 2019,0
New York Mets,0,Pittsburgh Pirates,0,0,August 4 2019,0
Kansas City Royals,0,Minnesota Twins,0,0,August 4 2019,0
Seattle Mariners,0,Houston Astros,0,0,August 4 2019,0
Milwaukee Brewers,0,Chicago Cubs,0,0,August 4 2019,0
Detroit Tigers,0,Texas Rangers,0,0,August 4 2019,0
San Francisco Giants,0,Colorado Rockies,0,0,August 4 2019,0
St. Louis Cardinals,0,Oakland Athletics,0,0,August 4 2019,0
San Diego Padres,0,Los Angeles Dodgers,0,0,August 4 2019,0
Washington Nationals,0,Arizona D'Backs,0,0,August 4 2019,0
Boston Red Sox,0,New York Yankees,0,0,August 4 2019,0
New York Yankees,0,Baltimore Orioles,0,0,August 5 2019,0
Milwaukee Brewers,0,Pittsburgh Pirates,0,0,August 5 2019,0
Toronto Blue Jays,0,Tampa Bay Rays,0,0,August 5 2019,0
Miami Marlins,0,New York Mets,0,0,August 5 2019,0
Chicago White Sox,0,Detroit Tigers,0,0,August 5 2019,0
Texas Rangers,0,Cleveland Indians,0,0,August 5 2019,0
Los Angeles Angels,0,Cincinnati Reds,0,0,August 5 2019,0
Kansas City Royals,0,Boston Red Sox,0,0,August 5 2019,0
Oakland Athletics,0,Chicago Cubs,0,0,August 5 2019,0
Atlanta Braves,0,Minnesota Twins,0,0,August 5 2019,0
Philadelphia Phillies,0,Arizona D'Backs,0,0,August 5 2019,0
Washington Nationals,0,San Francisco Giants,0,0,August 5 2019,0
St. Louis Cardinals,0,Los Angeles Dodgers,0,0,August 5 2019,0
Chicago White Sox,0,Detroit Tigers,0,0,August 6 2019,0
New York Yankees,0,Baltimore Orioles,0,0,August 6 2019,0
Milwaukee Brewers,0,Pittsburgh Pirates,0,0,August 6 2019,0
Toronto Blue Jays,0,Tampa Bay Rays,0,0,August 6 2019,0
Chicago White Sox,0,Detroit Tigers,0,0,August 6 2019,0
Texas Rangers,0,Cleveland Indians,0,0,August 6 2019,0
Los Angeles Angels,0,Cincinnati Reds,0,0,August 6 2019,0
Kansas City Royals,0,Boston Red Sox,0,0,August 6 2019,0
Miami Marlins,0,New York Mets,0,0,August 6 2019,0
Oakland Athletics,0,Chicago Cubs,0,0,August 6 2019,0
Atlanta Braves,0,Minnesota Twins,0,0,August 6 2019,0
Colorado Rockies,0,Houston Astros,0,0,August 6 2019,0
Philadelphia Phillies,0,Arizona D'Backs,0,0,August 6 2019,0
Washington Nationals,0,San Francisco Giants,0,0,August 6 2019,0
St. Louis Cardinals,0,Los Angeles Dodgers,0,0,August 6 2019,0
San Diego Padres,0,Seattle Mariners,0,0,August 6 2019,0
Miami Marlins,0,New York Mets,0,0,August 7 2019,0
Toronto Blue Jays,0,Tampa Bay Rays,0,0,August 7 2019,0
Atlanta Braves,0,Minnesota Twins,0,0,August 7 2019,0
Texas Rangers,0,Cleveland Indians,0,0,August 7 2019,0
Chicago White Sox,0,Detroit Tigers,0,0,August 7 2019,0
Colorado Rockies,0,Houston Astros,0,0,August 7 2019,0
Oakland Athletics,0,Chicago Cubs,0,0,August 7 2019,0
St. Louis Cardinals,0,Los Angeles Dodgers,0,0,August 7 2019,0
Washington Nationals,0,San Francisco Giants,0,0,August 7 2019,0
San Diego Padres,0,Seattle Mariners,0,0,August 7 2019,0
New York Yankees,0,Baltimore Orioles,0,0,August 7 2019,0
Milwaukee Brewers,0,Pittsburgh Pirates,0,0,August 7 2019,0
Kansas City Royals,0,Boston Red Sox,0,0,August 7 2019,0
Philadelphia Phillies,0,Arizona D'Backs,0,0,August 7 2019,0
New York Yankees,0,Toronto Blue Jays,0,0,August 8 2019,0
Los Angeles Angels,0,Boston Red Sox,0,0,August 8 2019,0
Chicago Cubs,0,Cincinnati Reds,0,0,August 8 2019,0
Kansas City Royals,0,Detroit Tigers,0,0,August 8 2019,0
Atlanta Braves,0,Miami Marlins,0,0,August 8 2019,0
Cleveland Indians,0,Minnesota Twins,0,0,August 8 2019,0
Philadelphia Phillies,0,San Francisco Giants,0,0,August 8 2019,0
Colorado Rockies,0,San Diego Padres,0,0,August 8 2019,0
Oakland Athletics,0,Chicago White Sox,0,0,August 9 2019,0
Houston Astros,0,Baltimore Orioles,0,0,August 9 2019,0
New York Yankees,0,Toronto Blue Jays,0,0,August 9 2019,0
Chicago Cubs,0,Cincinnati Reds,0,0,August 9 2019,0
Washington Nationals,0,New York Mets,0,0,August 9 2019,0
Los Angeles Angels,0,Boston Red Sox,0,0,August 9 2019,0
Atlanta Braves,0,Miami Marlins,0,0,August 9 2019,0
Kansas City Royals,0,Detroit Tigers,0,0,August 9 2019,0
Cleveland Indians,0,Minnesota Twins,0,0,August 9 2019,0
Texas Rangers,0,Milwaukee Brewers,0,0,August 9 2019,0
Pittsburgh Pirates,0,St. Louis Cardinals,0,0,August 9 2019,0
Arizona D'Backs,0,Los Angeles Dodgers,0,0,August 9 2019,0
Colorado Rockies,0,San Diego Padres,0,0,August 9 2019,0
Tampa Bay Rays,0,Seattle Mariners,0,0,August 9 2019,0
Philadelphia Phillies,0,San Francisco Giants,0,0,August 9 2019,0
New York Yankees,0,Toronto Blue Jays,0,0,August 10 2019,0
Los Angeles Angels,0,Boston Red Sox,0,0,August 10 2019,0
Philadelphia Phillies,0,San Francisco Giants,0,0,August 10 2019,0
Kansas City Royals,0,Detroit Tigers,0,0,August 10 2019,0
Atlanta Braves,0,Miami Marlins,0,0,August 10 2019,0
Houston Astros,0,Baltimore Orioles,0,0,August 10 2019,0
Chicago Cubs,0,Cincinnati Reds,0,0,August 10 2019,0
Cleveland Indians,0,Minnesota Twins,0,0,August 10 2019,0
Washington Nationals,0,New York Mets,0,0,August 10 2019,0
Oakland Athletics,0,Chicago White Sox,0,0,August 10 2019,0
Texas Rangers,0,Milwaukee Brewers,0,0,August 10 2019,0
Pittsburgh Pirates,0,St. Louis Cardinals,0,0,August 10 2019,0
Colorado Rockies,0,San Diego Padres,0,0,August 10 2019,0
Arizona D'Backs,0,Los Angeles Dodgers,0,0,August 10 2019,0
Tampa Bay Rays,0,Seattle Mariners,0,0,August 10 2019,0
Houston Astros,0,Baltimore Orioles,0,0,August 11 2019,0
Los Angeles Angels,0,Boston Red Sox,0,0,August 11 2019,0
New York Yankees,0,Toronto Blue Jays,0,0,August 11 2019,0
Chicago Cubs,0,Cincinnati Reds,0,0,August 11 2019,0
Washington Nationals,0,New York Mets,0,0,August 11 2019,0
Atlanta Braves,0,Miami Marlins,0,0,August 11 2019,0
Kansas City Royals,0,Detroit Tigers,0,0,August 11 2019,0
Oakland Athletics,0,Chicago White Sox,0,0,August 11 2019,0
Cleveland Indians,0,Minnesota Twins,0,0,August 11 2019,0
Texas Rangers,0,Milwaukee Brewers,0,0,August 11 2019,0
Pittsburgh Pirates,0,St. Louis Cardinals,0,0,August 11 2019,0
Colorado Rockies,0,San Diego Padres,0,0,August 11 2019,0
Philadelphia Phillies,0,San Francisco Giants,0,0,August 11 2019,0
Arizona D'Backs,0,Los Angeles Dodgers,0,0,August 11 2019,0
Tampa Bay Rays,0,Seattle Mariners,0,0,August 11 2019,0
Baltimore Orioles,0,New York Yankees,0,0,August 12 2019,0
Cincinnati Reds,0,Washington Nationals,0,0,August 12 2019,0
Texas Rangers,0,Toronto Blue Jays,0,0,August 12 2019,0
Boston Red Sox,0,Cleveland Indians,0,0,August 12 2019,0
Houston Astros,0,Chicago White Sox,0,0,August 12 2019,0
Arizona D'Backs,0,Colorado Rockies,0,0,August 12 2019,0
Pittsburgh Pirates,0,Los Angeles Angels,0,0,August 12 2019,0
Tampa Bay Rays,0,San Diego Padres,0,0,August 12 2019,0
Cincinnati Reds,0,Washington Nationals,0,0,August 13 2019,0
Chicago Cubs,0,Philadelphia Phillies,0,0,August 13 2019,0
Baltimore Orioles,0,New York Yankees,0,0,August 13 2019,0
Texas Rangers,0,Toronto Blue Jays,0,0,August 13 2019,0
Los Angeles Dodgers,0,Miami Marlins,0,0,August 13 2019,0
Seattle Mariners,0,Detroit Tigers,0,0,August 13 2019,0
Boston Red Sox,0,Cleveland Indians,0,0,August 13 2019,0
New York Mets,0,Atlanta Braves,0,0,August 13 2019,0
Minnesota Twins,0,Milwaukee Brewers,0,0,August 13 2019,0
Houston Astros,0,Chicago White Sox,0,0,August 13 2019,0
St. Louis Cardinals,0,Kansas City Royals,0,0,August 13 2019,0
Arizona D'Backs,0,Colorado Rockies,0,0,August 13 2019,0
Oakland Athletics,0,San Francisco Giants,0,0,August 13 2019,0
Pittsburgh Pirates,0,Los Angeles Angels,0,0,August 13 2019,0
Tampa Bay Rays,0,San Diego Padres,0,0,August 13 2019,0
Texas Rangers,0,Toronto Blue Jays,0,0,August 14 2019,0
Baltimore Orioles,0,New York Yankees,0,0,August 14 2019,0
Boston Red Sox,0,Cleveland Indians,0,0,August 14 2019,0
Houston Astros,0,Chicago White Sox,0,0,August 14 2019,0
Minnesota Twins,0,Milwaukee Brewers,0,0,August 14 2019,0
Arizona D'Backs,0,Colorado Rockies,0,0,August 14 2019,0
Tampa Bay Rays,0,San Diego Padres,0,0,August 14 2019,0
Oakland Athletics,0,San Francisco Giants,0,0,August 14 2019,0
Cincinnati Reds,0,Washington Nationals,0,0,August 14 2019,0
Chicago Cubs,0,Philadelphia Phillies,0,0,August 14 2019,0
Los Angeles Dodgers,0,Miami Marlins,0,0,August 14 2019,0
Seattle Mariners,0,Detroit Tigers,0,0,August 14 2019,0
New York Mets,0,Atlanta Braves,0,0,August 14 2019,0
Pittsburgh Pirates,0,Los Angeles Angels,0,0,August 14 2019,0
St. Louis Cardinals,0,Kansas City Royals,0,0,August 14 2019,0
Seattle Mariners,0,Detroit Tigers,0,0,August 15 2019,0
Los Angeles Dodgers,0,Miami Marlins,0,0,August 15 2019,0
Chicago Cubs,0,Philadelphia Phillies,0,0,August 15 2019,0
Cleveland Indians,0,New York Yankees,0,0,August 15 2019,0
St. Louis Cardinals,0,Cincinnati Reds,0,0,August 15 2019,0
New York Mets,0,Atlanta Braves,0,0,August 15 2019,0
Minnesota Twins,0,Texas Rangers,0,0,August 15 2019,0
San Francisco Giants,0,Arizona D'Backs,0,0,August 15 2019,0
Houston Astros,0,Oakland Athletics,0,0,August 15 2019,0
Chicago White Sox,0,Los Angeles Angels,0,0,August 15 2019,0
Milwaukee Brewers,0,Washington Nationals,0,0,August 16 2019,0
Chicago Cubs,0,Pittsburgh Pirates,0,0,August 16 2019,0
San Diego Padres,0,Philadelphia Phillies,0,0,August 16 2019,0
Cleveland Indians,0,New York Yankees,0,0,August 16 2019,0
Seattle Mariners,0,Toronto Blue Jays,0,0,August 16 2019,0
St. Louis Cardinals,0,Cincinnati Reds,0,0,August 16 2019,0
Detroit Tigers,0,Tampa Bay Rays,0,0,August 16 2019,0
Baltimore Orioles,0,Boston Red Sox,0,0,August 16 2019,0
Los Angeles Dodgers,0,Atlanta Braves,0,0,August 16 2019,0
Minnesota Twins,0,Texas Rangers,0,0,August 16 2019,0
New York Mets,0,Kansas City Royals,0,0,August 16 2019,0
Miami Marlins,0,Colorado Rockies,0,0,August 16 2019,0
San Francisco Giants,0,Arizona D'Backs,0,0,August 16 2019,0
Houston Astros,0,Oakland Athletics,0,0,August 16 2019,0
Chicago White Sox,0,Los Angeles Angels,0,0,August 16 2019,0
Cleveland Indians,0,New York Yankees,0,0,August 17 2019,0
Chicago Cubs,0,Pittsburgh Pirates,0,0,August 17 2019,0
Seattle Mariners,0,Toronto Blue Jays,0,0,August 17 2019,0
Houston Astros,0,Oakland Athletics,0,0,August 17 2019,0
Detroit Tigers,0,Tampa Bay Rays,0,0,August 17 2019,0
San Diego Padres,0,Philadelphia Phillies,0,0,August 17 2019,0
Milwaukee Brewers,0,Washington Nationals,0,0,August 17 2019,0
St. Louis Cardinals,0,Cincinnati Reds,0,0,August 17 2019,0
Baltimore Orioles,0,Boston Red Sox,0,0,August 17 2019,0
New York Mets,0,Kansas City Royals,0,0,August 17 2019,0
Los Angeles Dodgers,0,Atlanta Braves,0,0,August 17 2019,0
Minnesota Twins,0,Texas Rangers,0,0,August 17 2019,0
Miami Marlins,0,Colorado Rockies,0,0,August 17 2019,0
San Francisco Giants,0,Arizona D'Backs,0,0,August 17 2019,0
Chicago White Sox,0,Los Angeles Angels,0,0,August 17 2019,0
Cleveland Indians,0,New York Yankees,0,0,August 18 2019,0
Baltimore Orioles,0,Boston Red Sox,0,0,August 18 2019,0
San Diego Padres,0,Philadelphia Phillies,0,0,August 18 2019,0
Seattle Mariners,0,Toronto Blue Jays,0,0,August 18 2019,0
St. Louis Cardinals,0,Cincinnati Reds,0,0,August 18 2019,0
Detroit Tigers,0,Tampa Bay Rays,0,0,August 18 2019,0
Los Angeles Dodgers,0,Atlanta Braves,0,0,August 18 2019,0
Milwaukee Brewers,0,Washington Nationals,0,0,August 18 2019,0
New York Mets,0,Kansas City Royals,0,0,August 18 2019,0
Minnesota Twins,0,Texas Rangers,0,0,August 18 2019,0
Miami Marlins,0,Colorado Rockies,0,0,August 18 2019,0
Houston Astros,0,Oakland Athletics,0,0,August 18 2019,0
Chicago White Sox,0,Los Angeles Angels,0,0,August 18 2019,0
San Francisco Giants,0,Arizona D'Backs,0,0,August 18 2019,0
Chicago Cubs,0,Pittsburgh Pirates,0,0,August 18 2019,0
Kansas City Royals,0,Baltimore Orioles,0,0,August 19 2019,0
Washington Nationals,0,Pittsburgh Pirates,0,0,August 19 2019,0
San Diego Padres,0,Cincinnati Reds,0,0,August 19 2019,0
Seattle Mariners,0,Tampa Bay Rays,0,0,August 19 2019,0
Milwaukee Brewers,0,St. Louis Cardinals,0,0,August 19 2019,0
Los Angeles Angels,0,Texas Rangers,0,0,August 19 2019,0
Detroit Tigers,0,Houston Astros,0,0,August 19 2019,0
Chicago White Sox,0,Minnesota Twins,0,0,August 19 2019,0
Colorado Rockies,0,Arizona D'Backs,0,0,August 19 2019,0
Washington Nationals,0,Pittsburgh Pirates,0,0,August 20 2019,0
Kansas City Royals,0,Baltimore Orioles,0,0,August 20 2019,0
Philadelphia Phillies,0,Boston Red Sox,0,0,August 20 2019,0
San Diego Padres,0,Cincinnati Reds,0,0,August 20 2019,0
Cleveland Indians,0,New York Mets,0,0,August 20 2019,0
Seattle Mariners,0,Tampa Bay Rays,0,0,August 20 2019,0
Miami Marlins,0,Atlanta Braves,0,0,August 20 2019,0
Milwaukee Brewers,0,St. Louis Cardinals,0,0,August 20 2019,0
Los Angeles Angels,0,Texas Rangers,0,0,August 20 2019,0
San Francisco Giants,0,Chicago Cubs,0,0,August 20 2019,0
Chicago White Sox,0,Minnesota Twins,0,0,August 20 2019,0
Detroit Tigers,0,Houston Astros,0,0,August 20 2019,0
Colorado Rockies,0,Arizona D'Backs,0,0,August 20 2019,0
New York Yankees,0,Oakland Athletics,0,0,August 20 2019,0
Toronto Blue Jays,0,Los Angeles Dodgers,0,0,August 20 2019,0
San Diego Padres,0,Cincinnati Reds,0,0,August 21 2019,0
Seattle Mariners,0,Tampa Bay Rays,0,0,August 21 2019,0
Chicago White Sox,0,Minnesota Twins,0,0,August 21 2019,0
Colorado Rockies,0,Arizona D'Backs,0,0,August 21 2019,0
Washington Nationals,0,Pittsburgh Pirates,0,0,August 21 2019,0
Los Angeles Angels,0,Texas Rangers,0,0,August 21 2019,0
Kansas City Royals,0,Baltimore Orioles,0,0,August 21 2019,0
Philadelphia Phillies,0,Boston Red Sox,0,0,August 21 2019,0
Cleveland Indians,0,New York Mets,0,0,August 21 2019,0
Miami Marlins,0,Atlanta Braves,0,0,August 21 2019,0
Milwaukee Brewers,0,St. Louis Cardinals,0,0,August 21 2019,0
San Francisco Giants,0,Chicago Cubs,0,0,August 21 2019,0
Detroit Tigers,0,Houston Astros,0,0,August 21 2019,0
New York Yankees,0,Oakland Athletics,0,0,August 21 2019,0
Toronto Blue Jays,0,Los Angeles Dodgers,0,0,August 21 2019,0
San Francisco Giants,0,Chicago Cubs,0,0,August 22 2019,0
Tampa Bay Rays,0,Baltimore Orioles,0,0,August 22 2019,0
Washington Nationals,0,Pittsburgh Pirates,0,0,August 22 2019,0
Cleveland Indians,0,New York Mets,0,0,August 22 2019,0
Miami Marlins,0,Atlanta Braves,0,0,August 22 2019,0
Colorado Rockies,0,St. Louis Cardinals,0,0,August 22 2019,0
Detroit Tigers,0,Houston Astros,0,0,August 22 2019,0
Texas Rangers,0,Chicago White Sox,0,0,August 22 2019,0
New York Yankees,0,Oakland Athletics,0,0,August 22 2019,0
Toronto Blue Jays,0,Los Angeles Dodgers,0,0,August 22 2019,0
Washington Nationals,0,Chicago Cubs,0,0,August 23 2019,0
Tampa Bay Rays,0,Baltimore Orioles,0,0,August 23 2019,0
Cincinnati Reds,0,Pittsburgh Pirates,0,0,August 23 2019,0
Kansas City Royals,0,Cleveland Indians,0,0,August 23 2019,0
Atlanta Braves,0,New York Mets,0,0,August 23 2019,0
Philadelphia Phillies,0,Miami Marlins,0,0,August 23 2019,0
Detroit Tigers,0,Minnesota Twins,0,0,August 23 2019,0
Arizona D'Backs,0,Milwaukee Brewers,0,0,August 23 2019,0
Los Angeles Angels,0,Houston Astros,0,0,August 23 2019,0
Texas Rangers,0,Chicago White Sox,0,0,August 23 2019,0
Colorado Rockies,0,St. Louis Cardinals,0,0,August 23 2019,0
New York Yankees,0,Los Angeles Dodgers,0,0,August 23 2019,0
Boston Red Sox,0,San Diego Padres,0,0,August 23 2019,0
Toronto Blue Jays,0,Seattle Mariners,0,0,August 23 2019,0
Washington Nationals,0,Chicago Cubs,0,0,August 24 2019,0
New York Yankees,0,Los Angeles Dodgers,0,0,August 24 2019,0
Philadelphia Phillies,0,Miami Marlins,0,0,August 24 2019,0
Tampa Bay Rays,0,Baltimore Orioles,0,0,August 24 2019,0
Cincinnati Reds,0,Pittsburgh Pirates,0,0,August 24 2019,0
Atlanta Braves,0,New York Mets,0,0,August 24 2019,0
Detroit Tigers,0,Minnesota Twins,0,0,August 24 2019,0
Arizona D'Backs,0,Milwaukee Brewers,0,0,August 24 2019,0
Los Angeles Angels,0,Houston Astros,0,0,August 24 2019,0
Kansas City Royals,0,Cleveland Indians,0,0,August 24 2019,0
Texas Rangers,0,Chicago White Sox,0,0,August 24 2019,0
Colorado Rockies,0,St. Louis Cardinals,0,0,August 24 2019,0
Boston Red Sox,0,San Diego Padres,0,0,August 24 2019,0
San Francisco Giants,0,Oakland Athletics,0,0,August 24 2019,0
Toronto Blue Jays,0,Seattle Mariners,0,0,August 24 2019,0
Tampa Bay Rays,0,Baltimore Orioles,0,0,August 25 2019,0
Atlanta Braves,0,New York Mets,0,0,August 25 2019,0
Kansas City Royals,0,Cleveland Indians,0,0,August 25 2019,0
Philadelphia Phillies,0,Miami Marlins,0,0,August 25 2019,0
Cincinnati Reds,0,Pittsburgh Pirates,0,0,August 25 2019,0
Detroit Tigers,0,Minnesota Twins,0,0,August 25 2019,0
Arizona D'Backs,0,Milwaukee Brewers,0,0,August 25 2019,0
Los Angeles Angels,0,Houston Astros,0,0,August 25 2019,0
Texas Rangers,0,Chicago White Sox,0,0,August 25 2019,0
Colorado Rockies,0,St. Louis Cardinals,0,0,August 25 2019,0
Washington Nationals,0,Chicago Cubs,0,0,August 25 2019,0
San Francisco Giants,0,Oakland Athletics,0,0,August 25 2019,0
Boston Red Sox,0,San Diego Padres,0,0,August 25 2019,0
Toronto Blue Jays,0,Seattle Mariners,0,0,August 25 2019,0
New York Yankees,0,Los Angeles Dodgers,0,0,August 25 2019,0
Atlanta Braves,0,Colorado Rockies,0,0,August 26 2019,0
Pittsburgh Pirates,0,Philadelphia Phillies,0,0,August 26 2019,0
Cincinnati Reds,0,Miami Marlins,0,0,August 26 2019,0
St. Louis Cardinals,0,Milwaukee Brewers,0,0,August 26 2019,0
Oakland Athletics,0,Kansas City Royals,0,0,August 26 2019,0
Arizona D'Backs,0,San Francisco Giants,0,0,August 26 2019,0
Los Angeles Dodgers,0,San Diego Padres,0,0,August 26 2019,0
New York Yankees,0,Seattle Mariners,0,0,August 26 2019,0
Baltimore Orioles,0,Washington Nationals,0,0,August 27 2019,0
Pittsburgh Pirates,0,Philadelphia Phillies,0,0,August 27 2019,0
Atlanta Braves,0,Toronto Blue Jays,0,0,August 27 2019,0
Cleveland Indians,0,Detroit Tigers,0,0,August 27 2019,0
Chicago Cubs,0,New York Mets,0,0,August 27 2019,0
Cincinnati Reds,0,Miami Marlins,0,0,August 27 2019,0
St. Louis Cardinals,0,Milwaukee Brewers,0,0,August 27 2019,0
Tampa Bay Rays,0,Houston Astros,0,0,August 27 2019,0
Minnesota Twins,0,Chicago White Sox,0,0,August 27 2019,0
Oakland Athletics,0,Kansas City Royals,0,0,August 27 2019,0
Boston Red Sox,0,Colorado Rockies,0,0,August 27 2019,0
Arizona D'Backs,0,San Francisco Giants,0,0,August 27 2019,0
Texas Rangers,0,Los Angeles Angels,0,0,August 27 2019,0
Los Angeles Dodgers,0,San Diego Padres,0,0,August 27 2019,0
New York Yankees,0,Seattle Mariners,0,0,August 27 2019,0
St. Louis Cardinals,0,Milwaukee Brewers,0,0,August 28 2019,0
New York Yankees,0,Seattle Mariners,0,0,August 28 2019,0
Pittsburgh Pirates,0,Philadelphia Phillies,0,0,August 28 2019,0
Baltimore Orioles,0,Washington Nationals,0,0,August 28 2019,0
Atlanta Braves,0,Toronto Blue Jays,0,0,August 28 2019,0
Cincinnati Reds,0,Miami Marlins,0,0,August 28 2019,0
Cleveland Indians,0,Detroit Tigers,0,0,August 28 2019,0
Chicago Cubs,0,New York Mets,0,0,August 28 2019,0
Tampa Bay Rays,0,Houston Astros,0,0,August 28 2019,0
Minnesota Twins,0,Chicago White Sox,0,0,August 28 2019,0
Oakland Athletics,0,Kansas City Royals,0,0,August 28 2019,0
Boston Red Sox,0,Colorado Rockies,0,0,August 28 2019,0
Los Angeles Dodgers,0,San Diego Padres,0,0,August 28 2019,0
Texas Rangers,0,Los Angeles Angels,0,0,August 28 2019,0
Cleveland Indians,0,Detroit Tigers,0,0,August 29 2019,0
Oakland Athletics,0,Kansas City Royals,0,0,August 29 2019,0
Minnesota Twins,0,Chicago White Sox,0,0,August 29 2019,0
Tampa Bay Rays,0,Houston Astros,0,0,August 29 2019,0
Chicago Cubs,0,New York Mets,0,0,August 29 2019,0
Cincinnati Reds,0,Miami Marlins,0,0,August 29 2019,0
Seattle Mariners,0,Texas Rangers,0,0,August 29 2019,0
Pittsburgh Pirates,0,Colorado Rockies,0,0,August 29 2019,0
Los Angeles Dodgers,0,Arizona D'Backs,0,0,August 29 2019,0
San Diego Padres,0,San Francisco Giants,0,0,August 29 2019,0
Milwaukee Brewers,0,Chicago Cubs,0,0,August 30 2019,0
Miami Marlins,0,Washington Nationals,0,0,August 30 2019,0
New York Mets,0,Philadelphia Phillies,0,0,August 30 2019,0
Oakland Athletics,0,New York Yankees,0,0,August 30 2019,0
Houston Astros,0,Toronto Blue Jays,0,0,August 30 2019,0
Minnesota Twins,0,Detroit Tigers,0,0,August 30 2019,0
Cleveland Indians,0,Tampa Bay Rays,0,0,August 30 2019,0
Chicago White Sox,0,Atlanta Braves,0,0,August 30 2019,0
Seattle Mariners,0,Texas Rangers,0,0,August 30 2019,0
Baltimore Orioles,0,Kansas City Royals,0,0,August 30 2019,0
Cincinnati Reds,0,St. Louis Cardinals,0,0,August 30 2019,0
Pittsburgh Pirates,0,Colorado Rockies,0,0,August 30 2019,0
Los Angeles Dodgers,0,Arizona D'Backs,0,0,August 30 2019,0
Boston Red Sox,0,Los Angeles Angels,0,0,August 30 2019,0
San Diego Padres,0,San Francisco Giants,0,0,August 30 2019,0
Oakland Athletics,0,New York Yankees,0,0,August 31 2019,0
Milwaukee Brewers,0,Chicago Cubs,0,0,August 31 2019,0
Houston Astros,0,Toronto Blue Jays,0,0,August 31 2019,0
New York Mets,0,Philadelphia Phillies,0,0,August 31 2019,0
Cleveland Indians,0,Tampa Bay Rays,0,0,August 31 2019,0
Minnesota Twins,0,Detroit Tigers,0,0,August 31 2019,0
Miami Marlins,0,Washington Nationals,0,0,August 31 2019,0
Baltimore Orioles,0,Kansas City Royals,0,0,August 31 2019,0
Cincinnati Reds,0,St. Louis Cardinals,0,0,August 31 2019,0
Chicago White Sox,0,Atlanta Braves,0,0,August 31 2019,0
Seattle Mariners,0,Texas Rangers,0,0,August 31 2019,0
Pittsburgh Pirates,0,Colorado Rockies,0,0,August 31 2019,0
Los Angeles Dodgers,0,Arizona D'Backs,0,0,August 31 2019,0
San Diego Padres,0,San Francisco Giants,0,0,August 31 2019,0
Boston Red Sox,0,Los Angeles Angels,0,0,August 31 2019,0
Oakland Athletics,0,New York Yankees,0,0,September 1 2019,0
New York Mets,0,Philadelphia Phillies,0,0,September 1 2019,0
Houston Astros,0,Toronto Blue Jays,0,0,September 1 2019,0
Cleveland Indians,0,Tampa Bay Rays,0,0,September 1 2019,0
Minnesota Twins,0,Detroit Tigers,0,0,September 1 2019,0
Miami Marlins,0,Washington Nationals,0,0,September 1 2019,0
Baltimore Orioles,0,Kansas City Royals,0,0,September 1 2019,0
Cincinnati Reds,0,St. Louis Cardinals,0,0,September 1 2019,0
Milwaukee Brewers,0,Chicago Cubs,0,0,September 1 2019,0
Seattle Mariners,0,Texas Rangers,0,0,September 1 2019,0
Pittsburgh Pirates,0,Colorado Rockies,0,0,September 1 2019,0
San Diego Padres,0,San Francisco Giants,0,0,September 1 2019,0
Boston Red Sox,0,Los Angeles Angels,0,0,September 1 2019,0
Los Angeles Dodgers,0,Arizona D'Backs,0,0,September 1 2019,0
Chicago White Sox,0,Atlanta Braves,0,0,September 1 2019,0
New York Mets,0,Washington Nationals,0,0,September 2 2019,0
Texas Rangers,0,New York Yankees,0,0,September 2 2019,0
Baltimore Orioles,0,Tampa Bay Rays,0,0,September 2 2019,0
Minnesota Twins,0,Detroit Tigers,0,0,September 2 2019,0
Toronto Blue Jays,0,Atlanta Braves,0,0,September 2 2019,0
Philadelphia Phillies,0,Cincinnati Reds,0,0,September 2 2019,0
San Francisco Giants,0,St. Louis Cardinals,0,0,September 2 2019,0
Seattle Mariners,0,Chicago Cubs,0,0,September 2 2019,0
Houston Astros,0,Milwaukee Brewers,0,0,September 2 2019,0
San Diego Padres,0,Arizona D'Backs,0,0,September 2 2019,0
Chicago White Sox,0,Cleveland Indians,0,0,September 2 2019,0
Colorado Rockies,0,Los Angeles Dodgers,0,0,September 2 2019,0
Texas Rangers,0,New York Yankees,0,0,September 3 2019,0
Philadelphia Phillies,0,Cincinnati Reds,0,0,September 3 2019,0
New York Mets,0,Washington Nationals,0,0,September 3 2019,0
Miami Marlins,0,Pittsburgh Pirates,0,0,September 3 2019,0
Chicago White Sox,0,Cleveland Indians,0,0,September 3 2019,0
Minnesota Twins,0,Boston Red Sox,0,0,September 3 2019,0
Baltimore Orioles,0,Tampa Bay Rays,0,0,September 3 2019,0
Toronto Blue Jays,0,Atlanta Braves,0,0,September 3 2019,0
Houston Astros,0,Milwaukee Brewers,0,0,September 3 2019,0
San Francisco Giants,0,St. Louis Cardinals,0,0,September 3 2019,0
Seattle Mariners,0,Chicago Cubs,0,0,September 3 2019,0
Detroit Tigers,0,Kansas City Royals,0,0,September 3 2019,0
San Diego Padres,0,Arizona D'Backs,0,0,September 3 2019,0
Los Angeles Angels,0,Oakland Athletics,0,0,September 3 2019,0
Colorado Rockies,0,Los Angeles Dodgers,0,0,September 3 2019,0
New York Mets,0,Washington Nationals,0,0,September 4 2019,0
Baltimore Orioles,0,Tampa Bay Rays,0,0,September 4 2019,0
Texas Rangers,0,New York Yankees,0,0,September 4 2019,0
Philadelphia Phillies,0,Cincinnati Reds,0,0,September 4 2019,0
Miami Marlins,0,Pittsburgh Pirates,0,0,September 4 2019,0
Chicago White Sox,0,Cleveland Indians,0,0,September 4 2019,0
Minnesota Twins,0,Boston Red Sox,0,0,September 4 2019,0
San Francisco Giants,0,St. Louis Cardinals,0,0,September 4 2019,0
Detroit Tigers,0,Kansas City Royals,0,0,September 4 2019,0
San Diego Padres,0,Arizona D'Backs,0,0,September 4 2019,0
Los Angeles Angels,0,Oakland Athletics,0,0,September 4 2019,0
Colorado Rockies,0,Los Angeles Dodgers,0,0,September 4 2019,0
Philadelphia Phillies,0,Cincinnati Reds,0,0,September 5 2019,0
Chicago White Sox,0,Cleveland Indians,0,0,September 5 2019,0
Detroit Tigers,0,Kansas City Royals,0,0,September 5 2019,0
San Francisco Giants,0,St. Louis Cardinals,0,0,September 5 2019,0
Los Angeles Angels,0,Oakland Athletics,0,0,September 5 2019,0
Texas Rangers,0,Baltimore Orioles,0,0,September 5 2019,0
Miami Marlins,0,Pittsburgh Pirates,0,0,September 5 2019,0
Chicago Cubs,0,Milwaukee Brewers,0,0,September 5 2019,0
Toronto Blue Jays,0,Tampa Bay Rays,0,0,September 5 2019,0
Minnesota Twins,0,Boston Red Sox,0,0,September 5 2019,0
Washington Nationals,0,Atlanta Braves,0,0,September 5 2019,0
Seattle Mariners,0,Houston Astros,0,0,September 5 2019,0
Texas Rangers,0,Baltimore Orioles,0,0,September 6 2019,0
St. Louis Cardinals,0,Pittsburgh Pirates,0,0,September 6 2019,0
Toronto Blue Jays,0,Tampa Bay Rays,0,0,September 6 2019,0
Philadelphia Phillies,0,New York Mets,0,0,September 6 2019,0
Kansas City Royals,0,Miami Marlins,0,0,September 6 2019,0
New York Yankees,0,Boston Red Sox,0,0,September 6 2019,0
Arizona D'Backs,0,Cincinnati Reds,0,0,September 6 2019,0
Washington Nationals,0,Atlanta Braves,0,0,September 6 2019,0
Los Angeles Angels,0,Chicago White Sox,0,0,September 6 2019,0
Cleveland Indians,0,Minnesota Twins,0,0,September 6 2019,0
Chicago Cubs,0,Milwaukee Brewers,0,0,September 6 2019,0
Seattle Mariners,0,Houston Astros,0,0,September 6 2019,0
Detroit Tigers,0,Oakland Athletics,0,0,September 6 2019,0
San Francisco Giants,0,Los Angeles Dodgers,0,0,September 6 2019,0
Colorado Rockies,0,San Diego Padres,0,0,September 6 2019,0
New York Yankees,0,Boston Red Sox,0,0,September 7 2019,0
Arizona D'Backs,0,Cincinnati Reds,0,0,September 7 2019,0
Toronto Blue Jays,0,Tampa Bay Rays,0,0,September 7 2019,0
Kansas City Royals,0,Miami Marlins,0,0,September 7 2019,0
St. Louis Cardinals,0,Pittsburgh Pirates,0,0,September 7 2019,0
Texas Rangers,0,Baltimore Orioles,0,0,September 7 2019,0
Los Angeles Angels,0,Chicago White Sox,0,0,September 7 2019,0
Philadelphia Phillies,0,New York Mets,0,0,September 7 2019,0
Cleveland Indians,0,Minnesota Twins,0,0,September 7 2019,0
Chicago Cubs,0,Milwaukee Brewers,0,0,September 7 2019,0
Seattle Mariners,0,Houston Astros,0,0,September 7 2019,0
Washington Nationals,0,Atlanta Braves,0,0,September 7 2019,0
Colorado Rockies,0,San Diego Padres,0,0,September 7 2019,0
Detroit Tigers,0,Oakland Athletics,0,0,September 7 2019,0
San Francisco Giants,0,Los Angeles Dodgers,0,0,September 7 2019,0
Texas Rangers,0,Baltimore Orioles,0,0,September 8 2019,0
Toronto Blue Jays,0,Tampa Bay Rays,0,0,September 8 2019,0
Philadelphia Phillies,0,New York Mets,0,0,September 8 2019,0
Kansas City Royals,0,Miami Marlins,0,0,September 8 2019,0
Arizona D'Backs,0,Cincinnati Reds,0,0,September 8 2019,0
Washington Nationals,0,Atlanta Braves,0,0,September 8 2019,0
St. Louis Cardinals,0,Pittsburgh Pirates,0,0,September 8 2019,0
Seattle Mariners,0,Houston Astros,0,0,September 8 2019,0
Cleveland Indians,0,Minnesota Twins,0,0,September 8 2019,0
Chicago Cubs,0,Milwaukee Brewers,0,0,September 8 2019,0
Los Angeles Angels,0,Chicago White Sox,0,0,September 8 2019,0
Detroit Tigers,0,Oakland Athletics,0,0,September 8 2019,0
San Francisco Giants,0,Los Angeles Dodgers,0,0,September 8 2019,0
Colorado Rockies,0,San Diego Padres,0,0,September 8 2019,0
New York Yankees,0,Boston Red Sox,0,0,September 8 2019,0
Atlanta Braves,0,Philadelphia Phillies,0,0,September 9 2019,0
New York Yankees,0,Boston Red Sox,0,0,September 9 2019,0
Milwaukee Brewers,0,Miami Marlins,0,0,September 9 2019,0
Arizona D'Backs,0,New York Mets,0,0,September 9 2019,0
Oakland Athletics,0,Houston Astros,0,0,September 9 2019,0
Pittsburgh Pirates,0,San Francisco Giants,0,0,September 9 2019,0
Cleveland Indians,0,Los Angeles Angels,0,0,September 9 2019,0
Chicago Cubs,0,San Diego Padres,0,0,September 9 2019,0
New York Yankees,0,Detroit Tigers,0,0,September 10 2019,0
Los Angeles Dodgers,0,Baltimore Orioles,0,0,September 10 2019,0
Atlanta Braves,0,Philadelphia Phillies,0,0,September 10 2019,0
Boston Red Sox,0,Toronto Blue Jays,0,0,September 10 2019,0
Arizona D'Backs,0,New York Mets,0,0,September 10 2019,0
Milwaukee Brewers,0,Miami Marlins,0,0,September 10 2019,0
Washington Nationals,0,Minnesota Twins,0,0,September 10 2019,0
Tampa Bay Rays,0,Texas Rangers,0,0,September 10 2019,0
Oakland Athletics,0,Houston Astros,0,0,September 10 2019,0
Kansas City Royals,0,Chicago White Sox,0,0,September 10 2019,0
St. Louis Cardinals,0,Colorado Rockies,0,0,September 10 2019,0
Pittsburgh Pirates,0,San Francisco Giants,0,0,September 10 2019,0
Cleveland Indians,0,Los Angeles Angels,0,0,September 10 2019,0
Chicago Cubs,0,San Diego Padres,0,0,September 10 2019,0
Cincinnati Reds,0,Seattle Mariners,0,0,September 10 2019,0
New York Yankees,0,Detroit Tigers,0,0,September 11 2019,0
Los Angeles Dodgers,0,Baltimore Orioles,0,0,September 11 2019,0
Atlanta Braves,0,Philadelphia Phillies,0,0,September 11 2019,0
Boston Red Sox,0,Toronto Blue Jays,0,0,September 11 2019,0
Arizona D'Backs,0,New York Mets,0,0,September 11 2019,0
Milwaukee Brewers,0,Miami Marlins,0,0,September 11 2019,0
Washington Nationals,0,Minnesota Twins,0,0,September 11 2019,0
Tampa Bay Rays,0,Texas Rangers,0,0,September 11 2019,0
Cleveland Indians,0,Los Angeles Angels,0,0,September 11 2019,0
Oakland Athletics,0,Houston Astros,0,0,September 11 2019,0
Kansas City Royals,0,Chicago White Sox,0,0,September 11 2019,0
St. Louis Cardinals,0,Colorado Rockies,0,0,September 11 2019,0
Pittsburgh Pirates,0,San Francisco Giants,0,0,September 11 2019,0
Chicago Cubs,0,San Diego Padres,0,0,September 11 2019,0
Cincinnati Reds,0,Seattle Mariners,0,0,September 11 2019,0
Arizona D'Backs,0,New York Mets,0,0,September 12 2019,0
New York Yankees,0,Detroit Tigers,0,0,September 12 2019,0
Milwaukee Brewers,0,Miami Marlins,0,0,September 12 2019,0
Kansas City Royals,0,Chicago White Sox,0,0,September 12 2019,0
St. Louis Cardinals,0,Colorado Rockies,0,0,September 12 2019,0
Chicago Cubs,0,San Diego Padres,0,0,September 12 2019,0
Pittsburgh Pirates,0,San Francisco Giants,0,0,September 12 2019,0
Atlanta Braves,0,Philadelphia Phillies,0,0,September 12 2019,0
Los Angeles Dodgers,0,Baltimore Orioles,0,0,September 12 2019,0
Boston Red Sox,0,Toronto Blue Jays,0,0,September 12 2019,0
Washington Nationals,0,Minnesota Twins,0,0,September 12 2019,0
Tampa Bay Rays,0,Texas Rangers,0,0,September 12 2019,0
Oakland Athletics,0,Houston Astros,0,0,September 12 2019,0
Cincinnati Reds,0,Seattle Mariners,0,0,September 12 2019,0
Pittsburgh Pirates,0,Chicago Cubs,0,0,September 13 2019,0
Atlanta Braves,0,Washington Nationals,0,0,September 13 2019,0
New York Yankees,0,Toronto Blue Jays,0,0,September 13 2019,0
Los Angeles Dodgers,0,New York Mets,0,0,September 13 2019,0
Baltimore Orioles,0,Detroit Tigers,0,0,September 13 2019,0
Minnesota Twins,0,Cleveland Indians,0,0,September 13 2019,0
Oakland Athletics,0,Texas Rangers,0,0,September 13 2019,0
Houston Astros,0,Kansas City Royals,0,0,September 13 2019,0
Milwaukee Brewers,0,St. Louis Cardinals,0,0,September 13 2019,0
San Diego Padres,0,Colorado Rockies,0,0,September 13 2019,0
Cincinnati Reds,0,Arizona D'Backs,0,0,September 13 2019,0
Tampa Bay Rays,0,Los Angeles Angels,0,0,September 13 2019,0
Chicago White Sox,0,Seattle Mariners,0,0,September 13 2019,0
Miami Marlins,0,San Francisco Giants,0,0,September 13 2019,0
Pittsburgh Pirates,0,Chicago Cubs,0,0,September 14 2019,0
New York Yankees,0,Toronto Blue Jays,0,0,September 14 2019,0
Atlanta Braves,0,Washington Nationals,0,0,September 14 2019,0
Baltimore Orioles,0,Detroit Tigers,0,0,September 14 2019,0
Boston Red Sox,0,Philadelphia Phillies,0,0,September 14 2019,0
Los Angeles Dodgers,0,New York Mets,0,0,September 14 2019,0
Minnesota Twins,0,Cleveland Indians,0,0,September 14 2019,0
Houston Astros,0,Kansas City Royals,0,0,September 14 2019,0
Milwaukee Brewers,0,St. Louis Cardinals,0,0,September 14 2019,0
Oakland Athletics,0,Texas Rangers,0,0,September 14 2019,0
San Diego Padres,0,Colorado Rockies,0,0,September 14 2019,0
Cincinnati Reds,0,Arizona D'Backs,0,0,September 14 2019,0
Miami Marlins,0,San Francisco Giants,0,0,September 14 2019,0
Tampa Bay Rays,0,Los Angeles Angels,0,0,September 14 2019,0
Chicago White Sox,0,Seattle Mariners,0,0,September 14 2019,0
Boston Red Sox,0,Philadelphia Phillies,0,0,September 15 2019,0
New York Yankees,0,Toronto Blue Jays,0,0,September 15 2019,0
Los Angeles Dodgers,0,New York Mets,0,0,September 15 2019,0
Minnesota Twins,0,Cleveland Indians,0,0,September 15 2019,0
Baltimore Orioles,0,Detroit Tigers,0,0,September 15 2019,0
Atlanta Braves,0,Washington Nationals,0,0,September 15 2019,0
Houston Astros,0,Kansas City Royals,0,0,September 15 2019,0
Milwaukee Brewers,0,St. Louis Cardinals,0,0,September 15 2019,0
Pittsburgh Pirates,0,Chicago Cubs,0,0,September 15 2019,0
Oakland Athletics,0,Texas Rangers,0,0,September 15 2019,0
San Diego Padres,0,Colorado Rockies,0,0,September 15 2019,0
Miami Marlins,0,San Francisco Giants,0,0,September 15 2019,0
Tampa Bay Rays,0,Los Angeles Angels,0,0,September 15 2019,0
Chicago White Sox,0,Seattle Mariners,0,0,September 15 2019,0
Cincinnati Reds,0,Arizona D'Backs,0,0,September 15 2019,0
Baltimore Orioles,0,Detroit Tigers,0,0,September 16 2019,0
San Diego Padres,0,Milwaukee Brewers,0,0,September 16 2019,0
Chicago White Sox,0,Minnesota Twins,0,0,September 16 2019,0
Washington Nationals,0,St. Louis Cardinals,0,0,September 16 2019,0
Cincinnati Reds,0,Chicago Cubs,0,0,September 16 2019,0
New York Mets,0,Colorado Rockies,0,0,September 16 2019,0
Miami Marlins,0,Arizona D'Backs,0,0,September 16 2019,0
Kansas City Royals,0,Oakland Athletics,0,0,September 16 2019,0
Los Angeles Angels,0,New York Yankees,0,0,September 17 2019,0
Toronto Blue Jays,0,Baltimore Orioles,0,0,September 17 2019,0
Seattle Mariners,0,Pittsburgh Pirates,0,0,September 17 2019,0
Detroit Tigers,0,Cleveland Indians,0,0,September 17 2019,0
San Francisco Giants,0,Boston Red Sox,0,0,September 17 2019,0
Philadelphia Phillies,0,Atlanta Braves,0,0,September 17 2019,0
Chicago White Sox,0,Minnesota Twins,0,0,September 17 2019,0
San Diego Padres,0,Milwaukee Brewers,0,0,September 17 2019,0
Washington Nationals,0,St. Louis Cardinals,0,0,September 17 2019,0
Cincinnati Reds,0,Chicago Cubs,0,0,September 17 2019,0
Texas Rangers,0,Houston Astros,0,0,September 17 2019,0
New York Mets,0,Colorado Rockies,0,0,September 17 2019,0
Miami Marlins,0,Arizona D'Backs,0,0,September 17 2019,0
Kansas City Royals,0,Oakland Athletics,0,0,September 17 2019,0
Tampa Bay Rays,0,Los Angeles Dodgers,0,0,September 17 2019,0
Washington Nationals,0,St. Louis Cardinals,0,0,September 18 2019,0
New York Mets,0,Colorado Rockies,0,0,September 18 2019,0
Kansas City Royals,0,Oakland Athletics,0,0,September 18 2019,0
Miami Marlins,0,Arizona D'Backs,0,0,September 18 2019,0
Los Angeles Angels,0,New York Yankees,0,0,September 18 2019,0
Toronto Blue Jays,0,Baltimore Orioles,0,0,September 18 2019,0
Seattle Mariners,0,Pittsburgh Pirates,0,0,September 18 2019,0
Detroit Tigers,0,Cleveland Indians,0,0,September 18 2019,0
San Francisco Giants,0,Boston Red Sox,0,0,September 18 2019,0
Philadelphia Phillies,0,Atlanta Braves,0,0,September 18 2019,0
San Diego Padres,0,Milwaukee Brewers,0,0,September 18 2019,0
Chicago White Sox,0,Minnesota Twins,0,0,September 18 2019,0
Cincinnati Reds,0,Chicago Cubs,0,0,September 18 2019,0
Tampa Bay Rays,0,Los Angeles Dodgers,0,0,September 18 2019,0
Texas Rangers,0,Houston Astros,0,0,September 18 2019,0
Philadelphia Phillies,0,Atlanta Braves,0,0,September 19 2019,0
Seattle Mariners,0,Pittsburgh Pirates,0,0,September 19 2019,0
San Francisco Giants,0,Boston Red Sox,0,0,September 19 2019,0
San Diego Padres,0,Milwaukee Brewers,0,0,September 19 2019,0
Los Angeles Angels,0,New York Yankees,0,0,September 19 2019,0
Toronto Blue Jays,0,Baltimore Orioles,0,0,September 19 2019,0
Detroit Tigers,0,Cleveland Indians,0,0,September 19 2019,0
Kansas City Royals,0,Minnesota Twins,0,0,September 19 2019,0
St. Louis Cardinals,0,Chicago Cubs,0,0,September 19 2019,0
St. Louis Cardinals,0,Chicago Cubs,0,0,September 20 2019,0
Seattle Mariners,0,Baltimore Orioles,0,0,September 20 2019,0
Toronto Blue Jays,0,New York Yankees,0,0,September 20 2019,0
Boston Red Sox,0,Tampa Bay Rays,0,0,September 20 2019,0
New York Mets,0,Cincinnati Reds,0,0,September 20 2019,0
Philadelphia Phillies,0,Cleveland Indians,0,0,September 20 2019,0
Chicago White Sox,0,Detroit Tigers,0,0,September 20 2019,0
Washington Nationals,0,Miami Marlins,0,0,September 20 2019,0
San Francisco Giants,0,Atlanta Braves,0,0,September 20 2019,0
Pittsburgh Pirates,0,Milwaukee Brewers,0,0,September 20 2019,0
Kansas City Royals,0,Minnesota Twins,0,0,September 20 2019,0
Los Angeles Angels,0,Houston Astros,0,0,September 20 2019,0
Texas Rangers,0,Oakland Athletics,0,0,September 20 2019,0
Arizona D'Backs,0,San Diego Padres,0,0,September 20 2019,0
Colorado Rockies,0,Los Angeles Dodgers,0,0,September 20 2019,0
Toronto Blue Jays,0,New York Yankees,0,0,September 21 2019,0
St. Louis Cardinals,0,Chicago Cubs,0,0,September 21 2019,0
New York Mets,0,Cincinnati Reds,0,0,September 21 2019,0
Boston Red Sox,0,Tampa Bay Rays,0,0,September 21 2019,0
Washington Nationals,0,Miami Marlins,0,0,September 21 2019,0
Chicago White Sox,0,Detroit Tigers,0,0,September 21 2019,0
Seattle Mariners,0,Baltimore Orioles,0,0,September 21 2019,0
Los Angeles Angels,0,Houston Astros,0,0,September 21 2019,0
Philadelphia Phillies,0,Cleveland Indians,0,0,September 21 2019,0
Pittsburgh Pirates,0,Milwaukee Brewers,0,0,September 21 2019,0
Kansas City Royals,0,Minnesota Twins,0,0,September 21 2019,0
San Francisco Giants,0,Atlanta Braves,0,0,September 21 2019,0
Arizona D'Backs,0,San Diego Padres,0,0,September 21 2019,0
Texas Rangers,0,Oakland Athletics,0,0,September 21 2019,0
Colorado Rockies,0,Los Angeles Dodgers,0,0,September 21 2019,0
Seattle Mariners,0,Baltimore Orioles,0,0,September 22 2019,0
Toronto Blue Jays,0,New York Yankees,0,0,September 22 2019,0
Boston Red Sox,0,Tampa Bay Rays,0,0,September 22 2019,0
New York Mets,0,Cincinnati Reds,0,0,September 22 2019,0
Philadelphia Phillies,0,Cleveland Indians,0,0,September 22 2019,0
Chicago White Sox,0,Detroit Tigers,0,0,September 22 2019,0
Washington Nationals,0,Miami Marlins,0,0,September 22 2019,0
San Francisco Giants,0,Atlanta Braves,0,0,September 22 2019,0
Los Angeles Angels,0,Houston Astros,0,0,September 22 2019,0
Pittsburgh Pirates,0,Milwaukee Brewers,0,0,September 22 2019,0
Kansas City Royals,0,Minnesota Twins,0,0,September 22 2019,0
St. Louis Cardinals,0,Chicago Cubs,0,0,September 22 2019,0
Texas Rangers,0,Oakland Athletics,0,0,September 22 2019,0
Arizona D'Backs,0,San Diego Padres,0,0,September 22 2019,0
Colorado Rockies,0,Los Angeles Dodgers,0,0,September 22 2019,0
Philadelphia Phillies,0,Washington Nationals,0,0,September 23 2019,0
Baltimore Orioles,0,Toronto Blue Jays,0,0,September 23 2019,0
Miami Marlins,0,New York Mets,0,0,September 23 2019,0
Boston Red Sox,0,Tampa Bay Rays,0,0,September 23 2019,0
St. Louis Cardinals,0,Arizona D'Backs,0,0,September 23 2019,0
Minnesota Twins,0,Detroit Tigers,0,0,September 24 2019,0
Milwaukee Brewers,0,Cincinnati Reds,0,0,September 24 2019,0
Philadelphia Phillies,0,Washington Nationals,0,0,September 24 2019,0
Chicago Cubs,0,Pittsburgh Pirates,0,0,September 24 2019,0
Baltimore Orioles,0,Toronto Blue Jays,0,0,September 24 2019,0
Miami Marlins,0,New York Mets,0,0,September 24 2019,0
New York Yankees,0,Tampa Bay Rays,0,0,September 24 2019,0
Boston Red Sox,0,Texas Rangers,0,0,September 24 2019,0
Cleveland Indians,0,Chicago White Sox,0,0,September 24 2019,0
Atlanta Braves,0,Kansas City Royals,0,0,September 24 2019,0
St. Louis Cardinals,0,Arizona D'Backs,0,0,September 24 2019,0
Colorado Rockies,0,San Francisco Giants,0,0,September 24 2019,0
Oakland Athletics,0,Los Angeles Angels,0,0,September 24 2019,0
Los Angeles Dodgers,0,San Diego Padres,0,0,September 24 2019,0
Houston Astros,0,Seattle Mariners,0,0,September 24 2019,0
St. Louis Cardinals,0,Arizona D'Backs,0,0,September 25 2019,0
Milwaukee Brewers,0,Cincinnati Reds,0,0,September 25 2019,0
Minnesota Twins,0,Detroit Tigers,0,0,September 25 2019,0
Philadelphia Phillies,0,Washington Nationals,0,0,September 25 2019,0
Chicago Cubs,0,Pittsburgh Pirates,0,0,September 25 2019,0
Baltimore Orioles,0,Toronto Blue Jays,0,0,September 25 2019,0
Miami Marlins,0,New York Mets,0,0,September 25 2019,0
New York Yankees,0,Tampa Bay Rays,0,0,September 25 2019,0
Boston Red Sox,0,Texas Rangers,0,0,September 25 2019,0
Cleveland Indians,0,Chicago White Sox,0,0,September 25 2019,0
Atlanta Braves,0,Kansas City Royals,0,0,September 25 2019,0
Colorado Rockies,0,San Francisco Giants,0,0,September 25 2019,0
Oakland Athletics,0,Los Angeles Angels,0,0,September 25 2019,0
Houston Astros,0,Seattle Mariners,0,0,September 25 2019,0
Los Angeles Dodgers,0,San Diego Padres,0,0,September 25 2019,0
Milwaukee Brewers,0,Cincinnati Reds,0,0,September 26 2019,0
Minnesota Twins,0,Detroit Tigers,0,0,September 26 2019,0
Boston Red Sox,0,Texas Rangers,0,0,September 26 2019,0
Los Angeles Dodgers,0,San Diego Padres,0,0,September 26 2019,0
Colorado Rockies,0,San Francisco Giants,0,0,September 26 2019,0
Philadelphia Phillies,0,Washington Nationals,0,0,September 26 2019,0
Chicago Cubs,0,Pittsburgh Pirates,0,0,September 26 2019,0
Miami Marlins,0,New York Mets,0,0,September 26 2019,0
Cleveland Indians,0,Chicago White Sox,0,0,September 26 2019,0
Houston Astros,0,Los Angeles Angels,0,0,September 26 2019,0
Oakland Athletics,0,Seattle Mariners,0,0,September 26 2019,0
Cleveland Indians,0,Washington Nationals,0,0,September 27 2019,0
Cincinnati Reds,0,Pittsburgh Pirates,0,0,September 27 2019,0
Miami Marlins,0,Philadelphia Phillies,0,0,September 27 2019,0
Tampa Bay Rays,0,Toronto Blue Jays,0,0,September 27 2019,0
Atlanta Braves,0,New York Mets,0,0,September 27 2019,0
Baltimore Orioles,0,Boston Red Sox,0,0,September 27 2019,0
New York Yankees,0,Texas Rangers,0,0,September 27 2019,0
Detroit Tigers,0,Chicago White Sox,0,0,September 27 2019,0
Milwaukee Brewers,0,Colorado Rockies,0,0,September 27 2019,0
Minnesota Twins,0,Kansas City Royals,0,0,September 27 2019,0
Chicago Cubs,0,St. Louis Cardinals,0,0,September 27 2019,0
San Diego Padres,0,Arizona D'Backs,0,0,September 27 2019,0
Houston Astros,0,Los Angeles Angels,0,0,September 27 2019,0
Oakland Athletics,0,Seattle Mariners,0,0,September 27 2019,0
Los Angeles Dodgers,0,San Francisco Giants,0,0,September 27 2019,0
Baltimore Orioles,0,Boston Red Sox,0,0,September 28 2019,0
Tampa Bay Rays,0,Toronto Blue Jays,0,0,September 28 2019,0
Cleveland Indians,0,Washington Nationals,0,0,September 28 2019,0
Los Angeles Dodgers,0,San Francisco Giants,0,0,September 28 2019,0
Miami Marlins,0,Philadelphia Phillies,0,0,September 28 2019,0
Cincinnati Reds,0,Pittsburgh Pirates,0,0,September 28 2019,0
Detroit Tigers,0,Chicago White Sox,0,0,September 28 2019,0
Atlanta Braves,0,New York Mets,0,0,September 28 2019,0
Chicago Cubs,0,St. Louis Cardinals,0,0,September 28 2019,0
Minnesota Twins,0,Kansas City Royals,0,0,September 28 2019,0
New York Yankees,0,Texas Rangers,0,0,September 28 2019,0
Milwaukee Brewers,0,Colorado Rockies,0,0,September 28 2019,0
San Diego Padres,0,Arizona D'Backs,0,0,September 28 2019,0
Houston Astros,0,Los Angeles Angels,0,0,September 28 2019,0
Oakland Athletics,0,Seattle Mariners,0,0,September 28 2019,0
Cleveland Indians,0,Washington Nationals,0,0,September 29 2019,0
New York Yankees,0,Texas Rangers,0,0,September 29 2019,0
Los Angeles Dodgers,0,San Francisco Giants,0,0,September 29 2019,0
Cincinnati Reds,0,Pittsburgh Pirates,0,0,September 29 2019,0
Miami Marlins,0,Philadelphia Phillies,0,0,September 29 2019,0
Baltimore Orioles,0,Boston Red Sox,0,0,September 29 2019,0
Tampa Bay Rays,0,Toronto Blue Jays,0,0,September 29 2019,0
Houston Astros,0,Los Angeles Angels,0,0,September 29 2019,0
Detroit Tigers,0,Chicago White Sox,0,0,September 29 2019,0
Oakland Athletics,0,Seattle Mariners,0,0,September 29 2019,0
Milwaukee Brewers,0,Colorado Rockies,0,0,September 29 2019,0
San Diego Padres,0,Arizona D'Backs,0,0,September 29 2019,0
Atlanta Braves,0,New York Mets,0,0,September 29 2019,0
Chicago Cubs,0,St. Louis Cardinals,0,0,September 29 2019,0
Minnesota Twins,0,Kansas City Royals,0,0,September 29 2019,0
