Away,HW,Home,Total_Runs,awayRuns,date,homeRuns
Baltimore Orioles,0,Toronto Blue Jays,3,2,April 13 2017,1
San Diego Padres,1,Atlanta Braves,7,2,April 14 2017,5
Tampa Bay Rays,0,Boston Red Sox,15,10,April 14 2017,5
Pittsburgh Pirates,0,Chicago Cubs,6,4,April 14 2017,2
Milwaukee Brewers,0,Cincinnati Reds,14,10,April 14 2017,4
Detroit Tigers,0,Cleveland Indians,13,7,April 14 2017,6
Los Angeles Angels,1,Kansas City Royals,8,1,April 14 2017,7
Arizona D'Backs,1,Los Angeles Dodgers,8,1,April 14 2017,7
New York Mets,1,Miami Marlins,5,2,April 14 2017,3
Chicago White Sox,0,Minnesota Twins,3,2,April 14 2017,1
St. Louis Cardinals,1,New York Yankees,7,3,April 14 2017,4
Houston Astros,0,Oakland Athletics,9,7,April 14 2017,2
Texas Rangers,1,Seattle Mariners,3,1,April 14 2017,2
Colorado Rockies,1,San Francisco Giants,10,2,April 14 2017,8
Baltimore Orioles,0,Toronto Blue Jays,10,6,April 14 2017,4
Philadelphia Phillies,1,Washington Nationals,5,2,April 14 2017,3
San Diego Padres,1,Atlanta Braves,6,2,April 15 2017,4
Tampa Bay Rays,1,Boston Red Sox,3,1,April 15 2017,2
Pittsburgh Pirates,0,Chicago Cubs,15,8,April 15 2017,7
Milwaukee Brewers,1,Cincinnati Reds,12,5,April 15 2017,7
Detroit Tigers,1,Cleveland Indians,19,6,April 15 2017,13
Los Angeles Angels,1,Kansas City Royals,5,2,April 15 2017,3
Arizona D'Backs,1,Los Angeles Dodgers,12,4,April 15 2017,8
New York Mets,1,Miami Marlins,9,4,April 15 2017,5
Chicago White Sox,1,Minnesota Twins,6,0,April 15 2017,6
St. Louis Cardinals,1,New York Yankees,5,2,April 15 2017,3
Houston Astros,0,Oakland Athletics,16,10,April 15 2017,6
Texas Rangers,1,Seattle Mariners,5,0,April 15 2017,5
Colorado Rockies,0,San Francisco Giants,5,5,April 15 2017,0
Baltimore Orioles,1,Toronto Blue Jays,3,1,April 15 2017,2
Philadelphia Phillies,0,Washington Nationals,6,4,April 15 2017,2
San Diego Padres,1,Atlanta Braves,11,2,April 16 2017,9
Tampa Bay Rays,1,Boston Red Sox,12,5,April 16 2017,7
Pittsburgh Pirates,0,Chicago Cubs,7,6,April 16 2017,1
Milwaukee Brewers,0,Cincinnati Reds,6,4,April 16 2017,2
Detroit Tigers,0,Cleveland Indians,5,4,April 16 2017,1
Los Angeles Angels,1,Kansas City Royals,1,0,April 16 2017,1
Arizona D'Backs,0,Los Angeles Dodgers,4,3,April 16 2017,1
New York Mets,1,Miami Marlins,6,2,April 16 2017,4
Chicago White Sox,0,Minnesota Twins,4,3,April 16 2017,1
St. Louis Cardinals,1,New York Yankees,12,3,April 16 2017,9
Texas Rangers,1,Seattle Mariners,15,7,April 16 2017,8
Colorado Rockies,0,San Francisco Giants,7,4,April 16 2017,3
Baltimore Orioles,0,Toronto Blue Jays,15,11,April 16 2017,4
Philadelphia Phillies,1,Washington Nationals,10,4,April 16 2017,6
San Diego Padres,1,Atlanta Braves,9,4,April 17 2017,5
Tampa Bay Rays,1,Boston Red Sox,7,3,April 17 2017,4
Milwaukee Brewers,0,Chicago Cubs,9,6,April 17 2017,3
Los Angeles Angels,1,Houston Astros,3,0,April 17 2017,3
Arizona D'Backs,0,Los Angeles Dodgers,6,4,April 17 2017,2
Cleveland Indians,0,Minnesota Twins,4,3,April 17 2017,1
Chicago White Sox,1,New York Yankees,11,4,April 17 2017,7
Texas Rangers,0,Oakland Athletics,7,7,April 17 2017,0
Miami Marlins,1,Seattle Mariners,7,1,April 17 2017,6
Pittsburgh Pirates,1,St. Louis Cardinals,3,1,April 17 2017,2
Washington Nationals,0,Atlanta Braves,4,3,April 18 2017,1
Milwaukee Brewers,1,Chicago Cubs,16,7,April 18 2017,9
Baltimore Orioles,1,Cincinnati Reds,12,3,April 18 2017,9
Los Angeles Angels,0,Houston Astros,7,5,April 18 2017,2
San Francisco Giants,0,Kansas City Royals,3,2,April 18 2017,1
Colorado Rockies,0,Los Angeles Dodgers,7,4,April 18 2017,3
Cleveland Indians,0,Minnesota Twins,15,11,April 18 2017,4
Chicago White Sox,0,New York Yankees,5,4,April 18 2017,1
Philadelphia Phillies,0,New York Mets,8,6,April 18 2017,2
Texas Rangers,1,Oakland Athletics,6,2,April 18 2017,4
Arizona D'Backs,0,San Diego Padres,13,11,April 18 2017,2
Miami Marlins,0,Seattle Mariners,5,5,April 18 2017,0
Pittsburgh Pirates,1,St. Louis Cardinals,3,1,April 18 2017,2
Detroit Tigers,1,Tampa Bay Rays,6,1,April 18 2017,5
Boston Red Sox,0,Toronto Blue Jays,15,8,April 18 2017,7
Washington Nationals,0,Atlanta Braves,18,14,April 19 2017,4
Milwaukee Brewers,1,Chicago Cubs,11,4,April 19 2017,7
Baltimore Orioles,0,Cincinnati Reds,2,2,April 19 2017,0
Los Angeles Angels,1,Houston Astros,6,1,April 19 2017,5
San Francisco Giants,1,Kansas City Royals,2,0,April 19 2017,2
Colorado Rockies,1,Los Angeles Dodgers,6,2,April 19 2017,4
Chicago White Sox,1,New York Yankees,10,1,April 19 2017,9
Philadelphia Phillies,1,New York Mets,9,4,April 19 2017,5
Texas Rangers,1,Oakland Athletics,10,1,April 19 2017,9
Arizona D'Backs,1,San Diego Padres,1,0,April 19 2017,1
Miami Marlins,1,Seattle Mariners,15,5,April 19 2017,10
Pittsburgh Pirates,1,St. Louis Cardinals,3,1,April 19 2017,2
Detroit Tigers,1,Tampa Bay Rays,15,7,April 19 2017,8
Boston Red Sox,1,Toronto Blue Jays,3,0,April 19 2017,3
Washington Nationals,0,Atlanta Braves,5,3,April 20 2017,2
Baltimore Orioles,0,Cincinnati Reds,3,2,April 20 2017,1
Los Angeles Angels,1,Houston Astros,3,1,April 20 2017,2
St. Louis Cardinals,1,Milwaukee Brewers,12,5,April 20 2017,7
Cleveland Indians,0,Minnesota Twins,8,6,April 20 2017,2
Philadelphia Phillies,0,New York Mets,10,6,April 20 2017,4
Seattle Mariners,1,Oakland Athletics,15,6,April 20 2017,9
Arizona D'Backs,1,San Diego Padres,5,1,April 20 2017,4
Detroit Tigers,1,Tampa Bay Rays,9,1,April 20 2017,8
Kansas City Royals,1,Texas Rangers,1,0,April 20 2017,1
Boston Red Sox,0,Toronto Blue Jays,5,4,April 20 2017,1
Toronto Blue Jays,0,Los Angeles Angels,15,8,April 21 2017,7
Los Angeles Dodgers,1,Arizona D'Backs,18,5,April 21 2017,13
Boston Red Sox,1,Baltimore Orioles,2,0,April 21 2017,2
Cleveland Indians,0,Chicago White Sox,3,3,April 21 2017,0
Chicago Cubs,0,Cincinnati Reds,11,6,April 21 2017,5
San Francisco Giants,1,Colorado Rockies,11,5,April 21 2017,6
St. Louis Cardinals,0,Milwaukee Brewers,9,6,April 21 2017,3
Detroit Tigers,1,Minnesota Twins,9,3,April 21 2017,6
Washington Nationals,0,New York Mets,7,4,April 21 2017,3
Seattle Mariners,1,Oakland Athletics,4,1,April 21 2017,3
Atlanta Braves,1,Philadelphia Phillies,7,3,April 21 2017,4
New York Yankees,1,Pittsburgh Pirates,9,3,April 21 2017,6
Miami Marlins,1,San Diego Padres,8,3,April 21 2017,5
Houston Astros,0,Tampa Bay Rays,9,6,April 21 2017,3
Kansas City Royals,1,Texas Rangers,8,2,April 21 2017,6
Toronto Blue Jays,1,Los Angeles Angels,9,4,April 22 2017,5
Los Angeles Dodgers,1,Arizona D'Backs,16,5,April 22 2017,11
Boston Red Sox,1,Baltimore Orioles,6,2,April 22 2017,4
Cleveland Indians,0,Chicago White Sox,7,7,April 22 2017,0
Chicago Cubs,0,Cincinnati Reds,20,12,April 22 2017,8
San Francisco Giants,1,Colorado Rockies,15,3,April 22 2017,12
St. Louis Cardinals,0,Milwaukee Brewers,5,4,April 22 2017,1
Detroit Tigers,0,Minnesota Twins,9,5,April 22 2017,4
Washington Nationals,0,New York Mets,4,3,April 22 2017,1
Seattle Mariners,1,Oakland Athletics,7,3,April 22 2017,4
Atlanta Braves,1,Philadelphia Phillies,7,3,April 22 2017,4
New York Yankees,0,Pittsburgh Pirates,16,11,April 22 2017,5
Miami Marlins,0,San Diego Padres,9,6,April 22 2017,3
Houston Astros,1,Tampa Bay Rays,9,3,April 22 2017,6
Kansas City Royals,1,Texas Rangers,3,1,April 22 2017,2
Toronto Blue Jays,0,Los Angeles Angels,8,6,April 23 2017,2
Los Angeles Dodgers,0,Arizona D'Backs,8,6,April 23 2017,2
Boston Red Sox,0,Baltimore Orioles,8,6,April 23 2017,2
Cleveland Indians,1,Chicago White Sox,8,2,April 23 2017,6
Chicago Cubs,1,Cincinnati Reds,12,5,April 23 2017,7
San Francisco Giants,1,Colorado Rockies,8,0,April 23 2017,8
St. Louis Cardinals,0,Milwaukee Brewers,10,6,April 23 2017,4
Detroit Tigers,0,Minnesota Twins,17,13,April 23 2017,4
Washington Nationals,0,New York Mets,9,6,April 23 2017,3
Seattle Mariners,0,Oakland Athletics,12,11,April 23 2017,1
Atlanta Braves,1,Philadelphia Phillies,7,2,April 23 2017,5
New York Yankees,1,Pittsburgh Pirates,3,1,April 23 2017,2
Miami Marlins,0,San Diego Padres,10,7,April 23 2017,3
Houston Astros,0,Tampa Bay Rays,10,6,April 23 2017,4
Kansas City Royals,1,Texas Rangers,7,2,April 23 2017,5
Toronto Blue Jays,1,Los Angeles Angels,3,1,April 24 2017,2
San Diego Padres,1,Arizona D'Backs,13,6,April 24 2017,7
Tampa Bay Rays,1,Baltimore Orioles,9,3,April 24 2017,6
Kansas City Royals,1,Chicago White Sox,13,1,April 24 2017,12
Washington Nationals,1,Colorado Rockies,12,4,April 24 2017,8
Cincinnati Reds,1,Milwaukee Brewers,18,7,April 24 2017,11
Chicago Cubs,0,Pittsburgh Pirates,17,14,April 24 2017,3
Los Angeles Dodgers,1,San Francisco Giants,3,1,April 24 2017,2
Minnesota Twins,0,Texas Rangers,5,3,April 24 2017,2
Oakland Athletics,1,Los Angeles Angels,3,1,April 25 2017,2
San Diego Padres,1,Arizona D'Backs,12,3,April 25 2017,9
Tampa Bay Rays,0,Baltimore Orioles,2,2,April 25 2017,0
Kansas City Royals,1,Chicago White Sox,15,5,April 25 2017,10
Houston Astros,0,Cleveland Indians,6,4,April 25 2017,2
Washington Nationals,0,Colorado Rockies,27,15,April 25 2017,12
Seattle Mariners,1,Detroit Tigers,28,9,April 25 2017,19
Cincinnati Reds,1,Milwaukee Brewers,10,1,April 25 2017,9
Chicago Cubs,0,Pittsburgh Pirates,1,1,April 25 2017,0
Los Angeles Dodgers,0,San Francisco Giants,3,2,April 25 2017,1
Toronto Blue Jays,0,St. Louis Cardinals,11,6,April 25 2017,5
Minnesota Twins,0,Texas Rangers,9,8,April 25 2017,1
Oakland Athletics,1,Los Angeles Angels,13,5,April 26 2017,8
San Diego Padres,0,Arizona D'Backs,13,8,April 26 2017,5
Tampa Bay Rays,1,Baltimore Orioles,9,4,April 26 2017,5
New York Yankees,0,Boston Red Sox,4,3,April 26 2017,1
Kansas City Royals,1,Chicago White Sox,7,2,April 26 2017,5
Houston Astros,1,Cleveland Indians,13,6,April 26 2017,7
Washington Nationals,0,Colorado Rockies,15,11,April 26 2017,4
Seattle Mariners,0,Detroit Tigers,8,8,April 26 2017,0
Cincinnati Reds,1,Milwaukee Brewers,13,4,April 26 2017,9
Atlanta Braves,0,New York Mets,10,8,April 26 2017,2
Miami Marlins,1,Philadelphia Phillies,11,4,April 26 2017,7
Chicago Cubs,1,Pittsburgh Pirates,11,5,April 26 2017,6
Los Angeles Dodgers,1,San Francisco Giants,7,3,April 26 2017,4
Minnesota Twins,1,Texas Rangers,17,3,April 26 2017,14
Oakland Athletics,1,Los Angeles Angels,3,1,April 27 2017,2
San Diego Padres,1,Arizona D'Backs,8,2,April 27 2017,6
New York Yankees,0,Boston Red Sox,3,3,April 27 2017,0
Houston Astros,1,Cleveland Indians,7,3,April 27 2017,4
Washington Nationals,0,Colorado Rockies,21,16,April 27 2017,5
Seattle Mariners,0,Detroit Tigers,3,2,April 27 2017,1
Atlanta Braves,0,New York Mets,12,7,April 27 2017,5
Miami Marlins,1,Philadelphia Phillies,5,2,April 27 2017,3
Los Angeles Dodgers,0,San Francisco Giants,6,5,April 27 2017,1
Toronto Blue Jays,1,St. Louis Cardinals,12,4,April 27 2017,8
Toronto Blue Jays,1,St. Louis Cardinals,10,4,April 27 2017,6
Colorado Rockies,0,Arizona D'Backs,4,3,April 28 2017,1
Chicago Cubs,1,Boston Red Sox,9,4,April 28 2017,5
Seattle Mariners,0,Cleveland Indians,4,3,April 28 2017,1
Chicago White Sox,0,Detroit Tigers,10,7,April 28 2017,3
Oakland Athletics,1,Houston Astros,13,4,April 28 2017,9
Minnesota Twins,0,Kansas City Royals,10,6,April 28 2017,4
Philadelphia Phillies,1,Los Angeles Dodgers,8,3,April 28 2017,5
Pittsburgh Pirates,0,Miami Marlins,14,12,April 28 2017,2
Atlanta Braves,0,Milwaukee Brewers,18,10,April 28 2017,8
Baltimore Orioles,1,New York Yankees,25,11,April 28 2017,14
San Diego Padres,1,San Francisco Giants,7,3,April 28 2017,4
Cincinnati Reds,1,St. Louis Cardinals,12,5,April 28 2017,7
Los Angeles Angels,0,Texas Rangers,9,6,April 28 2017,3
Tampa Bay Rays,0,Toronto Blue Jays,11,7,April 28 2017,4
New York Mets,0,Washington Nationals,12,7,April 28 2017,5
Colorado Rockies,0,Arizona D'Backs,13,7,April 29 2017,6
Chicago Cubs,0,Boston Red Sox,11,7,April 29 2017,4
Seattle Mariners,1,Cleveland Indians,7,3,April 29 2017,4
Chicago White Sox,0,Detroit Tigers,10,6,April 29 2017,4
Oakland Athletics,0,Houston Astros,3,2,April 29 2017,1
Philadelphia Phillies,1,Los Angeles Dodgers,11,5,April 29 2017,6
Pittsburgh Pirates,0,Miami Marlins,4,4,April 29 2017,0
Atlanta Braves,0,Milwaukee Brewers,14,11,April 29 2017,3
Baltimore Orioles,1,New York Yankees,16,4,April 29 2017,12
San Diego Padres,0,San Francisco Giants,16,12,April 29 2017,4
Los Angeles Angels,1,Texas Rangers,9,3,April 29 2017,6
Tampa Bay Rays,1,Toronto Blue Jays,5,1,April 29 2017,4
New York Mets,0,Washington Nationals,8,5,April 29 2017,3
Colorado Rockies,1,Arizona D'Backs,2,0,April 30 2017,2
Chicago Cubs,1,Boston Red Sox,8,2,April 30 2017,6
Seattle Mariners,1,Cleveland Indians,16,4,April 30 2017,12
Chicago White Sox,1,Detroit Tigers,10,3,April 30 2017,7
Oakland Athletics,1,Houston Astros,9,2,April 30 2017,7
Minnesota Twins,0,Kansas City Royals,12,7,April 30 2017,5
Philadelphia Phillies,1,Los Angeles Dodgers,8,3,April 30 2017,5
Pittsburgh Pirates,1,Miami Marlins,13,3,April 30 2017,10
Atlanta Braves,1,Milwaukee Brewers,7,3,April 30 2017,4
Baltimore Orioles,0,New York Yankees,11,7,April 30 2017,4
San Diego Padres,0,San Francisco Giants,7,5,April 30 2017,2
Cincinnati Reds,0,St. Louis Cardinals,9,5,April 30 2017,4
Los Angeles Angels,0,Texas Rangers,7,5,April 30 2017,2
Tampa Bay Rays,1,Toronto Blue Jays,4,1,April 30 2017,3
New York Mets,1,Washington Nationals,28,5,April 30 2017,23
New York Mets,0,Atlanta Braves,12,7,May 1 2017,5
Baltimore Orioles,0,Boston Red Sox,7,5,May 1 2017,2
Philadelphia Phillies,0,Chicago Cubs,12,10,May 1 2017,2
Pittsburgh Pirates,1,Cincinnati Reds,7,3,May 1 2017,4
Cleveland Indians,1,Detroit Tigers,8,1,May 1 2017,7
Texas Rangers,1,Houston Astros,8,2,May 1 2017,6
Chicago White Sox,1,Kansas City Royals,7,1,May 1 2017,6
San Francisco Giants,0,Los Angeles Dodgers,7,4,May 1 2017,3
Tampa Bay Rays,0,Miami Marlins,6,4,May 1 2017,2
Toronto Blue Jays,0,New York Yankees,8,7,May 1 2017,1
Milwaukee Brewers,0,St. Louis Cardinals,12,7,May 1 2017,5
New York Mets,1,Atlanta Braves,16,7,May 2 2017,9
Baltimore Orioles,1,Boston Red Sox,7,2,May 2 2017,5
Philadelphia Phillies,1,Chicago Cubs,11,3,May 2 2017,8
Pittsburgh Pirates,0,Cincinnati Reds,15,12,May 2 2017,3
Cleveland Indians,1,Detroit Tigers,7,2,May 2 2017,5
Texas Rangers,1,Houston Astros,15,7,May 2 2017,8
Chicago White Sox,0,Kansas City Royals,6,6,May 2 2017,0
San Francisco Giants,1,Los Angeles Dodgers,18,5,May 2 2017,13
Tampa Bay Rays,0,Miami Marlins,4,3,May 2 2017,1
Oakland Athletics,1,Minnesota Twins,10,1,May 2 2017,9
Toronto Blue Jays,1,New York Yankees,16,5,May 2 2017,11
Colorado Rockies,1,San Diego Padres,8,2,May 2 2017,6
Los Angeles Angels,0,Seattle Mariners,10,6,May 2 2017,4
Milwaukee Brewers,1,St. Louis Cardinals,3,1,May 2 2017,2
Arizona D'Backs,0,Washington Nationals,9,6,May 2 2017,3
New York Mets,0,Atlanta Braves,21,16,May 3 2017,5
Baltimore Orioles,1,Boston Red Sox,6,2,May 3 2017,4
Philadelphia Phillies,1,Chicago Cubs,9,4,May 3 2017,5
Pittsburgh Pirates,1,Cincinnati Reds,9,2,May 3 2017,7
Cleveland Indians,0,Detroit Tigers,5,3,May 3 2017,2
Texas Rangers,1,Houston Astros,11,1,May 3 2017,10
Chicago White Sox,1,Kansas City Royals,7,1,May 3 2017,6
San Francisco Giants,0,Los Angeles Dodgers,5,4,May 3 2017,1
Oakland Athletics,1,Minnesota Twins,11,4,May 3 2017,7
Toronto Blue Jays,1,New York Yankees,14,6,May 3 2017,8
Colorado Rockies,0,San Diego Padres,14,11,May 3 2017,3
Los Angeles Angels,1,Seattle Mariners,15,7,May 3 2017,8
Miami Marlins,0,Tampa Bay Rays,16,10,May 3 2017,6
Arizona D'Backs,1,Washington Nationals,3,1,May 3 2017,2
Baltimore Orioles,0,Boston Red Sox,11,8,May 4 2017,3
Philadelphia Phillies,1,Chicago Cubs,9,4,May 4 2017,5
Pittsburgh Pirates,1,Cincinnati Reds,6,2,May 4 2017,4
Texas Rangers,0,Houston Astros,14,10,May 4 2017,4
Chicago White Sox,0,Kansas City Royals,11,8,May 4 2017,3
Oakland Athletics,0,Minnesota Twins,13,8,May 4 2017,5
Colorado Rockies,0,San Diego Padres,5,3,May 4 2017,2
Los Angeles Angels,1,Seattle Mariners,14,3,May 4 2017,11
Milwaukee Brewers,0,St. Louis Cardinals,9,5,May 4 2017,4
Miami Marlins,1,Tampa Bay Rays,6,1,May 4 2017,5
Arizona D'Backs,1,Washington Nationals,6,2,May 4 2017,4
Houston Astros,0,Los Angeles Angels,13,7,May 5 2017,6
St. Louis Cardinals,0,Atlanta Braves,10,10,May 5 2017,0
Chicago White Sox,1,Baltimore Orioles,6,2,May 5 2017,4
New York Yankees,0,Chicago Cubs,5,3,May 5 2017,2
San Francisco Giants,1,Cincinnati Reds,16,3,May 5 2017,13
Arizona D'Backs,0,Colorado Rockies,9,6,May 5 2017,3
Cleveland Indians,1,Kansas City Royals,4,1,May 5 2017,3
Boston Red Sox,1,Minnesota Twins,7,3,May 5 2017,4
Miami Marlins,1,New York Mets,15,7,May 5 2017,8
Detroit Tigers,0,Oakland Athletics,9,7,May 5 2017,2
Washington Nationals,0,Philadelphia Phillies,6,4,May 5 2017,2
Milwaukee Brewers,1,Pittsburgh Pirates,4,0,May 5 2017,4
Los Angeles Dodgers,0,San Diego Padres,10,8,May 5 2017,2
Texas Rangers,0,Seattle Mariners,4,3,May 5 2017,1
Toronto Blue Jays,0,Tampa Bay Rays,12,8,May 5 2017,4
Houston Astros,1,Los Angeles Angels,3,1,May 6 2017,2
St. Louis Cardinals,0,Atlanta Braves,8,5,May 6 2017,3
Chicago White Sox,1,Baltimore Orioles,11,5,May 6 2017,6
New York Yankees,0,Chicago Cubs,17,11,May 6 2017,6
San Francisco Giants,1,Cincinnati Reds,16,2,May 6 2017,14
Arizona D'Backs,1,Colorado Rockies,10,1,May 6 2017,9
Cleveland Indians,0,Kansas City Royals,4,3,May 6 2017,1
Boston Red Sox,0,Minnesota Twins,12,11,May 6 2017,1
Miami Marlins,1,New York Mets,14,3,May 6 2017,11
Detroit Tigers,1,Oakland Athletics,11,5,May 6 2017,6
Washington Nationals,0,Philadelphia Phillies,8,6,May 6 2017,2
Milwaukee Brewers,1,Pittsburgh Pirates,3,1,May 6 2017,2
Los Angeles Dodgers,0,San Diego Padres,12,10,May 6 2017,2
Texas Rangers,1,Seattle Mariners,10,2,May 6 2017,8
Toronto Blue Jays,1,Tampa Bay Rays,7,1,May 6 2017,6
Houston Astros,0,Los Angeles Angels,8,5,May 7 2017,3
St. Louis Cardinals,0,Atlanta Braves,10,6,May 7 2017,4
Chicago White Sox,1,Baltimore Orioles,4,0,May 7 2017,4
New York Yankees,0,Chicago Cubs,9,5,May 7 2017,4
San Francisco Giants,1,Cincinnati Reds,4,0,May 7 2017,4
Arizona D'Backs,1,Colorado Rockies,7,2,May 7 2017,5
Cleveland Indians,0,Kansas City Royals,1,1,May 7 2017,0
Boston Red Sox,0,Minnesota Twins,23,17,May 7 2017,6
Miami Marlins,0,New York Mets,7,7,May 7 2017,0
Detroit Tigers,1,Oakland Athletics,14,6,May 7 2017,8
Washington Nationals,1,Philadelphia Phillies,11,5,May 7 2017,6
Milwaukee Brewers,0,Pittsburgh Pirates,8,6,May 7 2017,2
Texas Rangers,1,Seattle Mariners,7,3,May 7 2017,4
Toronto Blue Jays,0,Tampa Bay Rays,3,2,May 7 2017,1
Washington Nationals,1,Baltimore Orioles,10,4,May 8 2017,6
New York Yankees,0,Cincinnati Reds,14,10,May 8 2017,4
Pittsburgh Pirates,1,Los Angeles Dodgers,13,1,May 8 2017,12
St. Louis Cardinals,0,Miami Marlins,13,9,May 8 2017,4
San Francisco Giants,1,New York Mets,7,3,May 8 2017,4
Los Angeles Angels,1,Oakland Athletics,5,2,May 8 2017,3
Texas Rangers,1,San Diego Padres,6,1,May 8 2017,5
Kansas City Royals,0,Tampa Bay Rays,10,7,May 8 2017,3
Cleveland Indians,1,Toronto Blue Jays,6,2,May 8 2017,4
Detroit Tigers,0,Arizona D'Backs,10,7,May 9 2017,3
Washington Nationals,1,Baltimore Orioles,9,4,May 9 2017,5
Minnesota Twins,0,Chicago White Sox,9,7,May 9 2017,2
New York Yankees,1,Cincinnati Reds,8,3,May 9 2017,5
Chicago Cubs,1,Colorado Rockies,14,4,May 9 2017,10
Chicago Cubs,0,Colorado Rockies,9,8,May 9 2017,1
Atlanta Braves,1,Houston Astros,11,3,May 9 2017,8
Pittsburgh Pirates,1,Los Angeles Dodgers,7,3,May 9 2017,4
St. Louis Cardinals,0,Miami Marlins,11,6,May 9 2017,5
Boston Red Sox,1,Milwaukee Brewers,18,7,May 9 2017,11
San Francisco Giants,1,New York Mets,7,1,May 9 2017,6
Los Angeles Angels,0,Oakland Athletics,10,7,May 9 2017,3
Seattle Mariners,0,Philadelphia Phillies,19,10,May 9 2017,9
Texas Rangers,0,San Diego Padres,11,11,May 9 2017,0
Kansas City Royals,0,Tampa Bay Rays,13,7,May 9 2017,6
Cleveland Indians,0,Toronto Blue Jays,6,6,May 9 2017,0
Detroit Tigers,1,Arizona D'Backs,8,1,May 10 2017,7
Chicago Cubs,1,Colorado Rockies,3,0,May 10 2017,3
Atlanta Braves,1,Houston Astros,6,2,May 10 2017,4
Pittsburgh Pirates,1,Los Angeles Dodgers,7,2,May 10 2017,5
St. Louis Cardinals,0,Miami Marlins,12,7,May 10 2017,5
Boston Red Sox,1,Milwaukee Brewers,11,4,May 10 2017,7
San Francisco Giants,0,New York Mets,11,6,May 10 2017,5
Los Angeles Angels,1,Oakland Athletics,4,1,May 10 2017,3
Seattle Mariners,0,Philadelphia Phillies,17,11,May 10 2017,6
Kansas City Royals,1,Tampa Bay Rays,13,1,May 10 2017,12
San Diego Padres,1,Texas Rangers,7,3,May 10 2017,4
Cleveland Indians,1,Toronto Blue Jays,15,7,May 10 2017,8
Baltimore Orioles,1,Washington Nationals,13,6,May 10 2017,7
Detroit Tigers,0,Los Angeles Angels,8,7,May 11 2017,1
Pittsburgh Pirates,1,Arizona D'Backs,3,1,May 11 2017,2
Minnesota Twins,0,Chicago White Sox,13,7,May 11 2017,6
Los Angeles Dodgers,1,Colorado Rockies,17,7,May 11 2017,10
Boston Red Sox,0,Milwaukee Brewers,5,4,May 11 2017,1
Houston Astros,0,New York Yankees,5,3,May 11 2017,2
Cincinnati Reds,0,San Francisco Giants,5,3,May 11 2017,2
Kansas City Royals,0,Tampa Bay Rays,6,6,May 11 2017,0
San Diego Padres,1,Texas Rangers,7,2,May 11 2017,5
Seattle Mariners,1,Toronto Blue Jays,9,2,May 11 2017,7
Detroit Tigers,1,Los Angeles Angels,7,0,May 12 2017,7
Pittsburgh Pirates,1,Arizona D'Backs,15,4,May 12 2017,11
Tampa Bay Rays,0,Boston Red Sox,9,5,May 12 2017,4
San Diego Padres,0,Chicago White Sox,9,6,May 12 2017,3
Minnesota Twins,0,Cleveland Indians,1,1,May 12 2017,0
Los Angeles Dodgers,0,Colorado Rockies,8,6,May 12 2017,2
Baltimore Orioles,1,Kansas City Royals,5,2,May 12 2017,3
Atlanta Braves,0,Miami Marlins,12,8,May 12 2017,4
New York Mets,1,Milwaukee Brewers,11,4,May 12 2017,7
Houston Astros,0,New York Yankees,6,5,May 12 2017,1
Cincinnati Reds,1,San Francisco Giants,5,2,May 12 2017,3
Chicago Cubs,0,St. Louis Cardinals,5,3,May 12 2017,2
Oakland Athletics,1,Texas Rangers,7,2,May 12 2017,5
Seattle Mariners,1,Toronto Blue Jays,4,0,May 12 2017,4
Detroit Tigers,0,Los Angeles Angels,7,4,May 13 2017,3
Pittsburgh Pirates,0,Arizona D'Backs,7,4,May 13 2017,3
Tampa Bay Rays,1,Boston Red Sox,9,3,May 13 2017,6
San Diego Padres,1,Chicago White Sox,9,4,May 13 2017,5
Minnesota Twins,0,Cleveland Indians,5,4,May 13 2017,1
Los Angeles Dodgers,0,Colorado Rockies,4,4,May 13 2017,0
Baltimore Orioles,1,Kansas City Royals,7,3,May 13 2017,4
Atlanta Braves,0,Miami Marlins,4,3,May 13 2017,1
New York Mets,1,Milwaukee Brewers,15,4,May 13 2017,11
Cincinnati Reds,1,San Francisco Giants,4,1,May 13 2017,3
Chicago Cubs,1,St. Louis Cardinals,8,3,May 13 2017,5
Oakland Athletics,1,Texas Rangers,11,5,May 13 2017,6
Seattle Mariners,1,Toronto Blue Jays,9,2,May 13 2017,7
Philadelphia Phillies,1,Washington Nationals,10,4,May 13 2017,6
Detroit Tigers,1,Los Angeles Angels,5,1,May 14 2017,4
Pittsburgh Pirates,0,Arizona D'Backs,10,6,May 14 2017,4
Tampa Bay Rays,0,Boston Red Sox,13,11,May 14 2017,2
San Diego Padres,1,Chicago White Sox,12,3,May 14 2017,9
Minnesota Twins,1,Cleveland Indians,11,3,May 14 2017,8
Los Angeles Dodgers,1,Colorado Rockies,15,6,May 14 2017,9
Baltimore Orioles,1,Kansas City Royals,17,8,May 14 2017,9
Atlanta Braves,1,Miami Marlins,4,1,May 14 2017,3
New York Mets,1,Milwaukee Brewers,20,9,May 14 2017,11
Houston Astros,1,New York Yankees,17,6,May 14 2017,11
Houston Astros,0,New York Yankees,17,10,May 14 2017,7
Cincinnati Reds,1,San Francisco Giants,11,3,May 14 2017,8
Chicago Cubs,1,St. Louis Cardinals,5,0,May 14 2017,5
Oakland Athletics,1,Texas Rangers,10,4,May 14 2017,6
Seattle Mariners,1,Toronto Blue Jays,5,2,May 14 2017,3
Philadelphia Phillies,0,Washington Nationals,7,4,May 14 2017,3
Philadelphia Phillies,1,Washington Nationals,11,5,May 14 2017,6
Chicago White Sox,1,Los Angeles Angels,8,3,May 15 2017,5
New York Mets,1,Arizona D'Backs,10,3,May 15 2017,7
Tampa Bay Rays,1,Cleveland Indians,15,7,May 15 2017,8
Houston Astros,0,Miami Marlins,9,7,May 15 2017,2
Milwaukee Brewers,1,San Diego Padres,11,5,May 15 2017,6
Oakland Athletics,1,Seattle Mariners,11,5,May 15 2017,6
Los Angeles Dodgers,1,San Francisco Giants,12,4,May 15 2017,8
Atlanta Braves,0,Toronto Blue Jays,16,10,May 15 2017,6
Chicago White Sox,1,Los Angeles Angels,13,6,May 16 2017,7
New York Mets,1,Arizona D'Backs,9,4,May 16 2017,5
Cincinnati Reds,1,Chicago Cubs,14,5,May 16 2017,9
Tampa Bay Rays,0,Cleveland Indians,10,6,May 16 2017,4
Baltimore Orioles,0,Detroit Tigers,24,13,May 16 2017,11
New York Yankees,0,Kansas City Royals,8,7,May 16 2017,1
Houston Astros,0,Miami Marlins,14,12,May 16 2017,2
Colorado Rockies,0,Minnesota Twins,10,7,May 16 2017,3
Washington Nationals,0,Pittsburgh Pirates,12,8,May 16 2017,4
Milwaukee Brewers,0,San Diego Padres,8,6,May 16 2017,2
Oakland Athletics,0,Seattle Mariners,15,9,May 16 2017,6
Los Angeles Dodgers,1,San Francisco Giants,3,1,May 16 2017,2
Boston Red Sox,0,St. Louis Cardinals,9,6,May 16 2017,3
Philadelphia Phillies,1,Texas Rangers,6,1,May 16 2017,5
Atlanta Braves,0,Toronto Blue Jays,14,9,May 16 2017,5
Chicago White Sox,1,Los Angeles Angels,20,8,May 17 2017,12
New York Mets,1,Arizona D'Backs,9,4,May 17 2017,5
Toronto Blue Jays,1,Atlanta Braves,12,4,May 17 2017,8
Cincinnati Reds,1,Chicago Cubs,12,5,May 17 2017,7
Tampa Bay Rays,0,Cleveland Indians,11,7,May 17 2017,4
Baltimore Orioles,1,Detroit Tigers,9,4,May 17 2017,5
New York Yankees,0,Kansas City Royals,18,11,May 17 2017,7
Houston Astros,0,Miami Marlins,3,3,May 17 2017,0
Washington Nationals,1,Pittsburgh Pirates,7,1,May 17 2017,6
Milwaukee Brewers,0,San Diego Padres,4,3,May 17 2017,1
Oakland Athletics,1,Seattle Mariners,4,0,May 17 2017,4
Los Angeles Dodgers,0,San Francisco Giants,7,6,May 17 2017,1
Boston Red Sox,0,St. Louis Cardinals,9,5,May 17 2017,4
Philadelphia Phillies,1,Texas Rangers,12,3,May 17 2017,9
Toronto Blue Jays,0,Atlanta Braves,9,9,May 18 2017,0
Cincinnati Reds,1,Chicago Cubs,14,5,May 18 2017,9
Baltimore Orioles,1,Detroit Tigers,11,5,May 18 2017,6
New York Yankees,1,Kansas City Royals,6,1,May 18 2017,5
Miami Marlins,1,Los Angeles Dodgers,9,2,May 18 2017,7
Colorado Rockies,0,Minnesota Twins,6,5,May 18 2017,1
Colorado Rockies,1,Minnesota Twins,2,0,May 18 2017,2
Boston Red Sox,1,Oakland Athletics,11,3,May 18 2017,8
Washington Nationals,1,Pittsburgh Pirates,14,4,May 18 2017,10
Milwaukee Brewers,0,San Diego Padres,6,4,May 18 2017,2
Chicago White Sox,1,Seattle Mariners,9,4,May 18 2017,5
Philadelphia Phillies,1,Texas Rangers,12,4,May 18 2017,8
Washington Nationals,1,Atlanta Braves,11,4,May 19 2017,7
Toronto Blue Jays,1,Baltimore Orioles,8,3,May 19 2017,5
Milwaukee Brewers,0,Chicago Cubs,9,6,May 19 2017,3
Colorado Rockies,0,Cincinnati Reds,18,12,May 19 2017,6
Texas Rangers,0,Detroit Tigers,8,5,May 19 2017,3
Cleveland Indians,0,Houston Astros,8,5,May 19 2017,3
Miami Marlins,1,Los Angeles Dodgers,9,2,May 19 2017,7
Kansas City Royals,1,Minnesota Twins,7,3,May 19 2017,4
Los Angeles Angels,1,New York Mets,3,0,May 19 2017,3
Boston Red Sox,1,Oakland Athletics,5,2,May 19 2017,3
Philadelphia Phillies,0,Pittsburgh Pirates,9,7,May 19 2017,2
Arizona D'Backs,0,San Diego Padres,11,10,May 19 2017,1
Chicago White Sox,0,Seattle Mariners,3,2,May 19 2017,1
San Francisco Giants,0,St. Louis Cardinals,11,6,May 19 2017,5
New York Yankees,1,Tampa Bay Rays,9,4,May 19 2017,5
Washington Nationals,1,Atlanta Braves,7,2,May 20 2017,5
Toronto Blue Jays,1,Baltimore Orioles,12,5,May 20 2017,7
Colorado Rockies,1,Cincinnati Reds,20,8,May 20 2017,12
Texas Rangers,1,Detroit Tigers,12,3,May 20 2017,9
Cleveland Indians,0,Houston Astros,3,3,May 20 2017,0
Miami Marlins,0,Los Angeles Dodgers,16,10,May 20 2017,6
Los Angeles Angels,1,New York Mets,12,5,May 20 2017,7
Boston Red Sox,1,Oakland Athletics,11,3,May 20 2017,8
Philadelphia Phillies,1,Pittsburgh Pirates,9,3,May 20 2017,6
Arizona D'Backs,0,San Diego Padres,10,9,May 20 2017,1
Chicago White Sox,0,Seattle Mariners,17,16,May 20 2017,1
San Francisco Giants,0,St. Louis Cardinals,4,3,May 20 2017,1
New York Yankees,1,Tampa Bay Rays,14,5,May 20 2017,9
Washington Nationals,0,Atlanta Braves,5,3,May 21 2017,2
Toronto Blue Jays,0,Baltimore Orioles,4,3,May 21 2017,1
Milwaukee Brewers,1,Chicago Cubs,19,6,May 21 2017,13
Colorado Rockies,0,Cincinnati Reds,10,6,May 21 2017,4
Texas Rangers,0,Detroit Tigers,7,5,May 21 2017,2
Cleveland Indians,0,Houston Astros,14,8,May 21 2017,6
Miami Marlins,1,Los Angeles Dodgers,9,3,May 21 2017,6
Kansas City Royals,0,Minnesota Twins,10,6,May 21 2017,4
Kansas City Royals,1,Minnesota Twins,12,4,May 21 2017,8
Los Angeles Angels,0,New York Mets,17,12,May 21 2017,5
Boston Red Sox,0,Oakland Athletics,15,12,May 21 2017,3
Philadelphia Phillies,1,Pittsburgh Pirates,1,0,May 21 2017,1
Arizona D'Backs,1,San Diego Padres,6,1,May 21 2017,5
Chicago White Sox,0,Seattle Mariners,9,8,May 21 2017,1
San Francisco Giants,1,St. Louis Cardinals,11,3,May 21 2017,8
New York Yankees,0,Tampa Bay Rays,5,3,May 21 2017,2
Chicago White Sox,1,Arizona D'Backs,6,1,May 22 2017,5
Pittsburgh Pirates,1,Atlanta Braves,7,2,May 22 2017,5
Minnesota Twins,0,Baltimore Orioles,21,14,May 22 2017,7
San Francisco Giants,0,Chicago Cubs,10,6,May 22 2017,4
Cleveland Indians,1,Cincinnati Reds,6,1,May 22 2017,5
Detroit Tigers,1,Houston Astros,1,0,May 22 2017,1
Kansas City Royals,1,New York Yankees,6,2,May 22 2017,4
Colorado Rockies,0,Philadelphia Phillies,9,8,May 22 2017,1
Los Angeles Angels,0,Tampa Bay Rays,5,3,May 22 2017,2
Chicago White Sox,1,Arizona D'Backs,9,4,May 23 2017,5
Pittsburgh Pirates,1,Atlanta Braves,11,5,May 23 2017,6
Minnesota Twins,0,Baltimore Orioles,2,2,May 23 2017,0
Texas Rangers,1,Boston Red Sox,17,6,May 23 2017,11
San Francisco Giants,1,Chicago Cubs,5,1,May 23 2017,4
Cleveland Indians,0,Cincinnati Reds,15,8,May 23 2017,7
Detroit Tigers,1,Houston Astros,8,2,May 23 2017,6
St. Louis Cardinals,1,Los Angeles Dodgers,3,1,May 23 2017,2
Toronto Blue Jays,0,Milwaukee Brewers,7,4,May 23 2017,3
Kansas City Royals,0,New York Yankees,8,6,May 23 2017,2
San Diego Padres,1,New York Mets,12,3,May 23 2017,9
Miami Marlins,0,Oakland Athletics,20,11,May 23 2017,9
Colorado Rockies,0,Philadelphia Phillies,10,8,May 23 2017,2
Los Angeles Angels,0,Tampa Bay Rays,4,4,May 23 2017,0
Seattle Mariners,1,Washington Nationals,11,1,May 23 2017,10
Chicago White Sox,1,Arizona D'Backs,14,6,May 24 2017,8
Pittsburgh Pirates,0,Atlanta Braves,17,12,May 24 2017,5
Minnesota Twins,0,Baltimore Orioles,7,4,May 24 2017,3
Texas Rangers,1,Boston Red Sox,13,4,May 24 2017,9
San Francisco Giants,1,Chicago Cubs,9,4,May 24 2017,5
Cincinnati Reds,0,Cleveland Indians,7,4,May 24 2017,3
Detroit Tigers,0,Houston Astros,9,6,May 24 2017,3
St. Louis Cardinals,0,Los Angeles Dodgers,7,6,May 24 2017,1
Toronto Blue Jays,0,Milwaukee Brewers,12,8,May 24 2017,4
Kansas City Royals,1,New York Yankees,3,0,May 24 2017,3
San Diego Padres,0,New York Mets,11,6,May 24 2017,5
Miami Marlins,1,Oakland Athletics,5,1,May 24 2017,4
Colorado Rockies,0,Philadelphia Phillies,9,7,May 24 2017,2
Los Angeles Angels,1,Tampa Bay Rays,7,2,May 24 2017,5
Seattle Mariners,1,Washington Nationals,6,1,May 24 2017,5
Pittsburgh Pirates,0,Atlanta Braves,13,9,May 25 2017,4
Texas Rangers,1,Boston Red Sox,8,2,May 25 2017,6
San Francisco Giants,1,Chicago Cubs,6,1,May 25 2017,5
Detroit Tigers,1,Houston Astros,13,6,May 25 2017,7
St. Louis Cardinals,1,Los Angeles Dodgers,10,3,May 25 2017,7
Arizona D'Backs,0,Milwaukee Brewers,4,4,May 25 2017,0
San Diego Padres,0,New York Mets,7,4,May 25 2017,3
Colorado Rockies,1,Philadelphia Phillies,3,1,May 25 2017,2
Los Angeles Angels,1,Tampa Bay Rays,4,0,May 25 2017,4
Seattle Mariners,0,Washington Nationals,6,4,May 25 2017,2
Seattle Mariners,1,Boston Red Sox,3,0,May 26 2017,3
Detroit Tigers,1,Chicago White Sox,10,2,May 26 2017,8
Kansas City Royals,0,Cleveland Indians,10,6,May 26 2017,4
St. Louis Cardinals,1,Colorado Rockies,10,0,May 26 2017,10
Baltimore Orioles,1,Houston Astros,2,0,May 26 2017,2
Chicago Cubs,1,Los Angeles Dodgers,4,0,May 26 2017,4
Los Angeles Angels,1,Miami Marlins,13,5,May 26 2017,8
Arizona D'Backs,0,Milwaukee Brewers,6,4,May 26 2017,2
Tampa Bay Rays,0,Minnesota Twins,7,5,May 26 2017,2
Oakland Athletics,0,New York Yankees,5,4,May 26 2017,1
Cincinnati Reds,0,Philadelphia Phillies,7,5,May 26 2017,2
New York Mets,0,Pittsburgh Pirates,9,8,May 26 2017,1
Atlanta Braves,0,San Francisco Giants,2,2,May 26 2017,0
Texas Rangers,1,Toronto Blue Jays,13,6,May 26 2017,7
San Diego Padres,1,Washington Nationals,6,1,May 26 2017,5
Seattle Mariners,1,Boston Red Sox,6,0,May 27 2017,6
Detroit Tigers,1,Chicago White Sox,3,0,May 27 2017,3
Detroit Tigers,0,Chicago White Sox,7,4,May 27 2017,3
Kansas City Royals,0,Cleveland Indians,7,5,May 27 2017,2
St. Louis Cardinals,0,Colorado Rockies,3,3,May 27 2017,0
Baltimore Orioles,1,Houston Astros,7,2,May 27 2017,5
Chicago Cubs,1,Los Angeles Dodgers,5,0,May 27 2017,5
Los Angeles Angels,0,Miami Marlins,7,5,May 27 2017,2
Arizona D'Backs,1,Milwaukee Brewers,7,1,May 27 2017,6
Tampa Bay Rays,1,Minnesota Twins,8,3,May 27 2017,5
Oakland Athletics,1,New York Yankees,5,2,May 27 2017,3
Cincinnati Reds,1,Philadelphia Phillies,7,3,May 27 2017,4
New York Mets,1,Pittsburgh Pirates,9,4,May 27 2017,5
Atlanta Braves,1,San Francisco Giants,9,3,May 27 2017,6
Texas Rangers,1,Toronto Blue Jays,4,1,May 27 2017,3
San Diego Padres,1,Washington Nationals,3,0,May 27 2017,3
Seattle Mariners,0,Boston Red Sox,5,5,May 28 2017,0
Detroit Tigers,1,Chicago White Sox,10,3,May 28 2017,7
Kansas City Royals,1,Cleveland Indians,11,1,May 28 2017,10
St. Louis Cardinals,1,Colorado Rockies,12,4,May 28 2017,8
Baltimore Orioles,1,Houston Astros,12,4,May 28 2017,8
Chicago Cubs,1,Los Angeles Dodgers,13,4,May 28 2017,9
Los Angeles Angels,1,Miami Marlins,11,2,May 28 2017,9
Arizona D'Backs,1,Milwaukee Brewers,14,5,May 28 2017,9
Tampa Bay Rays,0,Minnesota Twins,14,8,May 28 2017,6
Oakland Athletics,1,New York Yankees,14,5,May 28 2017,9
Cincinnati Reds,0,Philadelphia Phillies,12,8,May 28 2017,4
New York Mets,0,Pittsburgh Pirates,9,7,May 28 2017,2
Atlanta Braves,1,San Francisco Giants,8,1,May 28 2017,7
Texas Rangers,0,Toronto Blue Jays,4,3,May 28 2017,1
San Diego Padres,0,Washington Nationals,8,5,May 28 2017,3
Atlanta Braves,0,Los Angeles Angels,9,6,May 29 2017,3
New York Yankees,1,Baltimore Orioles,5,2,May 29 2017,3
Boston Red Sox,1,Chicago White Sox,9,4,May 29 2017,5
Oakland Athletics,1,Cleveland Indians,8,3,May 29 2017,5
Seattle Mariners,0,Colorado Rockies,11,6,May 29 2017,5
Detroit Tigers,0,Kansas City Royals,17,10,May 29 2017,7
Philadelphia Phillies,1,Miami Marlins,5,1,May 29 2017,4
Houston Astros,0,Minnesota Twins,24,16,May 29 2017,8
Milwaukee Brewers,1,New York Mets,6,2,May 29 2017,4
Arizona D'Backs,1,Pittsburgh Pirates,7,3,May 29 2017,4
Chicago Cubs,1,San Diego Padres,7,2,May 29 2017,5
Washington Nationals,0,San Francisco Giants,3,3,May 29 2017,0
Los Angeles Dodgers,0,St. Louis Cardinals,6,5,May 29 2017,1
Tampa Bay Rays,0,Texas Rangers,18,10,May 29 2017,8
Cincinnati Reds,1,Toronto Blue Jays,19,2,May 29 2017,17
Atlanta Braves,1,Los Angeles Angels,12,3,May 30 2017,9
New York Yankees,0,Baltimore Orioles,11,8,May 30 2017,3
Boston Red Sox,0,Chicago White Sox,20,13,May 30 2017,7
Oakland Athletics,1,Cleveland Indians,13,4,May 30 2017,9
Seattle Mariners,0,Colorado Rockies,14,10,May 30 2017,4
Detroit Tigers,1,Kansas City Royals,1,0,May 30 2017,1
Philadelphia Phillies,1,Miami Marlins,9,2,May 30 2017,7
Houston Astros,0,Minnesota Twins,9,7,May 30 2017,2
Milwaukee Brewers,1,New York Mets,9,4,May 30 2017,5
Arizona D'Backs,0,Pittsburgh Pirates,3,3,May 30 2017,0
Chicago Cubs,1,San Diego Padres,8,2,May 30 2017,6
Washington Nationals,0,San Francisco Giants,9,6,May 30 2017,3
Los Angeles Dodgers,0,St. Louis Cardinals,13,9,May 30 2017,4
Tampa Bay Rays,1,Texas Rangers,14,5,May 30 2017,9
Cincinnati Reds,1,Toronto Blue Jays,10,4,May 30 2017,6
Atlanta Braves,1,Los Angeles Angels,3,1,May 31 2017,2
New York Yankees,1,Baltimore Orioles,14,4,May 31 2017,10
Boston Red Sox,0,Chicago White Sox,5,4,May 31 2017,1
Oakland Athletics,0,Cleveland Indians,4,3,May 31 2017,1
Detroit Tigers,0,Kansas City Royals,11,6,May 31 2017,5
Philadelphia Phillies,1,Miami Marlins,12,2,May 31 2017,10
Houston Astros,0,Minnesota Twins,23,17,May 31 2017,6
Milwaukee Brewers,0,New York Mets,8,7,May 31 2017,1
Arizona D'Backs,0,Pittsburgh Pirates,11,6,May 31 2017,5
Chicago Cubs,1,San Diego Padres,3,1,May 31 2017,2
Colorado Rockies,1,Seattle Mariners,5,0,May 31 2017,5
Washington Nationals,0,San Francisco Giants,4,3,May 31 2017,1
Los Angeles Dodgers,1,St. Louis Cardinals,3,1,May 31 2017,2
Tampa Bay Rays,0,Texas Rangers,12,7,May 31 2017,5
Cincinnati Reds,1,Toronto Blue Jays,9,4,May 31 2017,5
Minnesota Twins,0,Los Angeles Angels,6,4,June 1 2017,2
Boston Red Sox,1,Baltimore Orioles,12,5,June 1 2017,7
Oakland Athletics,1,Cleveland Indians,8,0,June 1 2017,8
Arizona D'Backs,0,Miami Marlins,5,3,June 1 2017,2
Milwaukee Brewers,0,New York Mets,3,2,June 1 2017,1
Colorado Rockies,0,Seattle Mariners,9,6,June 1 2017,3
Los Angeles Dodgers,1,St. Louis Cardinals,2,0,June 1 2017,2
New York Yankees,0,Toronto Blue Jays,14,12,June 1 2017,2
Minnesota Twins,0,Los Angeles Angels,16,11,June 2 2017,5
Boston Red Sox,1,Baltimore Orioles,5,2,June 2 2017,3
St. Louis Cardinals,1,Chicago Cubs,5,2,June 2 2017,3
Atlanta Braves,1,Cincinnati Reds,5,2,June 2 2017,3
Chicago White Sox,1,Detroit Tigers,20,5,June 2 2017,15
Cleveland Indians,1,Kansas City Royals,4,0,June 2 2017,4
Arizona D'Backs,1,Miami Marlins,12,5,June 2 2017,7
Los Angeles Dodgers,0,Milwaukee Brewers,3,2,June 2 2017,1
Pittsburgh Pirates,0,New York Mets,19,12,June 2 2017,7
Washington Nationals,0,Oakland Athletics,16,13,June 2 2017,3
San Francisco Giants,0,Philadelphia Phillies,10,10,June 2 2017,0
Colorado Rockies,1,San Diego Padres,13,5,June 2 2017,8
Tampa Bay Rays,1,Seattle Mariners,16,4,June 2 2017,12
Houston Astros,0,Texas Rangers,8,7,June 2 2017,1
New York Yankees,1,Toronto Blue Jays,12,5,June 2 2017,7
Minnesota Twins,1,Los Angeles Angels,9,2,June 3 2017,7
Boston Red Sox,0,Baltimore Orioles,7,5,June 3 2017,2
St. Louis Cardinals,1,Chicago Cubs,8,3,June 3 2017,5
Atlanta Braves,0,Cincinnati Reds,11,6,June 3 2017,5
Chicago White Sox,1,Detroit Tigers,11,1,June 3 2017,10
Cleveland Indians,1,Kansas City Royals,17,5,June 3 2017,12
Arizona D'Backs,1,Miami Marlins,3,0,June 3 2017,3
Los Angeles Dodgers,0,Milwaukee Brewers,18,10,June 3 2017,8
Pittsburgh Pirates,1,New York Mets,6,2,June 3 2017,4
Washington Nationals,1,Oakland Athletics,14,4,June 3 2017,10
San Francisco Giants,1,Philadelphia Phillies,8,3,June 3 2017,5
Colorado Rockies,0,San Diego Padres,11,10,June 3 2017,1
Tampa Bay Rays,1,Seattle Mariners,11,2,June 3 2017,9
Houston Astros,0,Texas Rangers,11,6,June 3 2017,5
New York Yankees,0,Toronto Blue Jays,7,7,June 3 2017,0
Minnesota Twins,0,Los Angeles Angels,5,3,June 4 2017,2
Boston Red Sox,0,Baltimore Orioles,10,7,June 4 2017,3
St. Louis Cardinals,1,Chicago Cubs,13,6,June 4 2017,7
Atlanta Braves,0,Cincinnati Reds,21,13,June 4 2017,8
Chicago White Sox,1,Detroit Tigers,11,4,June 4 2017,7
Cleveland Indians,0,Kansas City Royals,8,8,June 4 2017,0
Arizona D'Backs,1,Miami Marlins,11,5,June 4 2017,6
Los Angeles Dodgers,1,Milwaukee Brewers,3,0,June 4 2017,3
Pittsburgh Pirates,0,New York Mets,12,11,June 4 2017,1
Washington Nationals,0,Oakland Athletics,21,11,June 4 2017,10
San Francisco Giants,1,Philadelphia Phillies,16,7,June 4 2017,9
Colorado Rockies,0,San Diego Padres,4,3,June 4 2017,1
Tampa Bay Rays,1,Seattle Mariners,8,1,June 4 2017,7
Houston Astros,0,Texas Rangers,9,7,June 4 2017,2
New York Yankees,1,Toronto Blue Jays,5,2,June 4 2017,3
Philadelphia Phillies,0,Atlanta Braves,15,11,June 5 2017,4
Miami Marlins,1,Chicago Cubs,4,1,June 5 2017,3
St. Louis Cardinals,1,Cincinnati Reds,6,2,June 5 2017,4
Houston Astros,0,Kansas City Royals,10,7,June 5 2017,3
Washington Nationals,0,Los Angeles Dodgers,6,4,June 5 2017,2
San Francisco Giants,0,Milwaukee Brewers,9,7,June 5 2017,2
Toronto Blue Jays,1,Oakland Athletics,8,3,June 5 2017,5
San Diego Padres,1,Arizona D'Backs,12,2,June 6 2017,10
Philadelphia Phillies,0,Atlanta Braves,4,3,June 6 2017,1
Pittsburgh Pirates,1,Baltimore Orioles,11,5,June 6 2017,6
Miami Marlins,1,Chicago Cubs,12,2,June 6 2017,10
St. Louis Cardinals,1,Cincinnati Reds,14,1,June 6 2017,13
Cleveland Indians,1,Colorado Rockies,14,3,June 6 2017,11
Los Angeles Angels,0,Detroit Tigers,8,5,June 6 2017,3
Houston Astros,1,Kansas City Royals,16,7,June 6 2017,9
Washington Nationals,0,Los Angeles Dodgers,3,2,June 6 2017,1
San Francisco Giants,1,Milwaukee Brewers,7,2,June 6 2017,5
Boston Red Sox,0,New York Yankees,9,5,June 6 2017,4
Toronto Blue Jays,1,Oakland Athletics,5,1,June 6 2017,4
Minnesota Twins,1,Seattle Mariners,15,3,June 6 2017,12
Chicago White Sox,0,Tampa Bay Rays,6,4,June 6 2017,2
New York Mets,1,Texas Rangers,18,8,June 6 2017,10
San Diego Padres,1,Arizona D'Backs,11,4,June 7 2017,7
Philadelphia Phillies,1,Atlanta Braves,15,1,June 7 2017,14
Pittsburgh Pirates,1,Baltimore Orioles,15,6,June 7 2017,9
Miami Marlins,0,Chicago Cubs,11,6,June 7 2017,5
St. Louis Cardinals,1,Cincinnati Reds,10,4,June 7 2017,6
Cleveland Indians,1,Colorado Rockies,9,1,June 7 2017,8
Los Angeles Angels,1,Detroit Tigers,4,0,June 7 2017,4
Houston Astros,1,Kansas City Royals,12,5,June 7 2017,7
Washington Nationals,1,Los Angeles Dodgers,3,1,June 7 2017,2
San Francisco Giants,1,Milwaukee Brewers,9,3,June 7 2017,6
Boston Red Sox,1,New York Yankees,8,0,June 7 2017,8
Toronto Blue Jays,0,Oakland Athletics,12,7,June 7 2017,5
Minnesota Twins,1,Seattle Mariners,11,5,June 7 2017,6
Chicago White Sox,1,Tampa Bay Rays,4,1,June 7 2017,3
New York Mets,0,Texas Rangers,7,4,June 7 2017,3
San Diego Padres,1,Arizona D'Backs,18,3,June 8 2017,15
Philadelphia Phillies,1,Atlanta Braves,4,1,June 8 2017,3
Colorado Rockies,0,Chicago Cubs,5,4,June 8 2017,1
St. Louis Cardinals,1,Cincinnati Reds,7,2,June 8 2017,5
Los Angeles Angels,0,Detroit Tigers,15,11,June 8 2017,4
Houston Astros,0,Kansas City Royals,7,6,June 8 2017,1
San Francisco Giants,0,Milwaukee Brewers,14,9,June 8 2017,5
Boston Red Sox,1,New York Yankees,10,1,June 8 2017,9
Miami Marlins,0,Pittsburgh Pirates,8,7,June 8 2017,1
Minnesota Twins,0,Seattle Mariners,3,2,June 8 2017,1
Chicago White Sox,1,Tampa Bay Rays,12,5,June 8 2017,7
Baltimore Orioles,1,Washington Nationals,7,1,June 8 2017,6
Milwaukee Brewers,0,Arizona D'Backs,14,8,June 9 2017,6
New York Mets,1,Atlanta Braves,5,2,June 9 2017,3
Detroit Tigers,1,Boston Red Sox,8,3,June 9 2017,5
Colorado Rockies,0,Chicago Cubs,8,5,June 9 2017,3
Chicago White Sox,1,Cleveland Indians,10,3,June 9 2017,7
Los Angeles Angels,0,Houston Astros,13,9,June 9 2017,4
Cincinnati Reds,1,Los Angeles Dodgers,9,2,June 9 2017,7
Baltimore Orioles,1,New York Yankees,10,2,June 9 2017,8
Miami Marlins,0,Pittsburgh Pirates,19,12,June 9 2017,7
Kansas City Royals,1,San Diego Padres,9,3,June 9 2017,6
Toronto Blue Jays,1,Seattle Mariners,6,2,June 9 2017,4
Minnesota Twins,0,San Francisco Giants,4,4,June 9 2017,0
Philadelphia Phillies,1,St. Louis Cardinals,5,2,June 9 2017,3
Oakland Athletics,1,Tampa Bay Rays,17,4,June 9 2017,13
Texas Rangers,0,Washington Nationals,7,5,June 9 2017,2
Milwaukee Brewers,1,Arizona D'Backs,5,2,June 10 2017,3
New York Mets,0,Atlanta Braves,7,6,June 10 2017,1
New York Mets,0,Atlanta Braves,9,8,June 10 2017,1
Detroit Tigers,1,Boston Red Sox,14,3,June 10 2017,11
Colorado Rockies,0,Chicago Cubs,10,9,June 10 2017,1
Chicago White Sox,0,Cleveland Indians,8,5,June 10 2017,3
Los Angeles Angels,1,Houston Astros,4,1,June 10 2017,3
Cincinnati Reds,1,Los Angeles Dodgers,9,4,June 10 2017,5
Baltimore Orioles,1,New York Yankees,19,3,June 10 2017,16
Miami Marlins,1,Pittsburgh Pirates,13,6,June 10 2017,7
Kansas City Royals,0,San Diego Padres,18,12,June 10 2017,6
Toronto Blue Jays,0,Seattle Mariners,6,4,June 10 2017,2
Minnesota Twins,0,San Francisco Giants,5,3,June 10 2017,2
Philadelphia Phillies,1,St. Louis Cardinals,7,0,June 10 2017,7
Oakland Athletics,1,Tampa Bay Rays,11,5,June 10 2017,6
Oakland Athletics,0,Tampa Bay Rays,9,7,June 10 2017,2
Texas Rangers,0,Washington Nationals,9,6,June 10 2017,3
Milwaukee Brewers,1,Arizona D'Backs,12,1,June 11 2017,11
New York Mets,0,Atlanta Braves,3,2,June 11 2017,1
Detroit Tigers,0,Boston Red Sox,11,8,June 11 2017,3
Colorado Rockies,1,Chicago Cubs,12,5,June 11 2017,7
Chicago White Sox,1,Cleveland Indians,6,2,June 11 2017,4
Los Angeles Angels,0,Houston Astros,18,12,June 11 2017,6
Cincinnati Reds,1,Los Angeles Dodgers,16,7,June 11 2017,9
Baltimore Orioles,1,New York Yankees,17,3,June 11 2017,14
Miami Marlins,1,Pittsburgh Pirates,4,1,June 11 2017,3
Kansas City Royals,0,San Diego Padres,11,8,June 11 2017,3
Toronto Blue Jays,0,Seattle Mariners,4,4,June 11 2017,0
Minnesota Twins,1,San Francisco Giants,21,8,June 11 2017,13
Philadelphia Phillies,1,St. Louis Cardinals,11,5,June 11 2017,6
Oakland Athletics,1,Tampa Bay Rays,9,4,June 11 2017,5
Texas Rangers,0,Washington Nationals,6,5,June 11 2017,1
New York Yankees,0,Los Angeles Angels,8,5,June 12 2017,3
Philadelphia Phillies,1,Boston Red Sox,11,5,June 12 2017,6
Baltimore Orioles,1,Chicago White Sox,17,7,June 12 2017,10
Texas Rangers,0,Houston Astros,7,6,June 12 2017,1
Seattle Mariners,0,Minnesota Twins,17,14,June 12 2017,3
Chicago Cubs,1,New York Mets,7,1,June 12 2017,6
Colorado Rockies,1,Pittsburgh Pirates,9,2,June 12 2017,7
Cincinnati Reds,1,San Diego Padres,12,3,June 12 2017,9
Atlanta Braves,0,Washington Nationals,21,11,June 12 2017,10
New York Yankees,1,Los Angeles Angels,5,2,June 13 2017,3
Philadelphia Phillies,1,Boston Red Sox,7,3,June 13 2017,4
Baltimore Orioles,1,Chicago White Sox,7,1,June 13 2017,6
Los Angeles Dodgers,0,Cleveland Indians,12,7,June 13 2017,5
Arizona D'Backs,0,Detroit Tigers,13,7,June 13 2017,6
Texas Rangers,0,Houston Astros,6,4,June 13 2017,2
Oakland Athletics,1,Miami Marlins,9,1,June 13 2017,8
Seattle Mariners,1,Minnesota Twins,27,7,June 13 2017,20
Chicago Cubs,0,New York Mets,17,14,June 13 2017,3
Colorado Rockies,1,Pittsburgh Pirates,7,2,June 13 2017,5
Cincinnati Reds,1,San Diego Padres,8,2,June 13 2017,6
Kansas City Royals,0,San Francisco Giants,9,8,June 13 2017,1
Milwaukee Brewers,1,St. Louis Cardinals,6,0,June 13 2017,6
Milwaukee Brewers,0,St. Louis Cardinals,13,8,June 13 2017,5
Tampa Bay Rays,0,Toronto Blue Jays,9,8,June 13 2017,1
Atlanta Braves,1,Washington Nationals,15,5,June 13 2017,10
New York Yankees,1,Los Angeles Angels,12,5,June 14 2017,7
Baltimore Orioles,0,Chicago White Sox,16,10,June 14 2017,6
Los Angeles Dodgers,0,Cleveland Indians,10,6,June 14 2017,4
Arizona D'Backs,0,Detroit Tigers,3,2,June 14 2017,1
Texas Rangers,1,Houston Astros,15,2,June 14 2017,13
Oakland Athletics,1,Miami Marlins,17,6,June 14 2017,11
Seattle Mariners,0,Minnesota Twins,10,6,June 14 2017,4
Chicago Cubs,1,New York Mets,13,4,June 14 2017,9
Boston Red Sox,0,Philadelphia Phillies,10,7,June 14 2017,3
Colorado Rockies,0,Pittsburgh Pirates,6,5,June 14 2017,1
Cincinnati Reds,1,San Diego Padres,6,2,June 14 2017,4
Kansas City Royals,0,San Francisco Giants,9,7,June 14 2017,2
Milwaukee Brewers,0,St. Louis Cardinals,13,7,June 14 2017,6
Tampa Bay Rays,1,Toronto Blue Jays,13,6,June 14 2017,7
Atlanta Braves,0,Washington Nationals,15,13,June 14 2017,2
Kansas City Royals,0,Los Angeles Angels,9,7,June 15 2017,2
Baltimore Orioles,1,Chicago White Sox,7,2,June 15 2017,5
Los Angeles Dodgers,1,Cleveland Indians,17,5,June 15 2017,12
San Francisco Giants,1,Colorado Rockies,19,9,June 15 2017,10
Tampa Bay Rays,1,Detroit Tigers,8,3,June 15 2017,5
Seattle Mariners,1,Minnesota Twins,8,2,June 15 2017,6
Washington Nationals,0,New York Mets,11,8,June 15 2017,3
New York Yankees,1,Oakland Athletics,15,7,June 15 2017,8
Boston Red Sox,1,Philadelphia Phillies,1,0,June 15 2017,1
Milwaukee Brewers,0,St. Louis Cardinals,10,6,June 15 2017,4
Kansas City Royals,0,Los Angeles Angels,4,3,June 16 2017,1
Miami Marlins,0,Atlanta Braves,5,5,June 16 2017,0
St. Louis Cardinals,0,Baltimore Orioles,13,11,June 16 2017,2
Los Angeles Dodgers,0,Cincinnati Reds,4,3,June 16 2017,1
San Francisco Giants,1,Colorado Rockies,18,8,June 16 2017,10
Tampa Bay Rays,1,Detroit Tigers,17,4,June 16 2017,13
Boston Red Sox,0,Houston Astros,3,2,June 16 2017,1
San Diego Padres,1,Milwaukee Brewers,11,5,June 16 2017,6
Cleveland Indians,0,Minnesota Twins,9,8,June 16 2017,1
Washington Nationals,0,New York Mets,9,7,June 16 2017,2
New York Yankees,1,Oakland Athletics,13,6,June 16 2017,7
Arizona D'Backs,0,Philadelphia Phillies,9,5,June 16 2017,4
Chicago Cubs,0,Pittsburgh Pirates,14,9,June 16 2017,5
Seattle Mariners,1,Texas Rangers,14,4,June 16 2017,10
Chicago White Sox,0,Toronto Blue Jays,15,11,June 16 2017,4
Kansas City Royals,1,Los Angeles Angels,9,0,June 17 2017,9
Miami Marlins,1,Atlanta Braves,15,7,June 17 2017,8
St. Louis Cardinals,1,Baltimore Orioles,22,7,June 17 2017,15
Los Angeles Dodgers,0,Cincinnati Reds,12,10,June 17 2017,2
San Francisco Giants,1,Colorado Rockies,6,1,June 17 2017,5
Tampa Bay Rays,0,Detroit Tigers,5,3,June 17 2017,2
Boston Red Sox,1,Houston Astros,8,1,June 17 2017,7
San Diego Padres,0,Milwaukee Brewers,12,7,June 17 2017,5
Cleveland Indians,0,Minnesota Twins,12,9,June 17 2017,3
Cleveland Indians,0,Minnesota Twins,8,6,June 17 2017,2
Washington Nationals,0,New York Mets,11,7,June 17 2017,4
New York Yankees,1,Oakland Athletics,7,2,June 17 2017,5
Arizona D'Backs,0,Philadelphia Phillies,6,5,June 17 2017,1
Chicago Cubs,1,Pittsburgh Pirates,7,3,June 17 2017,4
Seattle Mariners,1,Texas Rangers,14,4,June 17 2017,10
Chicago White Sox,0,Toronto Blue Jays,7,5,June 17 2017,2
Kansas City Royals,0,Los Angeles Angels,10,7,June 18 2017,3
Miami Marlins,1,Atlanta Braves,9,4,June 18 2017,5
St. Louis Cardinals,1,Baltimore Orioles,13,5,June 18 2017,8
Los Angeles Dodgers,0,Cincinnati Reds,15,8,June 18 2017,7
San Francisco Giants,1,Colorado Rockies,12,5,June 18 2017,7
Tampa Bay Rays,0,Detroit Tigers,10,9,June 18 2017,1
Boston Red Sox,0,Houston Astros,11,6,June 18 2017,5
San Diego Padres,1,Milwaukee Brewers,3,1,June 18 2017,2
Cleveland Indians,0,Minnesota Twins,7,5,June 18 2017,2
Washington Nationals,1,New York Mets,6,1,June 18 2017,5
New York Yankees,1,Oakland Athletics,7,3,June 18 2017,4
Arizona D'Backs,0,Philadelphia Phillies,9,5,June 18 2017,4
Chicago Cubs,0,Pittsburgh Pirates,8,7,June 18 2017,1
Seattle Mariners,0,Texas Rangers,10,7,June 18 2017,3
Chicago White Sox,1,Toronto Blue Jays,10,3,June 18 2017,7
San Francisco Giants,1,Atlanta Braves,9,0,June 19 2017,9
Cleveland Indians,0,Baltimore Orioles,12,12,June 19 2017,0
San Diego Padres,1,Chicago Cubs,5,2,June 19 2017,3
Boston Red Sox,1,Kansas City Royals,6,2,June 19 2017,4
New York Mets,1,Los Angeles Dodgers,16,6,June 19 2017,10
Washington Nationals,1,Miami Marlins,15,7,June 19 2017,8
Pittsburgh Pirates,0,Milwaukee Brewers,9,8,June 19 2017,1
Houston Astros,0,Oakland Athletics,5,4,June 19 2017,1
Detroit Tigers,1,Seattle Mariners,8,2,June 19 2017,6
Cincinnati Reds,0,Tampa Bay Rays,10,7,June 19 2017,3
Toronto Blue Jays,0,Texas Rangers,13,7,June 19 2017,6
San Francisco Giants,0,Atlanta Braves,9,6,June 20 2017,3
Cleveland Indians,1,Baltimore Orioles,11,5,June 20 2017,6
San Diego Padres,1,Chicago Cubs,4,0,June 20 2017,4
Arizona D'Backs,1,Colorado Rockies,7,3,June 20 2017,4
Boston Red Sox,0,Kansas City Royals,11,8,June 20 2017,3
New York Mets,1,Los Angeles Dodgers,12,0,June 20 2017,12
Washington Nationals,0,Miami Marlins,15,12,June 20 2017,3
Pittsburgh Pirates,0,Milwaukee Brewers,10,7,June 20 2017,3
Chicago White Sox,1,Minnesota Twins,16,7,June 20 2017,9
Los Angeles Angels,0,New York Yankees,11,8,June 20 2017,3
Houston Astros,0,Oakland Athletics,12,8,June 20 2017,4
St. Louis Cardinals,0,Philadelphia Phillies,9,8,June 20 2017,1
Detroit Tigers,1,Seattle Mariners,9,4,June 20 2017,5
Cincinnati Reds,1,Tampa Bay Rays,11,5,June 20 2017,6
Toronto Blue Jays,1,Texas Rangers,7,1,June 20 2017,6
San Francisco Giants,1,Atlanta Braves,8,3,June 21 2017,5
Cleveland Indians,0,Baltimore Orioles,6,5,June 21 2017,1
San Diego Padres,0,Chicago Cubs,5,3,June 21 2017,2
Arizona D'Backs,0,Colorado Rockies,21,16,June 21 2017,5
Boston Red Sox,1,Kansas City Royals,10,4,June 21 2017,6
New York Mets,1,Los Angeles Dodgers,10,2,June 21 2017,8
Washington Nationals,1,Miami Marlins,3,1,June 21 2017,2
Pittsburgh Pirates,1,Milwaukee Brewers,7,3,June 21 2017,4
Chicago White Sox,1,Minnesota Twins,6,2,June 21 2017,4
Los Angeles Angels,1,New York Yankees,12,4,June 21 2017,8
Houston Astros,0,Oakland Athletics,6,5,June 21 2017,1
St. Louis Cardinals,0,Philadelphia Phillies,13,7,June 21 2017,6
Detroit Tigers,1,Seattle Mariners,12,5,June 21 2017,7
Cincinnati Reds,1,Tampa Bay Rays,11,3,June 21 2017,8
Toronto Blue Jays,0,Texas Rangers,12,7,June 21 2017,5
San Francisco Giants,1,Atlanta Braves,23,11,June 22 2017,12
Cleveland Indians,0,Baltimore Orioles,9,6,June 22 2017,3
Arizona D'Backs,0,Colorado Rockies,13,10,June 22 2017,3
New York Mets,1,Los Angeles Dodgers,9,3,June 22 2017,6
Chicago Cubs,0,Miami Marlins,12,11,June 22 2017,1
Pittsburgh Pirates,1,Milwaukee Brewers,6,2,June 22 2017,4
Chicago White Sox,0,Minnesota Twins,9,9,June 22 2017,0
Los Angeles Angels,0,New York Yankees,15,10,June 22 2017,5
Houston Astros,0,Oakland Athletics,21,12,June 22 2017,9
St. Louis Cardinals,1,Philadelphia Phillies,6,1,June 22 2017,5
Detroit Tigers,1,Seattle Mariners,15,6,June 22 2017,9
Toronto Blue Jays,1,Texas Rangers,15,4,June 22 2017,11
Philadelphia Phillies,0,Arizona D'Backs,7,6,June 23 2017,1
Milwaukee Brewers,1,Atlanta Braves,9,4,June 23 2017,5
Los Angeles Angels,1,Boston Red Sox,13,4,June 23 2017,9
Oakland Athletics,0,Chicago White Sox,3,3,June 23 2017,0
Minnesota Twins,0,Cleveland Indians,5,5,June 23 2017,0
Toronto Blue Jays,1,Kansas City Royals,9,4,June 23 2017,5
Colorado Rockies,1,Los Angeles Dodgers,7,1,June 23 2017,6
Chicago Cubs,1,Miami Marlins,2,0,June 23 2017,2
Texas Rangers,1,New York Yankees,3,1,June 23 2017,2
Detroit Tigers,1,San Diego Padres,1,0,June 23 2017,1
Houston Astros,1,Seattle Mariners,16,3,June 23 2017,13
New York Mets,0,San Francisco Giants,15,11,June 23 2017,4
Pittsburgh Pirates,0,St. Louis Cardinals,7,4,June 23 2017,3
Baltimore Orioles,1,Tampa Bay Rays,20,5,June 23 2017,15
Cincinnati Reds,1,Washington Nationals,11,5,June 23 2017,6
Philadelphia Phillies,1,Arizona D'Backs,11,2,June 24 2017,9
Milwaukee Brewers,1,Atlanta Braves,4,1,June 24 2017,3
Los Angeles Angels,0,Boston Red Sox,9,6,June 24 2017,3
Oakland Athletics,0,Chicago White Sox,12,10,June 24 2017,2
Minnesota Twins,0,Cleveland Indians,6,4,June 24 2017,2
Toronto Blue Jays,1,Kansas City Royals,5,2,June 24 2017,3
Colorado Rockies,1,Los Angeles Dodgers,4,0,June 24 2017,4
Chicago Cubs,0,Miami Marlins,8,5,June 24 2017,3
Texas Rangers,0,New York Yankees,9,8,June 24 2017,1
Detroit Tigers,1,San Diego Padres,10,3,June 24 2017,7
Houston Astros,0,Seattle Mariners,7,5,June 24 2017,2
New York Mets,0,San Francisco Giants,7,5,June 24 2017,2
Pittsburgh Pirates,0,St. Louis Cardinals,10,7,June 24 2017,3
Baltimore Orioles,0,Tampa Bay Rays,11,8,June 24 2017,3
Cincinnati Reds,1,Washington Nationals,21,3,June 24 2017,18
Philadelphia Phillies,1,Arizona D'Backs,3,1,June 25 2017,2
Milwaukee Brewers,0,Atlanta Braves,7,7,June 25 2017,0
Los Angeles Angels,0,Boston Red Sox,6,4,June 25 2017,2
Oakland Athletics,0,Chicago White Sox,8,5,June 25 2017,3
Minnesota Twins,0,Cleveland Indians,4,4,June 25 2017,0
Toronto Blue Jays,0,Kansas City Royals,10,8,June 25 2017,2
Colorado Rockies,1,Los Angeles Dodgers,18,6,June 25 2017,12
Chicago Cubs,1,Miami Marlins,6,2,June 25 2017,4
Texas Rangers,0,New York Yankees,13,7,June 25 2017,6
Detroit Tigers,0,San Diego Padres,12,7,June 25 2017,5
Houston Astros,0,Seattle Mariners,10,8,June 25 2017,2
New York Mets,0,San Francisco Giants,10,8,June 25 2017,2
Pittsburgh Pirates,1,St. Louis Cardinals,12,4,June 25 2017,8
Baltimore Orioles,0,Tampa Bay Rays,13,8,June 25 2017,5
Cincinnati Reds,0,Washington Nationals,8,6,June 25 2017,2
Philadelphia Phillies,1,Arizona D'Backs,7,1,June 26 2017,6
Minnesota Twins,1,Boston Red Sox,5,1,June 26 2017,4
New York Yankees,0,Chicago White Sox,11,6,June 26 2017,5
Texas Rangers,1,Cleveland Indians,24,9,June 26 2017,15
Los Angeles Angels,0,Los Angeles Dodgers,4,4,June 26 2017,0
Colorado Rockies,1,San Francisco Giants,11,2,June 26 2017,9
Cincinnati Reds,1,St. Louis Cardinals,10,2,June 26 2017,8
Chicago Cubs,0,Washington Nationals,9,5,June 26 2017,4
St. Louis Cardinals,1,Arizona D'Backs,11,5,June 27 2017,6
Minnesota Twins,1,Boston Red Sox,11,2,June 27 2017,9
New York Yankees,1,Chicago White Sox,7,3,June 27 2017,4
Milwaukee Brewers,1,Cincinnati Reds,14,6,June 27 2017,8
Texas Rangers,0,Cleveland Indians,3,2,June 27 2017,1
Kansas City Royals,1,Detroit Tigers,8,3,June 27 2017,5
Oakland Athletics,0,Houston Astros,10,6,June 27 2017,4
Los Angeles Angels,1,Los Angeles Dodgers,4,0,June 27 2017,4
New York Mets,1,Miami Marlins,9,3,June 27 2017,6
Tampa Bay Rays,0,Pittsburgh Pirates,6,4,June 27 2017,2
Atlanta Braves,0,San Diego Padres,3,3,June 27 2017,0
Philadelphia Phillies,0,Seattle Mariners,10,8,June 27 2017,2
Colorado Rockies,1,San Francisco Giants,7,3,June 27 2017,4
Baltimore Orioles,0,Toronto Blue Jays,4,3,June 27 2017,1
Chicago Cubs,1,Washington Nationals,7,1,June 27 2017,6
Los Angeles Dodgers,1,Los Angeles Angels,5,2,June 28 2017,3
St. Louis Cardinals,0,Arizona D'Backs,7,4,June 28 2017,3
Minnesota Twins,0,Boston Red Sox,5,4,June 28 2017,1
New York Yankees,0,Chicago White Sox,15,12,June 28 2017,3
Milwaukee Brewers,1,Cincinnati Reds,7,3,June 28 2017,4
Texas Rangers,1,Cleveland Indians,8,3,June 28 2017,5
Kansas City Royals,0,Detroit Tigers,10,8,June 28 2017,2
Oakland Athletics,1,Houston Astros,19,8,June 28 2017,11
New York Mets,0,Miami Marlins,8,8,June 28 2017,0
Tampa Bay Rays,1,Pittsburgh Pirates,8,2,June 28 2017,6
Atlanta Braves,1,San Diego Padres,11,4,June 28 2017,7
Philadelphia Phillies,0,Seattle Mariners,9,5,June 28 2017,4
Colorado Rockies,1,San Francisco Giants,8,3,June 28 2017,5
Baltimore Orioles,1,Toronto Blue Jays,4,0,June 28 2017,4
Chicago Cubs,1,Washington Nationals,12,4,June 28 2017,8
Los Angeles Dodgers,0,Los Angeles Angels,8,6,June 29 2017,2
St. Louis Cardinals,0,Arizona D'Backs,14,10,June 29 2017,4
Minnesota Twins,1,Boston Red Sox,9,3,June 29 2017,6
New York Yankees,1,Chicago White Sox,7,3,June 29 2017,4
Milwaukee Brewers,0,Cincinnati Reds,14,11,June 29 2017,3
Texas Rangers,1,Cleveland Indians,6,1,June 29 2017,5
Kansas City Royals,1,Detroit Tigers,10,3,June 29 2017,7
Oakland Athletics,1,Houston Astros,7,1,June 29 2017,6
New York Mets,0,Miami Marlins,9,6,June 29 2017,3
Tampa Bay Rays,1,Pittsburgh Pirates,4,0,June 29 2017,4
Atlanta Braves,1,San Diego Padres,6,0,June 29 2017,6
Baltimore Orioles,0,Toronto Blue Jays,2,2,June 29 2017,0
Chicago Cubs,0,Washington Nationals,9,5,June 29 2017,4
Seattle Mariners,0,Los Angeles Angels,10,10,June 30 2017,0
Colorado Rockies,0,Arizona D'Backs,9,6,June 30 2017,3
Tampa Bay Rays,0,Baltimore Orioles,10,6,June 30 2017,4
Texas Rangers,1,Chicago White Sox,15,7,June 30 2017,8
Chicago Cubs,1,Cincinnati Reds,5,0,June 30 2017,5
New York Yankees,0,Houston Astros,17,13,June 30 2017,4
Minnesota Twins,1,Kansas City Royals,9,1,June 30 2017,8
Miami Marlins,1,Milwaukee Brewers,5,2,June 30 2017,3
Philadelphia Phillies,1,New York Mets,3,1,June 30 2017,2
Atlanta Braves,0,Oakland Athletics,4,3,June 30 2017,1
San Francisco Giants,0,Pittsburgh Pirates,18,13,June 30 2017,5
Los Angeles Dodgers,0,San Diego Padres,14,10,June 30 2017,4
Washington Nationals,1,St. Louis Cardinals,9,1,June 30 2017,8
Boston Red Sox,0,Toronto Blue Jays,11,7,June 30 2017,4
Seattle Mariners,1,Los Angeles Angels,4,0,July 1 2017,4
Colorado Rockies,1,Arizona D'Backs,8,2,July 1 2017,6
Tampa Bay Rays,0,Baltimore Orioles,13,10,July 1 2017,3
Texas Rangers,0,Chicago White Sox,14,10,July 1 2017,4
Chicago Cubs,1,Cincinnati Reds,8,3,July 1 2017,5
Cleveland Indians,1,Detroit Tigers,11,4,July 1 2017,7
Cleveland Indians,0,Detroit Tigers,5,4,July 1 2017,1
New York Yankees,1,Houston Astros,13,6,July 1 2017,7
Minnesota Twins,1,Kansas City Royals,17,6,July 1 2017,11
Minnesota Twins,0,Kansas City Royals,15,10,July 1 2017,5
Miami Marlins,1,Milwaukee Brewers,12,4,July 1 2017,8
Philadelphia Phillies,1,New York Mets,13,6,July 1 2017,7
Atlanta Braves,0,Oakland Athletics,7,4,July 1 2017,3
San Francisco Giants,0,Pittsburgh Pirates,3,2,July 1 2017,1
Los Angeles Dodgers,0,San Diego Padres,8,8,July 1 2017,0
Washington Nationals,1,St. Louis Cardinals,3,1,July 1 2017,2
Boston Red Sox,0,Toronto Blue Jays,8,7,July 1 2017,1
Seattle Mariners,0,Los Angeles Angels,8,5,July 2 2017,3
Colorado Rockies,1,Arizona D'Backs,7,3,July 2 2017,4
Tampa Bay Rays,1,Baltimore Orioles,8,1,July 2 2017,7
Texas Rangers,1,Chicago White Sox,11,5,July 2 2017,6
Chicago Cubs,0,Cincinnati Reds,8,6,July 2 2017,2
Cleveland Indians,0,Detroit Tigers,19,11,July 2 2017,8
New York Yankees,1,Houston Astros,9,1,July 2 2017,8
Minnesota Twins,1,Kansas City Royals,8,2,July 2 2017,6
Miami Marlins,0,Milwaukee Brewers,13,10,July 2 2017,3
Philadelphia Phillies,0,New York Mets,8,7,July 2 2017,1
Atlanta Braves,0,Oakland Athletics,7,4,July 2 2017,3
San Francisco Giants,0,Pittsburgh Pirates,8,5,July 2 2017,3
Los Angeles Dodgers,1,San Diego Padres,8,3,July 2 2017,5
Washington Nationals,0,St. Louis Cardinals,9,7,July 2 2017,2
Boston Red Sox,0,Toronto Blue Jays,16,15,July 2 2017,1
Cincinnati Reds,1,Colorado Rockies,8,3,July 3 2017,5
Baltimore Orioles,1,Milwaukee Brewers,9,1,July 3 2017,8
Los Angeles Angels,1,Minnesota Twins,14,5,July 3 2017,9
Toronto Blue Jays,1,New York Yankees,9,3,July 3 2017,6
Chicago White Sox,0,Oakland Athletics,9,7,July 3 2017,2
Pittsburgh Pirates,1,Philadelphia Phillies,4,0,July 3 2017,4
Kansas City Royals,0,Seattle Mariners,4,3,July 3 2017,1
Miami Marlins,1,St. Louis Cardinals,20,6,July 3 2017,14
Boston Red Sox,0,Texas Rangers,12,7,July 3 2017,5
New York Mets,1,Washington Nationals,5,2,July 3 2017,3
Houston Astros,0,Atlanta Braves,20,16,July 4 2017,4
Tampa Bay Rays,0,Chicago Cubs,11,6,July 4 2017,5
San Diego Padres,0,Cleveland Indians,1,1,July 4 2017,0
Cincinnati Reds,0,Colorado Rockies,9,8,July 4 2017,1
San Francisco Giants,1,Detroit Tigers,8,3,July 4 2017,5
Arizona D'Backs,1,Los Angeles Dodgers,7,3,July 4 2017,4
Baltimore Orioles,1,Milwaukee Brewers,8,2,July 4 2017,6
Los Angeles Angels,1,Minnesota Twins,9,4,July 4 2017,5
Toronto Blue Jays,0,New York Yankees,5,4,July 4 2017,1
Chicago White Sox,1,Oakland Athletics,13,6,July 4 2017,7
Pittsburgh Pirates,0,Philadelphia Phillies,3,3,July 4 2017,0
Kansas City Royals,0,Seattle Mariners,10,7,July 4 2017,3
Miami Marlins,0,St. Louis Cardinals,7,5,July 4 2017,2
Boston Red Sox,0,Texas Rangers,15,11,July 4 2017,4
New York Mets,1,Washington Nationals,15,4,July 4 2017,11
Houston Astros,0,Atlanta Braves,14,10,July 5 2017,4
Tampa Bay Rays,1,Chicago Cubs,10,3,July 5 2017,7
San Diego Padres,0,Cleveland Indians,8,6,July 5 2017,2
Cincinnati Reds,1,Colorado Rockies,8,3,July 5 2017,5
San Francisco Giants,0,Detroit Tigers,9,5,July 5 2017,4
Arizona D'Backs,1,Los Angeles Dodgers,1,0,July 5 2017,1
Baltimore Orioles,1,Milwaukee Brewers,4,0,July 5 2017,4
Los Angeles Angels,0,Minnesota Twins,3,2,July 5 2017,1
Toronto Blue Jays,0,New York Yankees,13,7,July 5 2017,6
Chicago White Sox,1,Oakland Athletics,11,4,July 5 2017,7
Pittsburgh Pirates,0,Philadelphia Phillies,7,5,July 5 2017,2
Kansas City Royals,0,Seattle Mariners,15,9,July 5 2017,6
Miami Marlins,0,St. Louis Cardinals,15,9,July 5 2017,6
Boston Red Sox,1,Texas Rangers,10,2,July 5 2017,8
Milwaukee Brewers,0,Chicago Cubs,13,11,July 6 2017,2
San Diego Padres,1,Cleveland Indians,13,2,July 6 2017,11
Cincinnati Reds,0,Colorado Rockies,9,6,July 6 2017,3
San Francisco Giants,1,Detroit Tigers,8,2,July 6 2017,6
Arizona D'Backs,1,Los Angeles Dodgers,9,4,July 6 2017,5
Baltimore Orioles,1,Minnesota Twins,10,4,July 6 2017,6
Pittsburgh Pirates,0,Philadelphia Phillies,9,6,July 6 2017,3
Oakland Athletics,0,Seattle Mariners,11,7,July 6 2017,4
Miami Marlins,1,St. Louis Cardinals,7,3,July 6 2017,4
Boston Red Sox,1,Tampa Bay Rays,5,1,July 6 2017,4
Houston Astros,1,Toronto Blue Jays,11,4,July 6 2017,7
Atlanta Braves,0,Washington Nationals,7,5,July 6 2017,2
Cincinnati Reds,1,Arizona D'Backs,9,3,July 7 2017,6
Pittsburgh Pirates,1,Chicago Cubs,7,1,July 7 2017,6
Detroit Tigers,1,Cleveland Indians,13,2,July 7 2017,11
Chicago White Sox,1,Colorado Rockies,16,4,July 7 2017,12
Kansas City Royals,1,Los Angeles Dodgers,5,1,July 7 2017,4
Baltimore Orioles,1,Minnesota Twins,15,6,July 7 2017,9
Milwaukee Brewers,0,New York Yankees,13,9,July 7 2017,4
San Diego Padres,0,Philadelphia Phillies,7,4,July 7 2017,3
Oakland Athletics,1,Seattle Mariners,9,2,July 7 2017,7
Miami Marlins,0,San Francisco Giants,7,6,July 7 2017,1
New York Mets,0,St. Louis Cardinals,11,6,July 7 2017,5
Boston Red Sox,0,Tampa Bay Rays,11,8,July 7 2017,3
Los Angeles Angels,1,Texas Rangers,10,0,July 7 2017,10
Houston Astros,0,Toronto Blue Jays,14,12,July 7 2017,2
Atlanta Braves,1,Washington Nationals,9,4,July 7 2017,5
Cincinnati Reds,0,Arizona D'Backs,7,7,July 8 2017,0
Pittsburgh Pirates,0,Chicago Cubs,6,4,July 8 2017,2
Detroit Tigers,1,Cleveland Indians,4,0,July 8 2017,4
Chicago White Sox,0,Colorado Rockies,9,5,July 8 2017,4
Kansas City Royals,1,Los Angeles Dodgers,9,4,July 8 2017,5
Baltimore Orioles,0,Minnesota Twins,6,5,July 8 2017,1
Milwaukee Brewers,1,New York Yankees,8,3,July 8 2017,5
San Diego Padres,0,Philadelphia Phillies,3,2,July 8 2017,1
Oakland Athletics,0,Seattle Mariners,7,4,July 8 2017,3
Miami Marlins,0,San Francisco Giants,9,5,July 8 2017,4
New York Mets,1,St. Louis Cardinals,5,1,July 8 2017,4
Boston Red Sox,1,Tampa Bay Rays,1,0,July 8 2017,1
Los Angeles Angels,1,Texas Rangers,7,2,July 8 2017,5
Houston Astros,1,Toronto Blue Jays,9,2,July 8 2017,7
Atlanta Braves,0,Washington Nationals,13,13,July 8 2017,0
Cincinnati Reds,0,Arizona D'Backs,3,2,July 9 2017,1
Pittsburgh Pirates,0,Chicago Cubs,17,14,July 9 2017,3
Detroit Tigers,0,Cleveland Indians,8,5,July 9 2017,3
Chicago White Sox,1,Colorado Rockies,10,0,July 9 2017,10
Kansas City Royals,1,Los Angeles Dodgers,7,2,July 9 2017,5
Baltimore Orioles,0,Minnesota Twins,16,11,July 9 2017,5
Milwaukee Brewers,0,New York Yankees,8,5,July 9 2017,3
San Diego Padres,1,Philadelphia Phillies,8,1,July 9 2017,7
Oakland Athletics,1,Seattle Mariners,4,0,July 9 2017,4
Miami Marlins,0,San Francisco Giants,18,10,July 9 2017,8
New York Mets,1,St. Louis Cardinals,6,0,July 9 2017,6
Boston Red Sox,1,Tampa Bay Rays,8,3,July 9 2017,5
Los Angeles Angels,0,Texas Rangers,3,3,July 9 2017,0
Houston Astros,0,Toronto Blue Jays,20,19,July 9 2017,1
Atlanta Braves,1,Washington Nationals,15,5,July 9 2017,10
Tampa Bay Rays,0,Los Angeles Angels,3,2,July 14 2017,1
Arizona D'Backs,1,Atlanta Braves,7,3,July 14 2017,4
Chicago Cubs,0,Baltimore Orioles,17,9,July 14 2017,8
New York Yankees,1,Boston Red Sox,9,4,July 14 2017,5
Seattle Mariners,0,Chicago White Sox,6,4,July 14 2017,2
Washington Nationals,0,Cincinnati Reds,5,5,July 14 2017,0
Toronto Blue Jays,0,Detroit Tigers,9,7,July 14 2017,2
Minnesota Twins,1,Houston Astros,15,5,July 14 2017,10
Texas Rangers,0,Kansas City Royals,8,5,July 14 2017,3
Los Angeles Dodgers,0,Miami Marlins,10,6,July 14 2017,4
Philadelphia Phillies,1,Milwaukee Brewers,15,6,July 14 2017,9
Colorado Rockies,1,New York Mets,16,2,July 14 2017,14
Cleveland Indians,1,Oakland Athletics,5,0,July 14 2017,5
St. Louis Cardinals,1,Pittsburgh Pirates,7,2,July 14 2017,5
San Francisco Giants,0,San Diego Padres,9,5,July 14 2017,4
Tampa Bay Rays,0,Los Angeles Angels,9,6,July 15 2017,3
Arizona D'Backs,1,Atlanta Braves,13,5,July 15 2017,8
Chicago Cubs,0,Baltimore Orioles,13,10,July 15 2017,3
New York Yankees,0,Boston Red Sox,5,4,July 15 2017,1
Seattle Mariners,0,Chicago White Sox,7,4,July 15 2017,3
Washington Nationals,0,Cincinnati Reds,17,10,July 15 2017,7
Toronto Blue Jays,1,Detroit Tigers,12,1,July 15 2017,11
Minnesota Twins,0,Houston Astros,6,4,July 15 2017,2
Texas Rangers,0,Kansas City Royals,1,1,July 15 2017,0
Los Angeles Dodgers,0,Miami Marlins,8,7,July 15 2017,1
Philadelphia Phillies,1,Milwaukee Brewers,5,2,July 15 2017,3
Colorado Rockies,1,New York Mets,12,3,July 15 2017,9
Cleveland Indians,1,Oakland Athletics,8,3,July 15 2017,5
St. Louis Cardinals,0,Pittsburgh Pirates,4,4,July 15 2017,0
San Francisco Giants,1,San Diego Padres,8,3,July 15 2017,5
Tampa Bay Rays,1,Los Angeles Angels,7,3,July 16 2017,4
Arizona D'Backs,1,Atlanta Braves,8,1,July 16 2017,7
Chicago Cubs,0,Baltimore Orioles,8,8,July 16 2017,0
New York Yankees,0,Boston Red Sox,3,3,July 16 2017,0
New York Yankees,1,Boston Red Sox,3,0,July 16 2017,3
Seattle Mariners,0,Chicago White Sox,13,7,July 16 2017,6
Washington Nationals,0,Cincinnati Reds,18,14,July 16 2017,4
Toronto Blue Jays,1,Detroit Tigers,11,5,July 16 2017,6
Minnesota Twins,1,Houston Astros,8,3,July 16 2017,5
Texas Rangers,1,Kansas City Royals,7,3,July 16 2017,4
Los Angeles Dodgers,0,Miami Marlins,5,3,July 16 2017,2
Philadelphia Phillies,0,Milwaukee Brewers,7,5,July 16 2017,2
Colorado Rockies,0,New York Mets,17,13,July 16 2017,4
Cleveland Indians,1,Oakland Athletics,10,3,July 16 2017,7
St. Louis Cardinals,1,Pittsburgh Pirates,7,3,July 16 2017,4
San Francisco Giants,1,San Diego Padres,8,1,July 16 2017,7
Chicago Cubs,0,Atlanta Braves,7,4,July 17 2017,3
Texas Rangers,1,Baltimore Orioles,4,1,July 17 2017,3
Toronto Blue Jays,0,Boston Red Sox,7,4,July 17 2017,3
Washington Nationals,0,Cincinnati Reds,7,6,July 17 2017,1
San Diego Padres,1,Colorado Rockies,15,6,July 17 2017,9
Seattle Mariners,0,Houston Astros,16,9,July 17 2017,7
Detroit Tigers,0,Kansas City Royals,12,10,July 17 2017,2
Philadelphia Phillies,1,Miami Marlins,11,5,July 17 2017,6
New York Yankees,1,Minnesota Twins,6,2,July 17 2017,4
St. Louis Cardinals,0,New York Mets,9,6,July 17 2017,3
Tampa Bay Rays,0,Oakland Athletics,5,3,July 17 2017,2
Milwaukee Brewers,1,Pittsburgh Pirates,6,2,July 17 2017,4
Cleveland Indians,0,San Francisco Giants,8,5,July 17 2017,3
Washington Nationals,0,Los Angeles Angels,7,4,July 18 2017,3
Chicago Cubs,0,Atlanta Braves,6,5,July 18 2017,1
Texas Rangers,1,Baltimore Orioles,13,1,July 18 2017,12
Toronto Blue Jays,1,Boston Red Sox,9,4,July 18 2017,5
Los Angeles Dodgers,0,Chicago White Sox,1,1,July 18 2017,0
Arizona D'Backs,0,Cincinnati Reds,13,11,July 18 2017,2
San Diego Padres,1,Colorado Rockies,16,7,July 18 2017,9
Seattle Mariners,1,Houston Astros,8,2,July 18 2017,6
Detroit Tigers,0,Kansas City Royals,12,9,July 18 2017,3
Philadelphia Phillies,0,Miami Marlins,7,5,July 18 2017,2
New York Yankees,0,Minnesota Twins,9,6,July 18 2017,3
St. Louis Cardinals,0,New York Mets,5,5,July 18 2017,0
Tampa Bay Rays,0,Oakland Athletics,7,4,July 18 2017,3
Milwaukee Brewers,1,Pittsburgh Pirates,7,3,July 18 2017,4
Cleveland Indians,1,San Francisco Giants,3,1,July 18 2017,2
Washington Nationals,1,Los Angeles Angels,7,0,July 19 2017,7
Chicago Cubs,0,Atlanta Braves,10,8,July 19 2017,2
Texas Rangers,1,Baltimore Orioles,12,2,July 19 2017,10
Toronto Blue Jays,1,Boston Red Sox,6,1,July 19 2017,5
Los Angeles Dodgers,0,Chicago White Sox,10,9,July 19 2017,1
Arizona D'Backs,1,Cincinnati Reds,7,3,July 19 2017,4
San Diego Padres,1,Colorado Rockies,22,4,July 19 2017,18
Seattle Mariners,0,Houston Astros,5,4,July 19 2017,1
Detroit Tigers,1,Kansas City Royals,7,3,July 19 2017,4
Philadelphia Phillies,0,Miami Marlins,13,10,July 19 2017,3
New York Yankees,1,Minnesota Twins,7,1,July 19 2017,6
St. Louis Cardinals,1,New York Mets,10,3,July 19 2017,7
Tampa Bay Rays,1,Oakland Athletics,9,2,July 19 2017,7
Milwaukee Brewers,1,Pittsburgh Pirates,5,2,July 19 2017,3
Cleveland Indians,1,San Francisco Giants,9,4,July 19 2017,5
Texas Rangers,1,Baltimore Orioles,16,7,July 20 2017,9
Toronto Blue Jays,0,Boston Red Sox,14,8,July 20 2017,6
Arizona D'Backs,0,Cincinnati Reds,14,12,July 20 2017,2
Detroit Tigers,1,Kansas City Royals,20,4,July 20 2017,16
Atlanta Braves,0,Los Angeles Dodgers,9,6,July 20 2017,3
St. Louis Cardinals,1,New York Mets,5,2,July 20 2017,3
Milwaukee Brewers,1,Pittsburgh Pirates,6,2,July 20 2017,4
New York Yankees,0,Seattle Mariners,5,4,July 20 2017,1
San Diego Padres,0,San Francisco Giants,7,5,July 20 2017,2
Boston Red Sox,0,Los Angeles Angels,8,6,July 21 2017,2
Washington Nationals,1,Arizona D'Backs,11,5,July 21 2017,6
Houston Astros,0,Baltimore Orioles,15,8,July 21 2017,7
St. Louis Cardinals,0,Chicago Cubs,15,11,July 21 2017,4
Miami Marlins,0,Cincinnati Reds,4,3,July 21 2017,1
Toronto Blue Jays,1,Cleveland Indians,16,3,July 21 2017,13
Pittsburgh Pirates,0,Colorado Rockies,18,13,July 21 2017,5
Chicago White Sox,1,Kansas City Royals,13,6,July 21 2017,7
Atlanta Braves,0,Los Angeles Dodgers,15,12,July 21 2017,3
Detroit Tigers,0,Minnesota Twins,9,6,July 21 2017,3
Oakland Athletics,1,New York Mets,12,5,July 21 2017,7
Milwaukee Brewers,1,Philadelphia Phillies,7,1,July 21 2017,6
New York Yankees,0,Seattle Mariners,6,5,July 21 2017,1
San Diego Padres,0,San Francisco Giants,21,12,July 21 2017,9
Texas Rangers,0,Tampa Bay Rays,7,4,July 21 2017,3
Boston Red Sox,1,Los Angeles Angels,10,3,July 22 2017,7
Washington Nationals,0,Arizona D'Backs,7,4,July 22 2017,3
Houston Astros,0,Baltimore Orioles,12,8,July 22 2017,4
St. Louis Cardinals,1,Chicago Cubs,5,2,July 22 2017,3
Miami Marlins,0,Cincinnati Reds,9,5,July 22 2017,4
Toronto Blue Jays,1,Cleveland Indians,3,1,July 22 2017,2
Pittsburgh Pirates,1,Colorado Rockies,10,3,July 22 2017,7
Chicago White Sox,1,Kansas City Royals,9,2,July 22 2017,7
Atlanta Braves,1,Los Angeles Dodgers,8,2,July 22 2017,6
Detroit Tigers,1,Minnesota Twins,11,5,July 22 2017,6
Oakland Athletics,1,New York Mets,11,5,July 22 2017,6
Milwaukee Brewers,0,Philadelphia Phillies,17,9,July 22 2017,8
New York Yankees,1,Seattle Mariners,11,5,July 22 2017,6
San Diego Padres,1,San Francisco Giants,9,4,July 22 2017,5
Texas Rangers,0,Tampa Bay Rays,7,4,July 22 2017,3
Boston Red Sox,1,Los Angeles Angels,5,2,July 23 2017,3
Washington Nationals,0,Arizona D'Backs,8,6,July 23 2017,2
Houston Astros,1,Baltimore Orioles,16,7,July 23 2017,9
St. Louis Cardinals,1,Chicago Cubs,8,3,July 23 2017,5
Miami Marlins,1,Cincinnati Reds,9,3,July 23 2017,6
Toronto Blue Jays,1,Cleveland Indians,9,1,July 23 2017,8
Pittsburgh Pirates,1,Colorado Rockies,16,3,July 23 2017,13
Chicago White Sox,1,Kansas City Royals,9,4,July 23 2017,5
Atlanta Braves,1,Los Angeles Dodgers,9,4,July 23 2017,5
Detroit Tigers,0,Minnesota Twins,15,9,July 23 2017,6
Oakland Athletics,0,New York Mets,5,3,July 23 2017,2
Milwaukee Brewers,1,Philadelphia Phillies,9,3,July 23 2017,6
New York Yankees,0,Seattle Mariners,10,6,July 23 2017,4
San Diego Padres,0,San Francisco Giants,7,5,July 23 2017,2
Texas Rangers,0,Tampa Bay Rays,11,6,July 23 2017,5
Atlanta Braves,1,Arizona D'Backs,12,2,July 24 2017,10
Chicago White Sox,0,Chicago Cubs,4,3,July 24 2017,1
Cincinnati Reds,1,Cleveland Indians,8,2,July 24 2017,6
Kansas City Royals,0,Detroit Tigers,8,5,July 24 2017,3
Minnesota Twins,1,Los Angeles Dodgers,10,4,July 24 2017,6
Houston Astros,0,Philadelphia Phillies,17,13,July 24 2017,4
New York Mets,0,San Diego Padres,8,5,July 24 2017,3
Boston Red Sox,1,Seattle Mariners,4,0,July 24 2017,4
Pittsburgh Pirates,0,San Francisco Giants,13,10,July 24 2017,3
Colorado Rockies,1,St. Louis Cardinals,10,2,July 24 2017,8
Baltimore Orioles,0,Tampa Bay Rays,5,5,July 24 2017,0
Miami Marlins,0,Texas Rangers,4,4,July 24 2017,0
Oakland Athletics,1,Toronto Blue Jays,6,2,July 24 2017,4
Atlanta Braves,0,Arizona D'Backs,11,8,July 25 2017,3
Chicago White Sox,1,Chicago Cubs,9,2,July 25 2017,7
Los Angeles Angels,1,Cleveland Indians,18,7,July 25 2017,11
Kansas City Royals,0,Detroit Tigers,4,3,July 25 2017,1
Minnesota Twins,1,Los Angeles Dodgers,8,2,July 25 2017,6
Cincinnati Reds,1,New York Yankees,6,2,July 25 2017,4
Houston Astros,0,Philadelphia Phillies,5,5,July 25 2017,0
New York Mets,0,San Diego Padres,11,6,July 25 2017,5
Boston Red Sox,1,Seattle Mariners,11,5,July 25 2017,6
Pittsburgh Pirates,1,San Francisco Giants,14,3,July 25 2017,11
Colorado Rockies,1,St. Louis Cardinals,5,2,July 25 2017,3
Baltimore Orioles,1,Tampa Bay Rays,9,4,July 25 2017,5
Miami Marlins,1,Texas Rangers,14,4,July 25 2017,10
Oakland Athletics,1,Toronto Blue Jays,5,1,July 25 2017,4
Milwaukee Brewers,0,Washington Nationals,8,8,July 25 2017,0
Atlanta Braves,1,Arizona D'Backs,13,3,July 26 2017,10
Chicago Cubs,0,Chicago White Sox,11,8,July 26 2017,3
Los Angeles Angels,1,Cleveland Indians,14,4,July 26 2017,10
Kansas City Royals,0,Detroit Tigers,18,16,July 26 2017,2
Minnesota Twins,1,Los Angeles Dodgers,11,5,July 26 2017,6
Cincinnati Reds,1,New York Yankees,14,5,July 26 2017,9
Houston Astros,1,Philadelphia Phillies,9,0,July 26 2017,9
New York Mets,1,San Diego Padres,9,3,July 26 2017,6
Boston Red Sox,0,Seattle Mariners,4,4,July 26 2017,0
Pittsburgh Pirates,1,San Francisco Giants,3,1,July 26 2017,2
Colorado Rockies,1,St. Louis Cardinals,15,5,July 26 2017,10
Baltimore Orioles,1,Tampa Bay Rays,6,1,July 26 2017,5
Miami Marlins,0,Texas Rangers,32,22,July 26 2017,10
Oakland Athletics,1,Toronto Blue Jays,5,2,July 26 2017,3
Milwaukee Brewers,1,Washington Nationals,13,5,July 26 2017,8
Chicago Cubs,0,Chicago White Sox,9,6,July 27 2017,3
Los Angeles Angels,1,Cleveland Indians,3,1,July 27 2017,2
Cincinnati Reds,1,Miami Marlins,5,1,July 27 2017,4
Tampa Bay Rays,1,New York Yankees,11,5,July 27 2017,6
New York Mets,1,San Diego Padres,12,5,July 27 2017,7
Arizona D'Backs,0,St. Louis Cardinals,4,4,July 27 2017,0
Oakland Athletics,1,Toronto Blue Jays,12,4,July 27 2017,8
Milwaukee Brewers,1,Washington Nationals,17,2,July 27 2017,15
Kansas City Royals,0,Boston Red Sox,6,4,July 28 2017,2
Cleveland Indians,0,Chicago White Sox,12,9,July 28 2017,3
Houston Astros,0,Detroit Tigers,11,6,July 28 2017,5
San Francisco Giants,1,Los Angeles Dodgers,10,4,July 28 2017,6
Cincinnati Reds,1,Miami Marlins,11,4,July 28 2017,7
Chicago Cubs,1,Milwaukee Brewers,3,1,July 28 2017,2
Tampa Bay Rays,1,New York Yankees,7,1,July 28 2017,6
Minnesota Twins,0,Oakland Athletics,9,6,July 28 2017,3
Atlanta Braves,1,Philadelphia Phillies,13,3,July 28 2017,10
Pittsburgh Pirates,1,San Diego Padres,5,2,July 28 2017,3
New York Mets,0,Seattle Mariners,12,7,July 28 2017,5
Arizona D'Backs,1,St. Louis Cardinals,1,0,July 28 2017,1
Baltimore Orioles,1,Texas Rangers,10,2,July 28 2017,8
Los Angeles Angels,0,Toronto Blue Jays,9,7,July 28 2017,2
Kansas City Royals,1,Boston Red Sox,17,8,July 29 2017,9
Cleveland Indians,0,Chicago White Sox,9,5,July 29 2017,4
Houston Astros,1,Detroit Tigers,8,3,July 29 2017,5
San Francisco Giants,1,Los Angeles Dodgers,3,1,July 29 2017,2
Cincinnati Reds,1,Miami Marlins,10,3,July 29 2017,7
Chicago Cubs,0,Milwaukee Brewers,3,2,July 29 2017,1
Tampa Bay Rays,1,New York Yankees,9,4,July 29 2017,5
Minnesota Twins,1,Oakland Athletics,9,4,July 29 2017,5
Atlanta Braves,1,Philadelphia Phillies,7,3,July 29 2017,4
Pittsburgh Pirates,1,San Diego Padres,6,2,July 29 2017,4
New York Mets,1,Seattle Mariners,5,2,July 29 2017,3
Arizona D'Backs,0,St. Louis Cardinals,8,7,July 29 2017,1
Baltimore Orioles,0,Texas Rangers,4,4,July 29 2017,0
Los Angeles Angels,0,Toronto Blue Jays,11,6,July 29 2017,5
Colorado Rockies,0,Washington Nationals,6,4,July 29 2017,2
Kansas City Royals,0,Boston Red Sox,8,5,July 30 2017,3
Cleveland Indians,1,Chicago White Sox,4,1,July 30 2017,3
Houston Astros,1,Detroit Tigers,14,1,July 30 2017,13
San Francisco Giants,1,Los Angeles Dodgers,5,2,July 30 2017,3
Cincinnati Reds,0,Miami Marlins,10,6,July 30 2017,4
Chicago Cubs,0,Milwaukee Brewers,6,4,July 30 2017,2
Tampa Bay Rays,0,New York Yankees,8,5,July 30 2017,3
Minnesota Twins,1,Oakland Athletics,11,5,July 30 2017,6
Atlanta Braves,1,Philadelphia Phillies,3,1,July 30 2017,2
Pittsburgh Pirates,0,San Diego Padres,8,7,July 30 2017,1
New York Mets,1,Seattle Mariners,10,1,July 30 2017,9
Arizona D'Backs,1,St. Louis Cardinals,5,2,July 30 2017,3
Baltimore Orioles,0,Texas Rangers,16,10,July 30 2017,6
Los Angeles Angels,1,Toronto Blue Jays,21,10,July 30 2017,11
Colorado Rockies,0,Washington Nationals,16,10,July 30 2017,6
Colorado Rockies,1,Washington Nationals,4,1,July 30 2017,3
Kansas City Royals,1,Baltimore Orioles,3,1,July 31 2017,2
Cleveland Indians,1,Boston Red Sox,8,2,July 31 2017,6
Toronto Blue Jays,1,Chicago White Sox,13,6,July 31 2017,7
Tampa Bay Rays,1,Houston Astros,21,7,July 31 2017,14
Washington Nationals,0,Miami Marlins,1,1,July 31 2017,0
Detroit Tigers,1,New York Yankees,10,3,July 31 2017,7
San Francisco Giants,1,Oakland Athletics,13,5,July 31 2017,8
Atlanta Braves,1,Philadelphia Phillies,13,6,July 31 2017,7
Seattle Mariners,0,Texas Rangers,10,6,July 31 2017,4
Philadelphia Phillies,1,Los Angeles Angels,8,1,August 1 2017,7
Los Angeles Dodgers,0,Atlanta Braves,5,3,August 1 2017,2
Kansas City Royals,1,Baltimore Orioles,9,2,August 1 2017,7
Cleveland Indians,1,Boston Red Sox,22,10,August 1 2017,12
Toronto Blue Jays,0,Chicago White Sox,12,8,August 1 2017,4
Arizona D'Backs,1,Chicago Cubs,20,4,August 1 2017,16
New York Mets,1,Colorado Rockies,9,4,August 1 2017,5
Tampa Bay Rays,0,Houston Astros,10,6,August 1 2017,4
Washington Nationals,1,Miami Marlins,13,6,August 1 2017,7
St. Louis Cardinals,1,Milwaukee Brewers,5,2,August 1 2017,3
Detroit Tigers,0,New York Yankees,7,4,August 1 2017,3
San Francisco Giants,0,Oakland Athletics,14,10,August 1 2017,4
Cincinnati Reds,0,Pittsburgh Pirates,10,9,August 1 2017,1
Minnesota Twins,1,San Diego Padres,3,0,August 1 2017,3
Seattle Mariners,0,Texas Rangers,15,8,August 1 2017,7
Philadelphia Phillies,1,Los Angeles Angels,7,0,August 2 2017,7
Los Angeles Dodgers,1,Atlanta Braves,8,3,August 2 2017,5
Kansas City Royals,1,Baltimore Orioles,6,0,August 2 2017,6
Toronto Blue Jays,0,Chicago White Sox,6,5,August 2 2017,1
Arizona D'Backs,0,Chicago Cubs,3,3,August 2 2017,0
New York Mets,0,Colorado Rockies,15,10,August 2 2017,5
Tampa Bay Rays,0,Houston Astros,3,3,August 2 2017,0
Washington Nationals,1,Miami Marlins,7,0,August 2 2017,7
St. Louis Cardinals,0,Milwaukee Brewers,9,5,August 2 2017,4
Detroit Tigers,0,New York Yankees,2,2,August 2 2017,0
Cincinnati Reds,0,Pittsburgh Pirates,7,5,August 2 2017,2
Minnesota Twins,0,San Diego Padres,7,5,August 2 2017,2
Oakland Athletics,0,San Francisco Giants,7,6,August 2 2017,1
Seattle Mariners,1,Texas Rangers,6,1,August 2 2017,5
Philadelphia Phillies,1,Los Angeles Angels,9,4,August 3 2017,5
Los Angeles Dodgers,0,Atlanta Braves,11,7,August 3 2017,4
Detroit Tigers,0,Baltimore Orioles,12,7,August 3 2017,5
Chicago White Sox,1,Boston Red Sox,14,5,August 3 2017,9
Arizona D'Backs,0,Chicago Cubs,18,10,August 3 2017,8
New York Yankees,1,Cleveland Indians,6,1,August 3 2017,5
New York Mets,1,Colorado Rockies,9,4,August 3 2017,5
Tampa Bay Rays,0,Houston Astros,8,5,August 3 2017,3
Seattle Mariners,1,Kansas City Royals,10,4,August 3 2017,6
St. Louis Cardinals,1,Milwaukee Brewers,3,1,August 3 2017,2
Texas Rangers,0,Minnesota Twins,5,4,August 3 2017,1
Cincinnati Reds,1,Pittsburgh Pirates,6,0,August 3 2017,6
Oakland Athletics,1,San Francisco Giants,13,2,August 3 2017,11
Oakland Athletics,1,Los Angeles Angels,14,6,August 4 2017,8
Miami Marlins,1,Atlanta Braves,8,3,August 4 2017,5
Detroit Tigers,0,Baltimore Orioles,7,5,August 4 2017,2
Chicago White Sox,1,Boston Red Sox,5,2,August 4 2017,3
Washington Nationals,0,Chicago Cubs,6,4,August 4 2017,2
St. Louis Cardinals,1,Cincinnati Reds,5,2,August 4 2017,3
New York Yankees,1,Cleveland Indians,9,2,August 4 2017,7
Philadelphia Phillies,1,Colorado Rockies,7,3,August 4 2017,4
Toronto Blue Jays,1,Houston Astros,23,7,August 4 2017,16
Seattle Mariners,0,Kansas City Royals,7,5,August 4 2017,2
Texas Rangers,1,Minnesota Twins,12,4,August 4 2017,8
Los Angeles Dodgers,0,New York Mets,6,6,August 4 2017,0
San Diego Padres,1,Pittsburgh Pirates,16,6,August 4 2017,10
Arizona D'Backs,0,San Francisco Giants,3,2,August 4 2017,1
Milwaukee Brewers,0,Tampa Bay Rays,2,2,August 4 2017,0
Oakland Athletics,0,Los Angeles Angels,5,5,August 5 2017,0
Miami Marlins,1,Atlanta Braves,9,2,August 5 2017,7
Detroit Tigers,1,Baltimore Orioles,7,2,August 5 2017,5
Chicago White Sox,1,Boston Red Sox,5,1,August 5 2017,4
Washington Nationals,1,Chicago Cubs,11,4,August 5 2017,7
St. Louis Cardinals,0,Cincinnati Reds,5,4,August 5 2017,1
New York Yankees,0,Cleveland Indians,3,2,August 5 2017,1
Philadelphia Phillies,1,Colorado Rockies,13,5,August 5 2017,8
Toronto Blue Jays,0,Houston Astros,7,4,August 5 2017,3
Texas Rangers,0,Minnesota Twins,5,4,August 5 2017,1
Los Angeles Dodgers,0,New York Mets,11,7,August 5 2017,4
San Diego Padres,0,Pittsburgh Pirates,7,5,August 5 2017,2
Arizona D'Backs,1,San Francisco Giants,9,4,August 5 2017,5
Milwaukee Brewers,0,Tampa Bay Rays,3,3,August 5 2017,0
Oakland Athletics,0,Los Angeles Angels,21,11,August 6 2017,10
Miami Marlins,0,Atlanta Braves,5,4,August 6 2017,1
Detroit Tigers,1,Baltimore Orioles,15,3,August 6 2017,12
Chicago White Sox,1,Boston Red Sox,9,3,August 6 2017,6
Washington Nationals,0,Chicago Cubs,13,9,August 6 2017,4
St. Louis Cardinals,0,Cincinnati Reds,17,13,August 6 2017,4
New York Yankees,0,Cleveland Indians,9,8,August 6 2017,1
Philadelphia Phillies,0,Colorado Rockies,5,3,August 6 2017,2
Toronto Blue Jays,1,Houston Astros,13,6,August 6 2017,7
Seattle Mariners,0,Kansas City Royals,15,8,August 6 2017,7
Seattle Mariners,1,Kansas City Royals,10,1,August 6 2017,9
Texas Rangers,1,Minnesota Twins,11,5,August 6 2017,6
Los Angeles Dodgers,0,New York Mets,8,8,August 6 2017,0
San Diego Padres,1,Pittsburgh Pirates,9,4,August 6 2017,5
Arizona D'Backs,1,San Francisco Giants,9,3,August 6 2017,6
Milwaukee Brewers,1,Tampa Bay Rays,3,1,August 6 2017,2
Baltimore Orioles,0,Los Angeles Angels,8,6,August 7 2017,2
San Diego Padres,1,Cincinnati Reds,14,3,August 7 2017,11
St. Louis Cardinals,0,Kansas City Royals,14,11,August 7 2017,3
Milwaukee Brewers,1,Minnesota Twins,9,4,August 7 2017,5
Detroit Tigers,1,Pittsburgh Pirates,3,0,August 7 2017,3
Chicago Cubs,0,San Francisco Giants,8,5,August 7 2017,3
Miami Marlins,1,Washington Nationals,5,2,August 7 2017,3
Baltimore Orioles,1,Los Angeles Angels,5,2,August 8 2017,3
Los Angeles Dodgers,1,Arizona D'Backs,9,3,August 8 2017,6
Philadelphia Phillies,0,Atlanta Braves,7,5,August 8 2017,2
Houston Astros,1,Chicago White Sox,13,5,August 8 2017,8
San Diego Padres,0,Cincinnati Reds,10,7,August 8 2017,3
Colorado Rockies,1,Cleveland Indians,5,1,August 8 2017,4
St. Louis Cardinals,0,Kansas City Royals,13,10,August 8 2017,3
Milwaukee Brewers,1,Minnesota Twins,15,4,August 8 2017,11
Texas Rangers,1,New York Mets,9,4,August 8 2017,5
Seattle Mariners,0,Oakland Athletics,13,7,August 8 2017,6
Detroit Tigers,1,Pittsburgh Pirates,9,3,August 8 2017,6
Chicago Cubs,1,San Francisco Giants,9,3,August 8 2017,6
Boston Red Sox,0,Tampa Bay Rays,2,2,August 8 2017,0
New York Yankees,1,Toronto Blue Jays,6,2,August 8 2017,4
Miami Marlins,0,Washington Nationals,10,7,August 8 2017,3
Baltimore Orioles,1,Los Angeles Angels,6,1,August 9 2017,5
Los Angeles Dodgers,0,Arizona D'Backs,5,3,August 9 2017,2
Philadelphia Phillies,0,Atlanta Braves,5,3,August 9 2017,2
Houston Astros,1,Chicago White Sox,8,1,August 9 2017,7
San Diego Padres,1,Cincinnati Reds,11,3,August 9 2017,8
Colorado Rockies,0,Cleveland Indians,5,3,August 9 2017,2
Pittsburgh Pirates,1,Detroit Tigers,10,0,August 9 2017,10
Minnesota Twins,0,Milwaukee Brewers,4,4,August 9 2017,0
Texas Rangers,0,New York Mets,6,5,August 9 2017,1
Seattle Mariners,0,Oakland Athletics,9,6,August 9 2017,3
Chicago Cubs,1,San Francisco Giants,4,1,August 9 2017,3
Kansas City Royals,1,St. Louis Cardinals,13,5,August 9 2017,8
Boston Red Sox,0,Tampa Bay Rays,10,8,August 9 2017,2
New York Yankees,0,Toronto Blue Jays,16,11,August 9 2017,5
Miami Marlins,1,Washington Nationals,11,1,August 9 2017,10
Los Angeles Dodgers,0,Arizona D'Backs,14,8,August 10 2017,6
Houston Astros,1,Chicago White Sox,5,2,August 10 2017,3
San Diego Padres,1,Cincinnati Reds,13,3,August 10 2017,10
Pittsburgh Pirates,0,Detroit Tigers,12,7,August 10 2017,5
Minnesota Twins,0,Milwaukee Brewers,9,7,August 10 2017,2
Baltimore Orioles,0,Oakland Athletics,9,7,August 10 2017,2
New York Mets,0,Philadelphia Phillies,10,10,August 10 2017,0
Los Angeles Angels,0,Seattle Mariners,9,6,August 10 2017,3
Kansas City Royals,1,St. Louis Cardinals,14,6,August 10 2017,8
Cleveland Indians,1,Tampa Bay Rays,5,1,August 10 2017,4
New York Yankees,1,Toronto Blue Jays,4,0,August 10 2017,4
Miami Marlins,1,Washington Nationals,5,2,August 10 2017,3
Chicago Cubs,0,Arizona D'Backs,11,8,August 11 2017,3
Kansas City Royals,1,Chicago White Sox,9,3,August 11 2017,6
Minnesota Twins,0,Detroit Tigers,13,9,August 11 2017,4
San Diego Padres,0,Los Angeles Dodgers,7,4,August 11 2017,3
Colorado Rockies,1,Miami Marlins,9,3,August 11 2017,6
Cincinnati Reds,0,Milwaukee Brewers,21,11,August 11 2017,10
Boston Red Sox,1,New York Yankees,9,4,August 11 2017,5
Baltimore Orioles,1,Oakland Athletics,9,4,August 11 2017,5
New York Mets,0,Philadelphia Phillies,13,7,August 11 2017,6
Los Angeles Angels,0,Seattle Mariners,11,6,August 11 2017,5
Atlanta Braves,1,St. Louis Cardinals,13,5,August 11 2017,8
Cleveland Indians,0,Tampa Bay Rays,5,5,August 11 2017,0
Houston Astros,1,Texas Rangers,10,4,August 11 2017,6
Pittsburgh Pirates,0,Toronto Blue Jays,6,4,August 11 2017,2
Chicago Cubs,1,Arizona D'Backs,8,2,August 12 2017,6
Kansas City Royals,0,Chicago White Sox,9,5,August 12 2017,4
Minnesota Twins,1,Detroit Tigers,23,11,August 12 2017,12
San Diego Padres,1,Los Angeles Dodgers,9,3,August 12 2017,6
Colorado Rockies,1,Miami Marlins,7,3,August 12 2017,4
Cincinnati Reds,1,Milwaukee Brewers,11,5,August 12 2017,6
Boston Red Sox,0,New York Yankees,15,10,August 12 2017,5
Baltimore Orioles,0,Oakland Athletics,17,12,August 12 2017,5
New York Mets,1,Philadelphia Phillies,4,1,August 12 2017,3
Los Angeles Angels,0,Seattle Mariners,9,6,August 12 2017,3
Atlanta Braves,1,St. Louis Cardinals,11,5,August 12 2017,6
Cleveland Indians,0,Tampa Bay Rays,3,3,August 12 2017,0
Houston Astros,1,Texas Rangers,11,3,August 12 2017,8
Pittsburgh Pirates,1,Toronto Blue Jays,9,2,August 12 2017,7
San Francisco Giants,1,Washington Nationals,4,1,August 12 2017,3
Chicago Cubs,0,Arizona D'Backs,9,7,August 13 2017,2
Kansas City Royals,0,Chicago White Sox,20,14,August 13 2017,6
Minnesota Twins,0,Detroit Tigers,10,6,August 13 2017,4
San Diego Padres,1,Los Angeles Dodgers,10,4,August 13 2017,6
Colorado Rockies,1,Miami Marlins,8,3,August 13 2017,5
Cincinnati Reds,1,Milwaukee Brewers,11,4,August 13 2017,7
Boston Red Sox,0,New York Yankees,5,3,August 13 2017,2
Baltimore Orioles,1,Oakland Athletics,12,3,August 13 2017,9
New York Mets,0,Philadelphia Phillies,8,6,August 13 2017,2
Los Angeles Angels,0,Seattle Mariners,6,4,August 13 2017,2
Atlanta Braves,0,St. Louis Cardinals,9,6,August 13 2017,3
Cleveland Indians,0,Tampa Bay Rays,7,4,August 13 2017,3
Houston Astros,0,Texas Rangers,3,2,August 13 2017,1
Pittsburgh Pirates,1,Toronto Blue Jays,8,1,August 13 2017,7
San Francisco Giants,0,Washington Nationals,6,4,August 13 2017,2
San Francisco Giants,1,Washington Nationals,8,2,August 13 2017,6
Houston Astros,1,Arizona D'Backs,2,0,August 14 2017,2
Cleveland Indians,0,Boston Red Sox,10,7,August 14 2017,3
Cincinnati Reds,1,Chicago Cubs,20,5,August 14 2017,15
Atlanta Braves,1,Colorado Rockies,3,0,August 14 2017,3
San Francisco Giants,1,Miami Marlins,11,3,August 14 2017,8
New York Mets,1,New York Yankees,6,2,August 14 2017,4
Kansas City Royals,0,Oakland Athletics,8,6,August 14 2017,2
Philadelphia Phillies,1,San Diego Padres,11,4,August 14 2017,7
Baltimore Orioles,0,Seattle Mariners,14,11,August 14 2017,3
Detroit Tigers,1,Texas Rangers,8,2,August 14 2017,6
Tampa Bay Rays,1,Toronto Blue Jays,3,1,August 14 2017,2
Houston Astros,0,Arizona D'Backs,13,9,August 15 2017,4
St. Louis Cardinals,1,Boston Red Sox,14,4,August 15 2017,10
Cincinnati Reds,0,Chicago Cubs,3,2,August 15 2017,1
Atlanta Braves,0,Colorado Rockies,7,4,August 15 2017,3
Chicago White Sox,1,Los Angeles Dodgers,7,1,August 15 2017,6
San Francisco Giants,0,Miami Marlins,13,9,August 15 2017,4
Pittsburgh Pirates,1,Milwaukee Brewers,4,1,August 15 2017,3
Cleveland Indians,0,Minnesota Twins,9,8,August 15 2017,1
New York Mets,1,New York Yankees,9,4,August 15 2017,5
Kansas City Royals,1,Oakland Athletics,18,8,August 15 2017,10
Philadelphia Phillies,1,San Diego Padres,12,4,August 15 2017,8
Baltimore Orioles,1,Seattle Mariners,4,1,August 15 2017,3
Detroit Tigers,1,Texas Rangers,14,4,August 15 2017,10
Tampa Bay Rays,0,Toronto Blue Jays,10,6,August 15 2017,4
Los Angeles Angels,1,Washington Nationals,4,1,August 15 2017,3
St. Louis Cardinals,1,Boston Red Sox,9,4,August 16 2017,5
Cincinnati Reds,1,Chicago Cubs,13,6,August 16 2017,7
Atlanta Braves,1,Colorado Rockies,19,2,August 16 2017,17
Arizona D'Backs,1,Houston Astros,14,5,August 16 2017,9
Chicago White Sox,1,Los Angeles Dodgers,9,4,August 16 2017,5
San Francisco Giants,1,Miami Marlins,9,1,August 16 2017,8
Pittsburgh Pirates,1,Milwaukee Brewers,13,6,August 16 2017,7
New York Yankees,0,New York Mets,8,5,August 16 2017,3
Kansas City Royals,0,Oakland Athletics,13,7,August 16 2017,6
Philadelphia Phillies,1,San Diego Padres,3,0,August 16 2017,3
Baltimore Orioles,1,Seattle Mariners,13,6,August 16 2017,7
Detroit Tigers,1,Texas Rangers,18,6,August 16 2017,12
Tampa Bay Rays,1,Toronto Blue Jays,5,2,August 16 2017,3
Los Angeles Angels,0,Washington Nationals,5,3,August 16 2017,2
Cincinnati Reds,0,Chicago Cubs,23,13,August 17 2017,10
Atlanta Braves,0,Colorado Rockies,14,10,August 17 2017,4
Arizona D'Backs,0,Houston Astros,4,4,August 17 2017,0
Cleveland Indians,0,Minnesota Twins,12,9,August 17 2017,3
Cleveland Indians,1,Minnesota Twins,6,2,August 17 2017,4
New York Yankees,0,New York Mets,12,7,August 17 2017,5
St. Louis Cardinals,0,Pittsburgh Pirates,18,11,August 17 2017,7
Washington Nationals,0,San Diego Padres,3,2,August 17 2017,1
Philadelphia Phillies,1,San Francisco Giants,9,4,August 17 2017,5
Chicago White Sox,1,Texas Rangers,17,8,August 17 2017,9
Tampa Bay Rays,1,Toronto Blue Jays,8,3,August 17 2017,5
Cincinnati Reds,0,Atlanta Braves,8,5,August 18 2017,3
Los Angeles Angels,1,Baltimore Orioles,16,7,August 18 2017,9
New York Yankees,1,Boston Red Sox,15,6,August 18 2017,9
Toronto Blue Jays,1,Chicago Cubs,11,4,August 18 2017,7
Milwaukee Brewers,1,Colorado Rockies,12,4,August 18 2017,8
Los Angeles Dodgers,0,Detroit Tigers,13,8,August 18 2017,5
Oakland Athletics,1,Houston Astros,4,1,August 18 2017,3
Cleveland Indians,0,Kansas City Royals,11,10,August 18 2017,1
Arizona D'Backs,1,Minnesota Twins,13,3,August 18 2017,10
Miami Marlins,0,New York Mets,4,3,August 18 2017,1
St. Louis Cardinals,0,Pittsburgh Pirates,21,11,August 18 2017,10
Washington Nationals,0,San Diego Padres,8,7,August 18 2017,1
Philadelphia Phillies,1,San Francisco Giants,12,2,August 18 2017,10
Seattle Mariners,0,Tampa Bay Rays,8,7,August 18 2017,1
Chicago White Sox,0,Texas Rangers,7,4,August 18 2017,3
Cincinnati Reds,0,Atlanta Braves,19,11,August 19 2017,8
Los Angeles Angels,0,Baltimore Orioles,6,5,August 19 2017,1
New York Yankees,0,Boston Red Sox,7,4,August 19 2017,3
Toronto Blue Jays,1,Chicago Cubs,7,3,August 19 2017,4
Milwaukee Brewers,0,Colorado Rockies,9,6,August 19 2017,3
Los Angeles Dodgers,0,Detroit Tigers,3,3,August 19 2017,0
Oakland Athletics,1,Houston Astros,3,0,August 19 2017,3
Cleveland Indians,0,Kansas City Royals,5,5,August 19 2017,0
Arizona D'Backs,1,Minnesota Twins,5,0,August 19 2017,5
Miami Marlins,1,New York Mets,9,1,August 19 2017,8
St. Louis Cardinals,1,Pittsburgh Pirates,10,4,August 19 2017,6
Washington Nationals,1,San Diego Padres,4,1,August 19 2017,3
Philadelphia Phillies,0,San Francisco Giants,21,12,August 19 2017,9
Seattle Mariners,0,Tampa Bay Rays,13,7,August 19 2017,6
Chicago White Sox,1,Texas Rangers,24,7,August 19 2017,17
Cincinnati Reds,1,Atlanta Braves,9,1,August 20 2017,8
Los Angeles Angels,0,Baltimore Orioles,9,5,August 20 2017,4
New York Yankees,1,Boston Red Sox,6,1,August 20 2017,5
Toronto Blue Jays,1,Chicago Cubs,11,5,August 20 2017,6
Milwaukee Brewers,0,Colorado Rockies,12,8,August 20 2017,4
Los Angeles Dodgers,1,Detroit Tigers,7,1,August 20 2017,6
Oakland Athletics,0,Houston Astros,5,3,August 20 2017,2
Cleveland Indians,1,Kansas City Royals,11,4,August 20 2017,7
Arizona D'Backs,1,Minnesota Twins,17,5,August 20 2017,12
Miami Marlins,0,New York Mets,10,6,August 20 2017,4
St. Louis Cardinals,1,Pittsburgh Pirates,9,3,August 20 2017,6
Washington Nationals,0,San Diego Padres,5,4,August 20 2017,1
Philadelphia Phillies,0,San Francisco Giants,7,5,August 20 2017,2
Seattle Mariners,1,Tampa Bay Rays,3,0,August 20 2017,3
Chicago White Sox,0,Texas Rangers,5,3,August 20 2017,2
Texas Rangers,0,Los Angeles Angels,8,5,August 21 2017,3
Seattle Mariners,0,Atlanta Braves,11,6,August 21 2017,5
Oakland Athletics,1,Baltimore Orioles,10,3,August 21 2017,7
Minnesota Twins,1,Chicago White Sox,13,6,August 21 2017,7
Minnesota Twins,0,Chicago White Sox,12,10,August 21 2017,2
Boston Red Sox,1,Cleveland Indians,9,4,August 21 2017,5
Arizona D'Backs,0,New York Mets,5,3,August 21 2017,2
Los Angeles Dodgers,0,Pittsburgh Pirates,11,6,August 21 2017,5
Milwaukee Brewers,1,San Francisco Giants,2,0,August 21 2017,2
Texas Rangers,1,Los Angeles Angels,11,1,August 22 2017,10
Seattle Mariners,1,Atlanta Braves,4,0,August 22 2017,4
Oakland Athletics,0,Baltimore Orioles,10,6,August 22 2017,4
Minnesota Twins,0,Chicago White Sox,5,4,August 22 2017,1
Chicago Cubs,0,Cincinnati Reds,22,13,August 22 2017,9
Boston Red Sox,0,Cleveland Indians,10,9,August 22 2017,1
New York Yankees,0,Detroit Tigers,17,13,August 22 2017,4
Washington Nationals,0,Houston Astros,7,4,August 22 2017,3
Colorado Rockies,1,Kansas City Royals,5,2,August 22 2017,3
Arizona D'Backs,0,New York Mets,11,7,August 22 2017,4
Miami Marlins,0,Philadelphia Phillies,20,12,August 22 2017,8
Miami Marlins,0,Philadelphia Phillies,11,7,August 22 2017,4
Los Angeles Dodgers,0,Pittsburgh Pirates,13,8,August 22 2017,5
Milwaukee Brewers,0,San Francisco Giants,7,4,August 22 2017,3
San Diego Padres,0,St. Louis Cardinals,16,12,August 22 2017,4
Toronto Blue Jays,1,Tampa Bay Rays,11,5,August 22 2017,6
Texas Rangers,0,Los Angeles Angels,12,7,August 23 2017,5
Seattle Mariners,0,Atlanta Braves,15,9,August 23 2017,6
Oakland Athletics,1,Baltimore Orioles,15,7,August 23 2017,8
Minnesota Twins,1,Chicago White Sox,7,3,August 23 2017,4
Chicago Cubs,0,Cincinnati Reds,12,9,August 23 2017,3
Boston Red Sox,0,Cleveland Indians,7,6,August 23 2017,1
New York Yankees,0,Detroit Tigers,12,10,August 23 2017,2
Washington Nationals,1,Houston Astros,7,1,August 23 2017,6
Colorado Rockies,1,Kansas City Royals,10,4,August 23 2017,6
Arizona D'Backs,1,New York Mets,6,2,August 23 2017,4
Miami Marlins,1,Philadelphia Phillies,8,0,August 23 2017,8
Los Angeles Dodgers,1,Pittsburgh Pirates,1,0,August 23 2017,1
Milwaukee Brewers,1,San Francisco Giants,6,2,August 23 2017,4
San Diego Padres,1,St. Louis Cardinals,8,2,August 23 2017,6
Toronto Blue Jays,0,Tampa Bay Rays,13,7,August 23 2017,6
Texas Rangers,0,Los Angeles Angels,3,3,August 24 2017,0
Minnesota Twins,1,Chicago White Sox,6,1,August 24 2017,5
Chicago Cubs,1,Cincinnati Reds,6,2,August 24 2017,4
Boston Red Sox,1,Cleveland Indians,19,6,August 24 2017,13
New York Yankees,1,Detroit Tigers,16,6,August 24 2017,10
Washington Nationals,0,Houston Astros,9,5,August 24 2017,4
Colorado Rockies,0,Kansas City Royals,5,3,August 24 2017,2
Arizona D'Backs,0,New York Mets,5,3,August 24 2017,2
Miami Marlins,0,Philadelphia Phillies,17,9,August 24 2017,8
Los Angeles Dodgers,0,Pittsburgh Pirates,7,5,August 24 2017,2
San Diego Padres,0,St. Louis Cardinals,7,4,August 24 2017,3
Toronto Blue Jays,1,Tampa Bay Rays,2,0,August 24 2017,2
Houston Astros,0,Los Angeles Angels,3,2,August 25 2017,1
San Francisco Giants,1,Arizona D'Backs,7,3,August 25 2017,4
Colorado Rockies,1,Atlanta Braves,7,2,August 25 2017,5
Baltimore Orioles,0,Boston Red Sox,19,16,August 25 2017,3
Detroit Tigers,1,Chicago White Sox,5,2,August 25 2017,3
Pittsburgh Pirates,1,Cincinnati Reds,14,5,August 25 2017,9
Kansas City Royals,1,Cleveland Indians,4,0,August 25 2017,4
Milwaukee Brewers,1,Los Angeles Dodgers,4,1,August 25 2017,3
San Diego Padres,1,Miami Marlins,14,6,August 25 2017,8
Seattle Mariners,0,New York Yankees,3,2,August 25 2017,1
Texas Rangers,1,Oakland Athletics,4,1,August 25 2017,3
Chicago Cubs,1,Philadelphia Phillies,8,1,August 25 2017,7
Tampa Bay Rays,0,St. Louis Cardinals,10,7,August 25 2017,3
Minnesota Twins,0,Toronto Blue Jays,7,6,August 25 2017,1
New York Mets,0,Washington Nationals,6,4,August 25 2017,2
Houston Astros,1,Los Angeles Angels,13,6,August 26 2017,7
San Francisco Giants,1,Arizona D'Backs,3,1,August 26 2017,2
Colorado Rockies,0,Atlanta Braves,13,7,August 26 2017,6
Baltimore Orioles,0,Boston Red Sox,7,7,August 26 2017,0
Detroit Tigers,0,Chicago White Sox,9,6,August 26 2017,3
Pittsburgh Pirates,0,Cincinnati Reds,1,1,August 26 2017,0
Kansas City Royals,1,Cleveland Indians,4,0,August 26 2017,4
Milwaukee Brewers,0,Los Angeles Dodgers,3,3,August 26 2017,0
San Diego Padres,1,Miami Marlins,3,1,August 26 2017,2
Seattle Mariners,1,New York Yankees,9,3,August 26 2017,6
Texas Rangers,1,Oakland Athletics,11,3,August 26 2017,8
Chicago Cubs,0,Philadelphia Phillies,19,17,August 26 2017,2
Tampa Bay Rays,1,St. Louis Cardinals,10,4,August 26 2017,6
Minnesota Twins,1,Toronto Blue Jays,19,9,August 26 2017,10
New York Mets,1,Washington Nationals,13,4,August 26 2017,9
Houston Astros,0,Los Angeles Angels,12,7,August 27 2017,5
San Francisco Giants,1,Arizona D'Backs,11,0,August 27 2017,11
Colorado Rockies,0,Atlanta Braves,3,3,August 27 2017,0
Baltimore Orioles,0,Boston Red Sox,3,2,August 27 2017,1
Detroit Tigers,1,Chicago White Sox,8,1,August 27 2017,7
Pittsburgh Pirates,0,Cincinnati Reds,7,5,August 27 2017,2
Kansas City Royals,1,Cleveland Indians,12,0,August 27 2017,12
Milwaukee Brewers,0,Los Angeles Dodgers,5,3,August 27 2017,2
San Diego Padres,1,Miami Marlins,8,2,August 27 2017,6
Seattle Mariners,1,New York Yankees,11,1,August 27 2017,10
Texas Rangers,1,Oakland Athletics,11,3,August 27 2017,8
Chicago Cubs,1,Philadelphia Phillies,9,3,August 27 2017,6
Tampa Bay Rays,0,St. Louis Cardinals,5,3,August 27 2017,2
Minnesota Twins,0,Toronto Blue Jays,9,7,August 27 2017,2
New York Mets,0,Washington Nationals,11,6,August 27 2017,5
New York Mets,1,Washington Nationals,9,4,August 27 2017,5
Oakland Athletics,1,Los Angeles Angels,4,1,August 28 2017,3
Seattle Mariners,1,Baltimore Orioles,13,6,August 28 2017,7
Pittsburgh Pirates,1,Chicago Cubs,7,1,August 28 2017,6
Detroit Tigers,0,Colorado Rockies,7,4,August 28 2017,3
Tampa Bay Rays,0,Kansas City Royals,12,12,August 28 2017,0
Cleveland Indians,0,New York Yankees,8,6,August 28 2017,2
Atlanta Braves,1,Philadelphia Phillies,7,1,August 28 2017,6
San Francisco Giants,0,San Diego Padres,3,3,August 28 2017,0
Boston Red Sox,0,Toronto Blue Jays,11,6,August 28 2017,5
Miami Marlins,1,Washington Nationals,13,2,August 28 2017,11
Oakland Athletics,1,Los Angeles Angels,10,2,August 29 2017,8
Los Angeles Dodgers,1,Arizona D'Backs,13,6,August 29 2017,7
Seattle Mariners,1,Baltimore Orioles,4,0,August 29 2017,4
Pittsburgh Pirates,1,Chicago Cubs,5,1,August 29 2017,4
New York Mets,1,Cincinnati Reds,18,4,August 29 2017,14
Detroit Tigers,1,Colorado Rockies,10,3,August 29 2017,7
Texas Rangers,0,Houston Astros,14,12,August 29 2017,2
Tampa Bay Rays,1,Kansas City Royals,8,2,August 29 2017,6
St. Louis Cardinals,0,Milwaukee Brewers,12,10,August 29 2017,2
Chicago White Sox,1,Minnesota Twins,10,4,August 29 2017,6
San Francisco Giants,1,San Diego Padres,9,3,August 29 2017,6
Boston Red Sox,0,Toronto Blue Jays,3,3,August 29 2017,0
Miami Marlins,1,Washington Nationals,11,3,August 29 2017,8
Oakland Athletics,1,Los Angeles Angels,18,8,August 30 2017,10
Los Angeles Dodgers,1,Arizona D'Backs,10,4,August 30 2017,6
Seattle Mariners,1,Baltimore Orioles,15,7,August 30 2017,8
Pittsburgh Pirates,1,Chicago Cubs,20,3,August 30 2017,17
New York Mets,0,Cincinnati Reds,2,2,August 30 2017,0
Detroit Tigers,0,Colorado Rockies,8,6,August 30 2017,2
Texas Rangers,0,Houston Astros,9,8,August 30 2017,1
Tampa Bay Rays,0,Kansas City Royals,8,5,August 30 2017,3
St. Louis Cardinals,1,Milwaukee Brewers,11,5,August 30 2017,6
Chicago White Sox,1,Minnesota Twins,12,1,August 30 2017,11
Cleveland Indians,0,New York Yankees,3,2,August 30 2017,1
Cleveland Indians,0,New York Yankees,13,9,August 30 2017,4
Atlanta Braves,0,Philadelphia Phillies,10,9,August 30 2017,1
Atlanta Braves,0,Philadelphia Phillies,7,5,August 30 2017,2
San Francisco Giants,1,San Diego Padres,5,0,August 30 2017,5
Boston Red Sox,0,Toronto Blue Jays,8,7,August 30 2017,1
Miami Marlins,1,Washington Nationals,4,0,August 30 2017,4
Los Angeles Dodgers,1,Arizona D'Backs,9,1,August 31 2017,8
Toronto Blue Jays,0,Baltimore Orioles,19,11,August 31 2017,8
Atlanta Braves,1,Chicago Cubs,8,2,August 31 2017,6
New York Mets,1,Cincinnati Reds,9,2,August 31 2017,7
Texas Rangers,1,Houston Astros,6,1,August 31 2017,5
Philadelphia Phillies,0,Miami Marlins,5,3,August 31 2017,2
Washington Nationals,1,Milwaukee Brewers,9,3,August 31 2017,6
Chicago White Sox,1,Minnesota Twins,9,4,August 31 2017,5
Boston Red Sox,1,New York Yankees,8,2,August 31 2017,6
St. Louis Cardinals,0,San Francisco Giants,7,5,August 31 2017,2
Toronto Blue Jays,1,Baltimore Orioles,1,0,September 1 2017,1
Tampa Bay Rays,0,Chicago White Sox,4,3,September 1 2017,1
Atlanta Braves,1,Chicago Cubs,2,0,September 1 2017,2
Arizona D'Backs,0,Colorado Rockies,14,9,September 1 2017,5
Cleveland Indians,0,Detroit Tigers,5,3,September 1 2017,2
Cleveland Indians,0,Detroit Tigers,10,10,September 1 2017,0
Philadelphia Phillies,0,Miami Marlins,3,2,September 1 2017,1
Washington Nationals,1,Milwaukee Brewers,1,0,September 1 2017,1
Kansas City Royals,0,Minnesota Twins,13,7,September 1 2017,6
Boston Red Sox,0,New York Yankees,5,4,September 1 2017,1
Cincinnati Reds,0,Pittsburgh Pirates,10,7,September 1 2017,3
Los Angeles Dodgers,0,San Diego Padres,1,1,September 1 2017,0
Oakland Athletics,1,Seattle Mariners,5,2,September 1 2017,3
St. Louis Cardinals,0,San Francisco Giants,17,11,September 1 2017,6
Los Angeles Angels,1,Texas Rangers,19,9,September 1 2017,10
Toronto Blue Jays,0,Baltimore Orioles,9,7,September 2 2017,2
Tampa Bay Rays,1,Chicago White Sox,9,4,September 2 2017,5
Atlanta Braves,1,Chicago Cubs,26,12,September 2 2017,14
Arizona D'Backs,0,Colorado Rockies,8,6,September 2 2017,2
Cleveland Indians,0,Detroit Tigers,7,5,September 2 2017,2
New York Mets,1,Houston Astros,20,8,September 2 2017,12
New York Mets,1,Houston Astros,5,1,September 2 2017,4
Philadelphia Phillies,1,Miami Marlins,19,9,September 2 2017,10
Washington Nationals,0,Milwaukee Brewers,5,3,September 2 2017,2
Kansas City Royals,1,Minnesota Twins,17,0,September 2 2017,17
Boston Red Sox,1,New York Yankees,6,1,September 2 2017,5
Cincinnati Reds,1,Pittsburgh Pirates,5,0,September 2 2017,5
Los Angeles Dodgers,1,San Diego Padres,11,5,September 2 2017,6
Los Angeles Dodgers,1,San Diego Padres,9,2,September 2 2017,7
Oakland Athletics,1,Seattle Mariners,13,6,September 2 2017,7
St. Louis Cardinals,1,San Francisco Giants,3,1,September 2 2017,2
Los Angeles Angels,0,Texas Rangers,11,7,September 2 2017,4
Toronto Blue Jays,1,Baltimore Orioles,9,4,September 3 2017,5
Tampa Bay Rays,1,Chicago White Sox,8,2,September 3 2017,6
Atlanta Braves,0,Chicago Cubs,6,5,September 3 2017,1
Arizona D'Backs,0,Colorado Rockies,6,5,September 3 2017,1
Cleveland Indians,0,Detroit Tigers,12,11,September 3 2017,1
New York Mets,1,Houston Astros,14,6,September 3 2017,8
Philadelphia Phillies,0,Miami Marlins,4,3,September 3 2017,1
Washington Nationals,1,Milwaukee Brewers,9,2,September 3 2017,7
Kansas City Royals,0,Minnesota Twins,9,5,September 3 2017,4
Boston Red Sox,1,New York Yankees,11,2,September 3 2017,9
Cincinnati Reds,1,Pittsburgh Pirates,4,1,September 3 2017,3
Los Angeles Dodgers,1,San Diego Padres,10,4,September 3 2017,6
Oakland Athletics,1,Seattle Mariners,12,2,September 3 2017,10
St. Louis Cardinals,0,San Francisco Giants,10,7,September 3 2017,3
Los Angeles Angels,1,Texas Rangers,13,6,September 3 2017,7
Texas Rangers,0,Atlanta Braves,10,8,September 4 2017,2
New York Yankees,0,Baltimore Orioles,11,7,September 4 2017,4
Toronto Blue Jays,0,Boston Red Sox,14,10,September 4 2017,4
Cleveland Indians,0,Chicago White Sox,8,5,September 4 2017,3
Milwaukee Brewers,1,Cincinnati Reds,9,4,September 4 2017,5
San Francisco Giants,1,Colorado Rockies,7,3,September 4 2017,4
Kansas City Royals,0,Detroit Tigers,13,7,September 4 2017,6
Arizona D'Backs,0,Los Angeles Dodgers,13,13,September 4 2017,0
Washington Nationals,0,Miami Marlins,9,7,September 4 2017,2
Philadelphia Phillies,1,New York Mets,18,7,September 4 2017,11
Los Angeles Angels,0,Oakland Athletics,20,11,September 4 2017,9
Chicago Cubs,1,Pittsburgh Pirates,12,0,September 4 2017,12
St. Louis Cardinals,0,San Diego Padres,2,2,September 4 2017,0
Houston Astros,0,Seattle Mariners,8,6,September 4 2017,2
Minnesota Twins,1,Tampa Bay Rays,15,4,September 4 2017,11
New York Yankees,1,Baltimore Orioles,13,6,September 5 2017,7
Toronto Blue Jays,1,Boston Red Sox,5,2,September 5 2017,3
Cleveland Indians,0,Chicago White Sox,13,9,September 5 2017,4
Milwaukee Brewers,1,Cincinnati Reds,12,3,September 5 2017,9
San Francisco Giants,1,Colorado Rockies,15,6,September 5 2017,9
Kansas City Royals,1,Detroit Tigers,15,2,September 5 2017,13
Arizona D'Backs,0,Los Angeles Dodgers,4,3,September 5 2017,1
Washington Nationals,0,Miami Marlins,3,2,September 5 2017,1
Philadelphia Phillies,0,New York Mets,10,9,September 5 2017,1
Los Angeles Angels,0,Oakland Athletics,15,8,September 5 2017,7
Chicago Cubs,1,Pittsburgh Pirates,7,3,September 5 2017,4
St. Louis Cardinals,0,San Diego Padres,12,8,September 5 2017,4
Houston Astros,0,Seattle Mariners,4,3,September 5 2017,1
Minnesota Twins,1,Tampa Bay Rays,3,1,September 5 2017,2
Texas Rangers,0,Atlanta Braves,20,12,September 6 2017,8
Texas Rangers,1,Atlanta Braves,9,4,September 6 2017,5
Toronto Blue Jays,1,Boston Red Sox,7,1,September 6 2017,6
Cleveland Indians,0,Chicago White Sox,6,5,September 6 2017,1
Milwaukee Brewers,1,Cincinnati Reds,8,1,September 6 2017,7
San Francisco Giants,0,Colorado Rockies,14,11,September 6 2017,3
Kansas City Royals,0,Detroit Tigers,15,13,September 6 2017,2
Arizona D'Backs,0,Los Angeles Dodgers,4,3,September 6 2017,1
Washington Nationals,0,Miami Marlins,9,8,September 6 2017,1
Philadelphia Phillies,1,New York Mets,9,3,September 6 2017,6
Los Angeles Angels,1,Oakland Athletics,4,1,September 6 2017,3
Chicago Cubs,0,Pittsburgh Pirates,1,1,September 6 2017,0
St. Louis Cardinals,0,San Diego Padres,4,3,September 6 2017,1
Houston Astros,0,Seattle Mariners,8,5,September 6 2017,3
Minnesota Twins,0,Tampa Bay Rays,16,10,September 6 2017,6
Miami Marlins,1,Atlanta Braves,11,5,September 7 2017,6
New York Yankees,0,Baltimore Orioles,10,9,September 7 2017,1
Cleveland Indians,0,Chicago White Sox,13,11,September 7 2017,2
Minnesota Twins,0,Kansas City Royals,6,4,September 7 2017,2
Colorado Rockies,0,Los Angeles Dodgers,10,9,September 7 2017,1
Cincinnati Reds,1,New York Mets,9,2,September 7 2017,7
Chicago Cubs,0,Pittsburgh Pirates,10,8,September 7 2017,2
St. Louis Cardinals,1,San Diego Padres,3,0,September 7 2017,3
Philadelphia Phillies,1,Washington Nationals,7,3,September 7 2017,4
San Diego Padres,0,Arizona D'Backs,16,10,September 8 2017,6
Miami Marlins,0,Atlanta Braves,8,7,September 8 2017,1
Tampa Bay Rays,1,Boston Red Sox,12,3,September 8 2017,9
San Francisco Giants,0,Chicago White Sox,11,9,September 8 2017,2
Milwaukee Brewers,0,Chicago Cubs,2,2,September 8 2017,0
Baltimore Orioles,1,Cleveland Indians,5,0,September 8 2017,5
Minnesota Twins,0,Kansas City Royals,13,8,September 8 2017,5
Colorado Rockies,0,Los Angeles Dodgers,9,5,September 8 2017,4
Cincinnati Reds,1,New York Mets,6,1,September 8 2017,5
Houston Astros,1,Oakland Athletics,17,8,September 8 2017,9
Los Angeles Angels,1,Seattle Mariners,7,3,September 8 2017,4
Pittsburgh Pirates,1,St. Louis Cardinals,5,1,September 8 2017,4
New York Yankees,1,Texas Rangers,16,5,September 8 2017,11
Detroit Tigers,0,Toronto Blue Jays,9,5,September 8 2017,4
Philadelphia Phillies,1,Washington Nationals,21,10,September 8 2017,11
San Diego Padres,0,Arizona D'Backs,15,8,September 9 2017,7
Miami Marlins,1,Atlanta Braves,11,5,September 9 2017,6
Tampa Bay Rays,1,Boston Red Sox,9,0,September 9 2017,9
San Francisco Giants,1,Chicago White Sox,14,1,September 9 2017,13
Milwaukee Brewers,0,Chicago Cubs,17,15,September 9 2017,2
Baltimore Orioles,1,Cleveland Indians,6,2,September 9 2017,4
Minnesota Twins,1,Kansas City Royals,7,2,September 9 2017,5
Colorado Rockies,0,Los Angeles Dodgers,11,6,September 9 2017,5
Cincinnati Reds,1,New York Mets,7,1,September 9 2017,6
Houston Astros,1,Oakland Athletics,12,1,September 9 2017,11
Houston Astros,1,Oakland Athletics,15,4,September 9 2017,11
Los Angeles Angels,1,Seattle Mariners,9,1,September 9 2017,8
Pittsburgh Pirates,1,St. Louis Cardinals,7,3,September 9 2017,4
New York Yankees,0,Texas Rangers,4,3,September 9 2017,1
Detroit Tigers,1,Toronto Blue Jays,9,4,September 9 2017,5
Philadelphia Phillies,0,Washington Nationals,9,5,September 9 2017,4
San Diego Padres,1,Arizona D'Backs,5,2,September 10 2017,3
Miami Marlins,1,Atlanta Braves,18,8,September 10 2017,10
Tampa Bay Rays,0,Boston Red Sox,5,4,September 10 2017,1
San Francisco Giants,1,Chicago White Sox,9,1,September 10 2017,8
Milwaukee Brewers,0,Chicago Cubs,4,3,September 10 2017,1
Baltimore Orioles,1,Cleveland Indians,5,2,September 10 2017,3
Minnesota Twins,1,Kansas City Royals,14,3,September 10 2017,11
Colorado Rockies,0,Los Angeles Dodgers,9,8,September 10 2017,1
Cincinnati Reds,0,New York Mets,15,10,September 10 2017,5
Houston Astros,1,Oakland Athletics,12,2,September 10 2017,10
Los Angeles Angels,0,Seattle Mariners,8,5,September 10 2017,3
Pittsburgh Pirates,1,St. Louis Cardinals,7,0,September 10 2017,7
New York Yankees,0,Texas Rangers,23,16,September 10 2017,7
Detroit Tigers,1,Toronto Blue Jays,10,2,September 10 2017,8
Philadelphia Phillies,1,Washington Nationals,5,2,September 10 2017,3
Colorado Rockies,0,Arizona D'Backs,9,5,September 11 2017,4
Detroit Tigers,1,Cleveland Indians,11,0,September 11 2017,11
Chicago White Sox,0,Kansas City Royals,14,11,September 11 2017,3
Pittsburgh Pirates,0,Milwaukee Brewers,7,7,September 11 2017,0
Los Angeles Dodgers,1,San Francisco Giants,14,6,September 11 2017,8
New York Yankees,0,Tampa Bay Rays,6,5,September 11 2017,1
Seattle Mariners,1,Texas Rangers,8,3,September 11 2017,5
Baltimore Orioles,1,Toronto Blue Jays,7,3,September 11 2017,4
Houston Astros,0,Los Angeles Angels,1,1,September 12 2017,0
Colorado Rockies,0,Arizona D'Backs,6,4,September 12 2017,2
Oakland Athletics,1,Boston Red Sox,12,1,September 12 2017,11
New York Mets,1,Chicago Cubs,11,3,September 12 2017,8
Detroit Tigers,1,Cleveland Indians,2,0,September 12 2017,2
Chicago White Sox,1,Kansas City Royals,7,3,September 12 2017,4
Pittsburgh Pirates,1,Milwaukee Brewers,7,2,September 12 2017,5
San Diego Padres,1,Minnesota Twins,16,0,September 12 2017,16
Miami Marlins,1,Philadelphia Phillies,17,8,September 12 2017,9
Los Angeles Dodgers,0,San Francisco Giants,8,5,September 12 2017,3
Cincinnati Reds,1,St. Louis Cardinals,17,4,September 12 2017,13
New York Yankees,1,Tampa Bay Rays,3,1,September 12 2017,2
Seattle Mariners,0,Texas Rangers,13,10,September 12 2017,3
Baltimore Orioles,1,Toronto Blue Jays,5,2,September 12 2017,3
Atlanta Braves,0,Washington Nationals,8,8,September 12 2017,0
Houston Astros,1,Los Angeles Angels,10,1,September 13 2017,9
Colorado Rockies,1,Arizona D'Backs,10,2,September 13 2017,8
Oakland Athletics,0,Boston Red Sox,10,7,September 13 2017,3
New York Mets,1,Chicago Cubs,22,5,September 13 2017,17
Detroit Tigers,1,Cleveland Indians,8,3,September 13 2017,5
Chicago White Sox,0,Kansas City Royals,8,5,September 13 2017,3
Pittsburgh Pirates,1,Milwaukee Brewers,10,2,September 13 2017,8
San Diego Padres,1,Minnesota Twins,4,1,September 13 2017,3
Miami Marlins,1,Philadelphia Phillies,9,1,September 13 2017,8
Los Angeles Dodgers,0,San Francisco Giants,5,4,September 13 2017,1
Cincinnati Reds,0,St. Louis Cardinals,6,6,September 13 2017,0
New York Yankees,0,Tampa Bay Rays,5,3,September 13 2017,2
Seattle Mariners,0,Texas Rangers,9,8,September 13 2017,1
Baltimore Orioles,0,Toronto Blue Jays,3,2,September 13 2017,1
Atlanta Braves,0,Washington Nationals,10,8,September 13 2017,2
Houston Astros,0,Los Angeles Angels,7,5,September 14 2017,2
Colorado Rockies,1,Arizona D'Backs,7,0,September 14 2017,7
Oakland Athletics,1,Boston Red Sox,8,2,September 14 2017,6
New York Mets,1,Chicago Cubs,20,6,September 14 2017,14
Kansas City Royals,1,Cleveland Indians,5,2,September 14 2017,3
Chicago White Sox,0,Detroit Tigers,24,17,September 14 2017,7
Toronto Blue Jays,1,Minnesota Twins,5,2,September 14 2017,3
Baltimore Orioles,1,New York Yankees,18,5,September 14 2017,13
Miami Marlins,1,Philadelphia Phillies,10,0,September 14 2017,10
Cincinnati Reds,1,St. Louis Cardinals,7,2,September 14 2017,5
Seattle Mariners,0,Texas Rangers,14,10,September 14 2017,4
Atlanta Braves,1,Washington Nationals,7,2,September 14 2017,5
Texas Rangers,1,Los Angeles Angels,13,6,September 15 2017,7
New York Mets,1,Atlanta Braves,5,2,September 15 2017,3
St. Louis Cardinals,1,Chicago Cubs,10,2,September 15 2017,8
Pittsburgh Pirates,1,Cincinnati Reds,6,2,September 15 2017,4
Kansas City Royals,0,Cleveland Indians,7,4,September 15 2017,3
San Diego Padres,1,Colorado Rockies,7,1,September 15 2017,6
Chicago White Sox,1,Detroit Tigers,5,2,September 15 2017,3
Seattle Mariners,1,Houston Astros,7,2,September 15 2017,5
Miami Marlins,1,Milwaukee Brewers,12,2,September 15 2017,10
Toronto Blue Jays,0,Minnesota Twins,7,4,September 15 2017,3
Baltimore Orioles,1,New York Yankees,10,2,September 15 2017,8
Oakland Athletics,0,Philadelphia Phillies,4,4,September 15 2017,0
Arizona D'Backs,0,San Francisco Giants,5,3,September 15 2017,2
Boston Red Sox,0,Tampa Bay Rays,19,13,September 15 2017,6
Los Angeles Dodgers,0,Washington Nationals,7,7,September 15 2017,0
Texas Rangers,1,Los Angeles Angels,2,0,September 16 2017,2
New York Mets,0,Atlanta Braves,10,7,September 16 2017,3
St. Louis Cardinals,1,Chicago Cubs,5,1,September 16 2017,4
Pittsburgh Pirates,1,Cincinnati Reds,3,1,September 16 2017,2
Kansas City Royals,1,Cleveland Indians,12,4,September 16 2017,8
San Diego Padres,1,Colorado Rockies,16,0,September 16 2017,16
Chicago White Sox,0,Detroit Tigers,14,10,September 16 2017,4
Seattle Mariners,1,Houston Astros,14,6,September 16 2017,8
Miami Marlins,0,Milwaukee Brewers,11,7,September 16 2017,4
Toronto Blue Jays,0,Minnesota Twins,9,7,September 16 2017,2
Baltimore Orioles,1,New York Yankees,12,3,September 16 2017,9
Oakland Athletics,1,Philadelphia Phillies,8,3,September 16 2017,5
Arizona D'Backs,0,San Francisco Giants,2,2,September 16 2017,0
Boston Red Sox,0,Tampa Bay Rays,4,3,September 16 2017,1
Los Angeles Dodgers,0,Washington Nationals,5,3,September 16 2017,2
Texas Rangers,0,Los Angeles Angels,6,4,September 17 2017,2
New York Mets,0,Atlanta Braves,6,5,September 17 2017,1
St. Louis Cardinals,1,Chicago Cubs,7,3,September 17 2017,4
Pittsburgh Pirates,1,Cincinnati Reds,7,2,September 17 2017,5
Kansas City Royals,1,Cleveland Indians,5,2,September 17 2017,3
San Diego Padres,0,Colorado Rockies,7,4,September 17 2017,3
Chicago White Sox,1,Detroit Tigers,12,0,September 17 2017,12
Seattle Mariners,1,Houston Astros,8,1,September 17 2017,7
Miami Marlins,1,Milwaukee Brewers,13,3,September 17 2017,10
Toronto Blue Jays,1,Minnesota Twins,20,7,September 17 2017,13
Baltimore Orioles,0,New York Yankees,10,6,September 17 2017,4
Oakland Athletics,0,Philadelphia Phillies,9,6,September 17 2017,3
Arizona D'Backs,1,San Francisco Giants,9,2,September 17 2017,7
Boston Red Sox,1,Tampa Bay Rays,5,2,September 17 2017,3
Los Angeles Dodgers,1,Washington Nationals,8,1,September 17 2017,7
Boston Red Sox,0,Baltimore Orioles,18,10,September 18 2017,8
Oakland Athletics,0,Detroit Tigers,11,8,September 18 2017,3
New York Mets,1,Miami Marlins,14,1,September 18 2017,13
Minnesota Twins,1,New York Yankees,3,1,September 18 2017,2
Los Angeles Dodgers,1,Philadelphia Phillies,7,3,September 18 2017,4
Milwaukee Brewers,0,Pittsburgh Pirates,3,3,September 18 2017,0
Arizona D'Backs,1,San Diego Padres,6,2,September 18 2017,4
Cleveland Indians,0,Los Angeles Angels,9,6,September 19 2017,3
Washington Nationals,0,Atlanta Braves,6,4,September 19 2017,2
Boston Red Sox,0,Baltimore Orioles,1,1,September 19 2017,0
St. Louis Cardinals,0,Cincinnati Reds,15,8,September 19 2017,7
Oakland Athletics,0,Detroit Tigers,17,9,September 19 2017,8
Chicago White Sox,1,Houston Astros,4,1,September 19 2017,3
New York Mets,1,Miami Marlins,9,4,September 19 2017,5
Minnesota Twins,1,New York Yankees,7,2,September 19 2017,5
Los Angeles Dodgers,1,Philadelphia Phillies,8,2,September 19 2017,6
Milwaukee Brewers,0,Pittsburgh Pirates,1,1,September 19 2017,0
Arizona D'Backs,1,San Diego Padres,8,2,September 19 2017,6
Texas Rangers,0,Seattle Mariners,4,3,September 19 2017,1
Colorado Rockies,1,San Francisco Giants,7,3,September 19 2017,4
Chicago Cubs,0,Tampa Bay Rays,3,2,September 19 2017,1
Kansas City Royals,1,Toronto Blue Jays,7,2,September 19 2017,5
Cleveland Indians,0,Los Angeles Angels,11,6,September 20 2017,5
Washington Nationals,0,Atlanta Braves,10,7,September 20 2017,3
Boston Red Sox,0,Baltimore Orioles,9,9,September 20 2017,0
St. Louis Cardinals,0,Cincinnati Reds,11,9,September 20 2017,2
Oakland Athletics,0,Detroit Tigers,5,3,September 20 2017,2
Chicago White Sox,1,Houston Astros,7,3,September 20 2017,4
New York Mets,1,Miami Marlins,11,2,September 20 2017,9
Minnesota Twins,1,New York Yankees,14,3,September 20 2017,11
Los Angeles Dodgers,1,Philadelphia Phillies,12,5,September 20 2017,7
Milwaukee Brewers,1,Pittsburgh Pirates,10,4,September 20 2017,6
Arizona D'Backs,0,San Diego Padres,20,13,September 20 2017,7
Texas Rangers,0,Seattle Mariners,14,8,September 20 2017,6
Colorado Rockies,1,San Francisco Giants,4,0,September 20 2017,4
Chicago Cubs,1,Tampa Bay Rays,9,1,September 20 2017,8
Kansas City Royals,0,Toronto Blue Jays,20,15,September 20 2017,5
Cleveland Indians,0,Los Angeles Angels,5,4,September 21 2017,1
Washington Nationals,1,Atlanta Braves,5,2,September 21 2017,3
Tampa Bay Rays,1,Baltimore Orioles,4,1,September 21 2017,3
St. Louis Cardinals,0,Cincinnati Reds,13,8,September 21 2017,5
Minnesota Twins,0,Detroit Tigers,13,12,September 21 2017,1
Chicago White Sox,0,Houston Astros,4,3,September 21 2017,1
Chicago Cubs,0,Milwaukee Brewers,8,5,September 21 2017,3
Los Angeles Dodgers,0,Philadelphia Phillies,9,5,September 21 2017,4
Colorado Rockies,1,San Diego Padres,3,0,September 21 2017,3
Texas Rangers,0,Seattle Mariners,6,4,September 21 2017,2
Kansas City Royals,0,Toronto Blue Jays,1,1,September 21 2017,0
Miami Marlins,1,Arizona D'Backs,24,11,September 22 2017,13
Philadelphia Phillies,1,Atlanta Braves,9,2,September 22 2017,7
Tampa Bay Rays,0,Baltimore Orioles,11,8,September 22 2017,3
Kansas City Royals,1,Chicago White Sox,13,6,September 22 2017,7
Boston Red Sox,0,Cincinnati Reds,9,5,September 22 2017,4
Minnesota Twins,0,Detroit Tigers,10,7,September 22 2017,3
Los Angeles Angels,1,Houston Astros,3,0,September 22 2017,3
San Francisco Giants,1,Los Angeles Dodgers,6,2,September 22 2017,4
Chicago Cubs,0,Milwaukee Brewers,9,5,September 22 2017,4
Washington Nationals,1,New York Mets,13,6,September 22 2017,7
Texas Rangers,1,Oakland Athletics,5,1,September 22 2017,4
St. Louis Cardinals,0,Pittsburgh Pirates,7,4,September 22 2017,3
Colorado Rockies,0,San Diego Padres,5,4,September 22 2017,1
Cleveland Indians,1,Seattle Mariners,4,1,September 22 2017,3
New York Yankees,1,Toronto Blue Jays,9,1,September 22 2017,8
Miami Marlins,0,Arizona D'Backs,18,12,September 23 2017,6
Philadelphia Phillies,1,Atlanta Braves,6,2,September 23 2017,4
Tampa Bay Rays,0,Baltimore Orioles,15,9,September 23 2017,6
Kansas City Royals,0,Chicago White Sox,10,8,September 23 2017,2
Boston Red Sox,0,Cincinnati Reds,5,5,September 23 2017,0
Minnesota Twins,0,Detroit Tigers,14,10,September 23 2017,4
Los Angeles Angels,1,Houston Astros,8,2,September 23 2017,6
San Francisco Giants,0,Los Angeles Dodgers,3,2,September 23 2017,1
Chicago Cubs,1,Milwaukee Brewers,7,3,September 23 2017,4
Washington Nationals,0,New York Mets,7,4,September 23 2017,3
Texas Rangers,1,Oakland Athletics,1,0,September 23 2017,1
St. Louis Cardinals,1,Pittsburgh Pirates,17,6,September 23 2017,11
Colorado Rockies,1,San Diego Padres,5,0,September 23 2017,5
Cleveland Indians,0,Seattle Mariners,15,11,September 23 2017,4
New York Yankees,0,Toronto Blue Jays,6,5,September 23 2017,1
Miami Marlins,1,Arizona D'Backs,5,2,September 24 2017,3
Philadelphia Phillies,0,Atlanta Braves,2,2,September 24 2017,0
Tampa Bay Rays,1,Baltimore Orioles,13,4,September 24 2017,9
Kansas City Royals,1,Chicago White Sox,9,1,September 24 2017,8
Boston Red Sox,0,Cincinnati Reds,9,5,September 24 2017,4
Minnesota Twins,0,Detroit Tigers,14,10,September 24 2017,4
Los Angeles Angels,0,Houston Astros,12,7,September 24 2017,5
San Francisco Giants,1,Los Angeles Dodgers,4,1,September 24 2017,3
Chicago Cubs,0,Milwaukee Brewers,5,5,September 24 2017,0
Washington Nationals,0,New York Mets,5,3,September 24 2017,2
Texas Rangers,1,Oakland Athletics,9,1,September 24 2017,8
St. Louis Cardinals,1,Pittsburgh Pirates,5,1,September 24 2017,4
Colorado Rockies,0,San Diego Padres,12,8,September 24 2017,4
Cleveland Indians,0,Seattle Mariners,6,4,September 24 2017,2
New York Yankees,1,Toronto Blue Jays,14,5,September 24 2017,9
San Francisco Giants,0,Arizona D'Backs,11,9,September 25 2017,2
Toronto Blue Jays,0,Boston Red Sox,10,6,September 25 2017,4
Los Angeles Angels,1,Chicago White Sox,6,2,September 25 2017,4
Miami Marlins,0,Colorado Rockies,9,5,September 25 2017,4
San Diego Padres,1,Los Angeles Dodgers,12,3,September 25 2017,9
Kansas City Royals,1,New York Yankees,14,3,September 25 2017,11
Atlanta Braves,0,New York Mets,11,9,September 25 2017,2
Atlanta Braves,1,New York Mets,5,2,September 25 2017,3
Seattle Mariners,0,Oakland Athletics,8,7,September 25 2017,1
Washington Nationals,0,Philadelphia Phillies,4,3,September 25 2017,1
Chicago Cubs,0,St. Louis Cardinals,12,10,September 25 2017,2
Houston Astros,0,Texas Rangers,13,11,September 25 2017,2
San Francisco Giants,1,Arizona D'Backs,15,4,September 26 2017,11
Toronto Blue Jays,0,Boston Red Sox,13,9,September 26 2017,4
Los Angeles Angels,0,Chicago White Sox,12,9,September 26 2017,3
Minnesota Twins,0,Cleveland Indians,14,8,September 26 2017,6
Miami Marlins,1,Colorado Rockies,6,0,September 26 2017,6
Detroit Tigers,1,Kansas City Royals,3,1,September 26 2017,2
San Diego Padres,1,Los Angeles Dodgers,11,2,September 26 2017,9
Cincinnati Reds,1,Milwaukee Brewers,13,6,September 26 2017,7
Tampa Bay Rays,1,New York Yankees,7,1,September 26 2017,6
Atlanta Braves,1,New York Mets,7,3,September 26 2017,4
Seattle Mariners,0,Oakland Athletics,9,6,September 26 2017,3
Washington Nationals,1,Philadelphia Phillies,5,1,September 26 2017,4
Baltimore Orioles,1,Pittsburgh Pirates,11,1,September 26 2017,10
Chicago Cubs,1,St. Louis Cardinals,15,7,September 26 2017,8
Houston Astros,0,Texas Rangers,17,14,September 26 2017,3
San Francisco Giants,1,Arizona D'Backs,7,3,September 27 2017,4
Toronto Blue Jays,1,Boston Red Sox,17,7,September 27 2017,10
Los Angeles Angels,1,Chicago White Sox,10,4,September 27 2017,6
Minnesota Twins,1,Cleveland Indians,6,2,September 27 2017,4
Miami Marlins,1,Colorado Rockies,24,9,September 27 2017,15
Detroit Tigers,1,Kansas City Royals,11,4,September 27 2017,7
San Diego Padres,1,Los Angeles Dodgers,10,0,September 27 2017,10
Cincinnati Reds,0,Milwaukee Brewers,6,6,September 27 2017,0
Tampa Bay Rays,1,New York Yankees,7,1,September 27 2017,6
Atlanta Braves,1,New York Mets,8,1,September 27 2017,7
Seattle Mariners,1,Oakland Athletics,11,5,September 27 2017,6
Washington Nationals,1,Philadelphia Phillies,12,5,September 27 2017,7
Baltimore Orioles,1,Pittsburgh Pirates,8,3,September 27 2017,5
Chicago Cubs,0,St. Louis Cardinals,6,5,September 27 2017,1
Houston Astros,0,Texas Rangers,14,12,September 27 2017,2
Houston Astros,0,Boston Red Sox,14,12,September 28 2017,2
Los Angeles Angels,1,Chicago White Sox,9,4,September 28 2017,5
Minnesota Twins,1,Cleveland Indians,7,2,September 28 2017,5
Detroit Tigers,0,Kansas City Royals,5,4,September 28 2017,1
Atlanta Braves,1,Miami Marlins,8,1,September 28 2017,7
Cincinnati Reds,1,Milwaukee Brewers,7,3,September 28 2017,4
Tampa Bay Rays,0,New York Yankees,15,9,September 28 2017,6
Chicago Cubs,0,St. Louis Cardinals,3,2,September 28 2017,1
Oakland Athletics,0,Texas Rangers,5,4,September 28 2017,1
Pittsburgh Pirates,1,Washington Nationals,9,4,September 28 2017,5
Seattle Mariners,1,Los Angeles Angels,11,5,September 29 2017,6
Houston Astros,0,Boston Red Sox,5,3,September 29 2017,2
Cincinnati Reds,1,Chicago Cubs,9,4,September 29 2017,5
Chicago White Sox,1,Cleveland Indians,11,1,September 29 2017,10
Los Angeles Dodgers,1,Colorado Rockies,10,1,September 29 2017,9
Arizona D'Backs,1,Kansas City Royals,3,1,September 29 2017,2
Atlanta Braves,1,Miami Marlins,11,5,September 29 2017,6
Detroit Tigers,1,Minnesota Twins,9,3,September 29 2017,6
Toronto Blue Jays,1,New York Yankees,4,0,September 29 2017,4
New York Mets,1,Philadelphia Phillies,8,2,September 29 2017,6
San Diego Padres,1,San Francisco Giants,8,0,September 29 2017,8
Milwaukee Brewers,0,St. Louis Cardinals,8,5,September 29 2017,3
Baltimore Orioles,1,Tampa Bay Rays,7,0,September 29 2017,7
Oakland Athletics,1,Texas Rangers,8,3,September 29 2017,5
Pittsburgh Pirates,1,Washington Nationals,7,1,September 29 2017,6
Seattle Mariners,0,Los Angeles Angels,10,6,September 30 2017,4
Houston Astros,1,Boston Red Sox,9,3,September 30 2017,6
Cincinnati Reds,1,Chicago Cubs,9,0,September 30 2017,9
Chicago White Sox,0,Cleveland Indians,3,2,September 30 2017,1
Los Angeles Dodgers,0,Colorado Rockies,8,5,September 30 2017,3
Arizona D'Backs,1,Kansas City Royals,7,3,September 30 2017,4
Atlanta Braves,1,Miami Marlins,12,2,September 30 2017,10
Detroit Tigers,0,Minnesota Twins,5,3,September 30 2017,2
Toronto Blue Jays,1,New York Yankees,3,1,September 30 2017,2
New York Mets,0,Philadelphia Phillies,11,7,September 30 2017,4
San Diego Padres,0,San Francisco Giants,5,3,September 30 2017,2
Milwaukee Brewers,1,St. Louis Cardinals,13,6,September 30 2017,7
Baltimore Orioles,1,Tampa Bay Rays,7,3,September 30 2017,4
Oakland Athletics,1,Texas Rangers,12,4,September 30 2017,8
Pittsburgh Pirates,0,Washington Nationals,5,4,September 30 2017,1
Seattle Mariners,1,Los Angeles Angels,8,2,October 1 2017,6
Houston Astros,0,Boston Red Sox,7,4,October 1 2017,3
Cincinnati Reds,0,Chicago Cubs,4,3,October 1 2017,1
Chicago White Sox,1,Cleveland Indians,4,1,October 1 2017,3
Los Angeles Dodgers,0,Colorado Rockies,9,6,October 1 2017,3
Arizona D'Backs,0,Kansas City Royals,16,14,October 1 2017,2
Atlanta Braves,0,Miami Marlins,13,8,October 1 2017,5
Detroit Tigers,1,Minnesota Twins,6,1,October 1 2017,5
Toronto Blue Jays,0,New York Yankees,3,2,October 1 2017,1
New York Mets,1,Philadelphia Phillies,11,0,October 1 2017,11
San Diego Padres,1,San Francisco Giants,9,4,October 1 2017,5
Milwaukee Brewers,0,St. Louis Cardinals,7,6,October 1 2017,1
Baltimore Orioles,1,Tampa Bay Rays,6,0,October 1 2017,6
Oakland Athletics,0,Texas Rangers,7,5,October 1 2017,2
Pittsburgh Pirates,0,Washington Nationals,19,11,October 1 2017,8
Minnesota Twins,1,New York Yankees,12,4,October 3 2017,8
Colorado Rockies,1,Arizona D'Backs,19,8,October 4 2017,11
New York Yankees,1,Cleveland Indians,4,0,October 5 2017,4
Boston Red Sox,1,Houston Astros,10,2,October 5 2017,8
New York Yankees,1,Cleveland Indians,17,8,October 6 2017,9
Boston Red Sox,1,Houston Astros,10,2,October 6 2017,8
Arizona D'Backs,1,Los Angeles Dodgers,14,5,October 6 2017,9
Chicago Cubs,0,Washington Nationals,3,3,October 6 2017,0
Arizona D'Backs,1,Los Angeles Dodgers,13,5,October 7 2017,8
Chicago Cubs,1,Washington Nationals,9,3,October 7 2017,6
Houston Astros,1,Boston Red Sox,13,3,October 8 2017,10
Cleveland Indians,1,New York Yankees,1,0,October 8 2017,1
Los Angeles Dodgers,0,Arizona D'Backs,4,3,October 9 2017,1
Houston Astros,0,Boston Red Sox,9,5,October 9 2017,4
Washington Nationals,1,Chicago Cubs,3,1,October 9 2017,2
Cleveland Indians,1,New York Yankees,10,3,October 9 2017,7
Washington Nationals,0,Chicago Cubs,5,5,October 11 2017,0
New York Yankees,0,Cleveland Indians,7,5,October 11 2017,2
Chicago Cubs,0,Washington Nationals,17,9,October 12 2017,8
New York Yankees,1,Houston Astros,3,1,October 13 2017,2
New York Yankees,1,Houston Astros,3,1,October 14 2017,2
Chicago Cubs,1,Los Angeles Dodgers,7,2,October 14 2017,5
Chicago Cubs,1,Los Angeles Dodgers,5,1,October 15 2017,4
Houston Astros,1,New York Yankees,9,1,October 16 2017,8
Los Angeles Dodgers,0,Chicago Cubs,7,6,October 17 2017,1
Houston Astros,1,New York Yankees,10,4,October 17 2017,6
Los Angeles Dodgers,1,Chicago Cubs,5,2,October 18 2017,3
Houston Astros,1,New York Yankees,5,0,October 18 2017,5
Los Angeles Dodgers,0,Chicago Cubs,12,11,October 19 2017,1
New York Yankees,1,Houston Astros,8,1,October 20 2017,7
New York Yankees,1,Houston Astros,4,0,October 21 2017,4
Houston Astros,1,Los Angeles Dodgers,4,1,October 24 2017,3
Houston Astros,0,Los Angeles Dodgers,13,7,October 25 2017,6
Los Angeles Dodgers,1,Houston Astros,8,3,October 27 2017,5
Los Angeles Dodgers,0,Houston Astros,8,6,October 28 2017,2
Los Angeles Dodgers,1,Houston Astros,25,12,October 29 2017,13
Houston Astros,1,Los Angeles Dodgers,4,1,October 31 2017,3
Houston Astros,0,Los Angeles Dodgers,6,5,November 1 2017,1
Colorado Rockies,1,Arizona D'Backs,10,2,March 29 2018,8
Philadelphia Phillies,1,Atlanta Braves,13,5,March 29 2018,8
Minnesota Twins,1,Baltimore Orioles,5,2,March 29 2018,3
Chicago White Sox,0,Kansas City Royals,21,14,March 29 2018,7
San Francisco Giants,0,Los Angeles Dodgers,1,1,March 29 2018,0
Chicago Cubs,0,Miami Marlins,12,8,March 29 2018,4
St. Louis Cardinals,1,New York Mets,13,4,March 29 2018,9
Los Angeles Angels,1,Oakland Athletics,11,5,March 29 2018,6
Milwaukee Brewers,0,San Diego Padres,3,2,March 29 2018,1
Cleveland Indians,1,Seattle Mariners,3,1,March 29 2018,2
Boston Red Sox,1,Tampa Bay Rays,10,4,March 29 2018,6
Houston Astros,0,Texas Rangers,5,4,March 29 2018,1
New York Yankees,0,Toronto Blue Jays,7,6,March 29 2018,1
Colorado Rockies,1,Arizona D'Backs,17,8,March 30 2018,9
Philadelphia Phillies,0,Atlanta Braves,9,5,March 30 2018,4
Washington Nationals,0,Cincinnati Reds,2,2,March 30 2018,0
Pittsburgh Pirates,0,Detroit Tigers,23,13,March 30 2018,10
San Francisco Giants,0,Los Angeles Dodgers,1,1,March 30 2018,0
Chicago Cubs,1,Miami Marlins,3,1,March 30 2018,2
Los Angeles Angels,0,Oakland Athletics,3,2,March 30 2018,1
Milwaukee Brewers,0,San Diego Padres,14,8,March 30 2018,6
Boston Red Sox,0,Tampa Bay Rays,1,1,March 30 2018,0
Houston Astros,1,Texas Rangers,6,1,March 30 2018,5
New York Yankees,0,Toronto Blue Jays,6,4,March 30 2018,2
Colorado Rockies,0,Arizona D'Backs,3,2,March 31 2018,1
Philadelphia Phillies,1,Atlanta Braves,17,2,March 31 2018,15
Minnesota Twins,0,Baltimore Orioles,8,6,March 31 2018,2
Washington Nationals,0,Cincinnati Reds,20,13,March 31 2018,7
Chicago White Sox,0,Kansas City Royals,7,4,March 31 2018,3
San Francisco Giants,1,Los Angeles Dodgers,5,0,March 31 2018,5
Chicago Cubs,0,Miami Marlins,16,10,March 31 2018,6
St. Louis Cardinals,1,New York Mets,8,2,March 31 2018,6
Los Angeles Angels,0,Oakland Athletics,11,8,March 31 2018,3
Milwaukee Brewers,0,San Diego Padres,10,7,March 31 2018,3
Cleveland Indians,0,Seattle Mariners,11,6,March 31 2018,5
Boston Red Sox,0,Tampa Bay Rays,5,3,March 31 2018,2
Houston Astros,0,Texas Rangers,12,9,March 31 2018,3
New York Yankees,1,Toronto Blue Jays,8,3,March 31 2018,5
Minnesota Twins,0,Baltimore Orioles,7,7,April 1 2018,0
Washington Nationals,0,Cincinnati Reds,11,6,April 1 2018,5
Pittsburgh Pirates,0,Detroit Tigers,1,1,April 1 2018,0
Pittsburgh Pirates,0,Detroit Tigers,14,8,April 1 2018,6
San Francisco Giants,1,Los Angeles Dodgers,9,0,April 1 2018,9
Chicago Cubs,1,Miami Marlins,6,0,April 1 2018,6
St. Louis Cardinals,0,New York Mets,6,5,April 1 2018,1
Los Angeles Angels,0,Oakland Athletics,11,7,April 1 2018,4
Cleveland Indians,1,Seattle Mariners,9,4,April 1 2018,5
Boston Red Sox,0,Tampa Bay Rays,3,2,April 1 2018,1
Houston Astros,0,Texas Rangers,10,8,April 1 2018,2
New York Yankees,1,Toronto Blue Jays,11,4,April 1 2018,7
Cleveland Indians,0,Los Angeles Angels,6,6,April 2 2018,0
Los Angeles Dodgers,1,Arizona D'Backs,15,7,April 2 2018,8
Washington Nationals,0,Atlanta Braves,9,8,April 2 2018,1
Chicago Cubs,1,Cincinnati Reds,1,0,April 2 2018,1
Kansas City Royals,1,Detroit Tigers,7,1,April 2 2018,6
Baltimore Orioles,1,Houston Astros,7,1,April 2 2018,6
Boston Red Sox,0,Miami Marlins,10,7,April 2 2018,3
St. Louis Cardinals,0,Milwaukee Brewers,12,8,April 2 2018,4
Texas Rangers,1,Oakland Athletics,4,1,April 2 2018,3
Minnesota Twins,1,Pittsburgh Pirates,9,4,April 2 2018,5
Colorado Rockies,0,San Diego Padres,11,7,April 2 2018,4
Chicago White Sox,1,Toronto Blue Jays,6,2,April 2 2018,4
Cleveland Indians,1,Los Angeles Angels,15,2,April 3 2018,13
Los Angeles Dodgers,1,Arizona D'Backs,7,1,April 3 2018,6
Washington Nationals,1,Atlanta Braves,19,6,April 3 2018,13
Kansas City Royals,0,Detroit Tigers,1,1,April 3 2018,0
Baltimore Orioles,1,Houston Astros,16,6,April 3 2018,10
Boston Red Sox,0,Miami Marlins,6,4,April 3 2018,2
St. Louis Cardinals,1,Milwaukee Brewers,9,4,April 3 2018,5
Tampa Bay Rays,1,New York Yankees,15,4,April 3 2018,11
Philadelphia Phillies,1,New York Mets,2,0,April 3 2018,2
Texas Rangers,0,Oakland Athletics,5,4,April 3 2018,1
Colorado Rockies,1,San Diego Padres,12,4,April 3 2018,8
Seattle Mariners,0,San Francisco Giants,10,6,April 3 2018,4
Chicago White Sox,1,Toronto Blue Jays,19,5,April 3 2018,14
Cleveland Indians,1,Los Angeles Angels,5,2,April 4 2018,3
Los Angeles Dodgers,1,Arizona D'Backs,3,0,April 4 2018,3
Washington Nationals,1,Atlanta Braves,8,1,April 4 2018,7
Baltimore Orioles,1,Houston Astros,5,2,April 4 2018,3
St. Louis Cardinals,0,Milwaukee Brewers,6,6,April 4 2018,0
Tampa Bay Rays,1,New York Yankees,9,2,April 4 2018,7
Philadelphia Phillies,1,New York Mets,6,2,April 4 2018,4
Texas Rangers,1,Oakland Athletics,8,2,April 4 2018,6
Minnesota Twins,0,Pittsburgh Pirates,10,7,April 4 2018,3
Colorado Rockies,0,San Diego Padres,7,5,April 4 2018,2
Seattle Mariners,1,San Francisco Giants,11,1,April 4 2018,10
Chicago White Sox,0,Toronto Blue Jays,7,4,April 4 2018,3
Tampa Bay Rays,1,Boston Red Sox,5,2,April 5 2018,3
Detroit Tigers,0,Chicago White Sox,16,9,April 5 2018,7
Chicago Cubs,0,Milwaukee Brewers,8,8,April 5 2018,0
Seattle Mariners,1,Minnesota Twins,6,2,April 5 2018,4
Baltimore Orioles,0,New York Yankees,7,5,April 5 2018,2
Texas Rangers,0,Oakland Athletics,9,6,April 5 2018,3
Miami Marlins,1,Philadelphia Phillies,5,0,April 5 2018,5
Cincinnati Reds,1,Pittsburgh Pirates,7,2,April 5 2018,5
Colorado Rockies,0,San Diego Padres,4,3,April 5 2018,1
Arizona D'Backs,0,St. Louis Cardinals,4,3,April 5 2018,1
New York Mets,0,Washington Nationals,10,8,April 5 2018,2
Oakland Athletics,1,Los Angeles Angels,22,9,April 6 2018,13
Kansas City Royals,1,Cleveland Indians,5,2,April 6 2018,3
Atlanta Braves,0,Colorado Rockies,11,8,April 6 2018,3
San Diego Padres,0,Houston Astros,5,4,April 6 2018,1
Chicago Cubs,1,Milwaukee Brewers,9,4,April 6 2018,5
Baltimore Orioles,0,New York Yankees,10,7,April 6 2018,3
Cincinnati Reds,1,Pittsburgh Pirates,17,3,April 6 2018,14
Toronto Blue Jays,0,Texas Rangers,13,8,April 6 2018,5
Oakland Athletics,0,Los Angeles Angels,10,7,April 7 2018,3
Tampa Bay Rays,1,Boston Red Sox,13,3,April 7 2018,10
Detroit Tigers,0,Chicago White Sox,7,6,April 7 2018,1
Kansas City Royals,0,Cleveland Indians,1,1,April 7 2018,0
Atlanta Braves,1,Colorado Rockies,5,2,April 7 2018,3
San Diego Padres,1,Houston Astros,1,0,April 7 2018,1
Chicago Cubs,0,Milwaukee Brewers,7,5,April 7 2018,2
Seattle Mariners,0,Minnesota Twins,15,11,April 7 2018,4
Baltimore Orioles,1,New York Yankees,11,3,April 7 2018,8
Miami Marlins,1,Philadelphia Phillies,21,1,April 7 2018,20
Cincinnati Reds,0,Pittsburgh Pirates,11,7,April 7 2018,4
Los Angeles Dodgers,1,San Francisco Giants,12,5,April 7 2018,7
Arizona D'Backs,1,St. Louis Cardinals,8,3,April 7 2018,5
Toronto Blue Jays,1,Texas Rangers,6,1,April 7 2018,5
New York Mets,0,Washington Nationals,5,3,April 7 2018,2
Oakland Athletics,1,Los Angeles Angels,7,1,April 8 2018,6
Tampa Bay Rays,1,Boston Red Sox,15,7,April 8 2018,8
Detroit Tigers,0,Chicago White Sox,1,1,April 8 2018,0
Kansas City Royals,1,Cleveland Indians,4,1,April 8 2018,3
Atlanta Braves,0,Colorado Rockies,4,4,April 8 2018,0
San Diego Padres,1,Houston Astros,5,1,April 8 2018,4
Chicago Cubs,0,Milwaukee Brewers,3,3,April 8 2018,0
Baltimore Orioles,0,New York Yankees,15,8,April 8 2018,7
Miami Marlins,0,Philadelphia Phillies,9,6,April 8 2018,3
Cincinnati Reds,1,Pittsburgh Pirates,5,0,April 8 2018,5
Los Angeles Dodgers,0,San Francisco Giants,3,2,April 8 2018,1
Arizona D'Backs,0,St. Louis Cardinals,5,4,April 8 2018,1
Toronto Blue Jays,0,Texas Rangers,11,7,April 8 2018,4
New York Mets,0,Washington Nationals,11,6,April 8 2018,5
Toronto Blue Jays,0,Baltimore Orioles,8,7,April 9 2018,1
Tampa Bay Rays,0,Chicago White Sox,9,5,April 9 2018,4
Detroit Tigers,1,Cleveland Indians,2,0,April 9 2018,2
San Diego Padres,0,Colorado Rockies,13,7,April 9 2018,6
Seattle Mariners,1,Kansas City Royals,10,0,April 9 2018,10
New York Mets,0,Miami Marlins,6,4,April 9 2018,2
Houston Astros,0,Minnesota Twins,2,2,April 9 2018,0
Cincinnati Reds,1,Philadelphia Phillies,11,5,April 9 2018,6
Arizona D'Backs,0,San Francisco Giants,3,2,April 9 2018,1
Milwaukee Brewers,0,St. Louis Cardinals,9,5,April 9 2018,4
Los Angeles Angels,0,Texas Rangers,11,8,April 9 2018,3
Atlanta Braves,1,Washington Nationals,2,0,April 9 2018,2
Toronto Blue Jays,0,Baltimore Orioles,3,2,April 10 2018,1
New York Yankees,1,Boston Red Sox,15,1,April 10 2018,14
Tampa Bay Rays,0,Chicago White Sox,11,6,April 10 2018,5
Pittsburgh Pirates,0,Chicago Cubs,13,8,April 10 2018,5
Detroit Tigers,1,Cleveland Indians,3,1,April 10 2018,2
San Diego Padres,0,Colorado Rockies,7,5,April 10 2018,2
Seattle Mariners,0,Kansas City Royals,11,8,April 10 2018,3
Oakland Athletics,1,Los Angeles Dodgers,4,0,April 10 2018,4
New York Mets,0,Miami Marlins,14,8,April 10 2018,6
Houston Astros,1,Minnesota Twins,5,1,April 10 2018,4
Cincinnati Reds,1,Philadelphia Phillies,7,1,April 10 2018,6
Arizona D'Backs,1,San Francisco Giants,9,4,April 10 2018,5
Milwaukee Brewers,1,St. Louis Cardinals,8,3,April 10 2018,5
Los Angeles Angels,0,Texas Rangers,12,11,April 10 2018,1
Atlanta Braves,1,Washington Nationals,5,1,April 10 2018,4
Toronto Blue Jays,1,Baltimore Orioles,8,3,April 11 2018,5
New York Yankees,0,Boston Red Sox,17,10,April 11 2018,7
Tampa Bay Rays,1,Chicago White Sox,3,1,April 11 2018,2
Pittsburgh Pirates,1,Chicago Cubs,18,5,April 11 2018,13
Detroit Tigers,1,Cleveland Indians,6,1,April 11 2018,5
San Diego Padres,1,Colorado Rockies,10,4,April 11 2018,6
Seattle Mariners,0,Kansas City Royals,6,4,April 11 2018,2
Oakland Athletics,0,Los Angeles Dodgers,22,16,April 11 2018,6
New York Mets,0,Miami Marlins,5,4,April 11 2018,1
Houston Astros,1,Minnesota Twins,17,8,April 11 2018,9
Cincinnati Reds,1,Philadelphia Phillies,7,3,April 11 2018,4
Arizona D'Backs,0,San Francisco Giants,10,7,April 11 2018,3
Milwaukee Brewers,0,St. Louis Cardinals,5,3,April 11 2018,2
Los Angeles Angels,0,Texas Rangers,9,7,April 11 2018,2
Atlanta Braves,0,Washington Nationals,8,5,April 11 2018,3
New York Yankees,1,Boston Red Sox,9,3,April 12 2018,6
Pittsburgh Pirates,0,Chicago Cubs,7,6,April 12 2018,1
St. Louis Cardinals,0,Cincinnati Reds,17,13,April 12 2018,4
Detroit Tigers,1,Cleveland Indians,12,3,April 12 2018,9
Los Angeles Angels,0,Kansas City Royals,8,7,April 12 2018,1
Chicago White Sox,1,Minnesota Twins,4,0,April 12 2018,4
San Francisco Giants,0,San Diego Padres,7,7,April 12 2018,0
Colorado Rockies,0,Washington Nationals,6,5,April 12 2018,1
Baltimore Orioles,1,Boston Red Sox,10,3,April 13 2018,7
Atlanta Braves,0,Chicago Cubs,4,4,April 13 2018,0
St. Louis Cardinals,0,Cincinnati Reds,8,5,April 13 2018,3
Toronto Blue Jays,0,Cleveland Indians,12,8,April 13 2018,4
New York Yankees,0,Detroit Tigers,14,8,April 13 2018,6
Texas Rangers,1,Houston Astros,5,2,April 13 2018,3
Los Angeles Angels,0,Kansas City Royals,9,5,April 13 2018,4
Arizona D'Backs,0,Los Angeles Dodgers,15,8,April 13 2018,7
Pittsburgh Pirates,1,Miami Marlins,9,2,April 13 2018,7
Milwaukee Brewers,1,New York Mets,11,5,April 13 2018,6
San Francisco Giants,1,San Diego Padres,6,1,April 13 2018,5
Oakland Athletics,1,Seattle Mariners,11,4,April 13 2018,7
Philadelphia Phillies,0,Tampa Bay Rays,3,2,April 13 2018,1
Colorado Rockies,0,Washington Nationals,3,2,April 13 2018,1
Baltimore Orioles,1,Boston Red Sox,13,3,April 14 2018,10
Atlanta Braves,1,Chicago Cubs,24,10,April 14 2018,14
St. Louis Cardinals,0,Cincinnati Reds,7,6,April 14 2018,1
Texas Rangers,0,Houston Astros,11,6,April 14 2018,5
Los Angeles Angels,0,Kansas City Royals,8,5,April 14 2018,3
Arizona D'Backs,0,Los Angeles Dodgers,10,9,April 14 2018,1
Pittsburgh Pirates,0,Miami Marlins,1,1,April 14 2018,0
Milwaukee Brewers,0,New York Mets,6,5,April 14 2018,1
San Francisco Giants,1,San Diego Padres,9,4,April 14 2018,5
Oakland Athletics,1,Seattle Mariners,18,8,April 14 2018,10
Philadelphia Phillies,0,Tampa Bay Rays,13,9,April 14 2018,4
Colorado Rockies,1,Washington Nationals,8,2,April 14 2018,6
Baltimore Orioles,1,Boston Red Sox,4,1,April 15 2018,3
St. Louis Cardinals,0,Cincinnati Reds,5,3,April 15 2018,2
Texas Rangers,0,Houston Astros,4,3,April 15 2018,1
Arizona D'Backs,1,Los Angeles Dodgers,9,2,April 15 2018,7
Pittsburgh Pirates,0,Miami Marlins,10,7,April 15 2018,3
Milwaukee Brewers,1,New York Mets,5,2,April 15 2018,3
San Francisco Giants,1,San Diego Padres,11,1,April 15 2018,10
Oakland Athletics,0,Seattle Mariners,3,2,April 15 2018,1
Philadelphia Phillies,0,Tampa Bay Rays,14,10,April 15 2018,4
Colorado Rockies,0,Washington Nationals,11,6,April 15 2018,5
Philadelphia Phillies,1,Atlanta Braves,3,1,April 16 2018,2
Cincinnati Reds,0,Milwaukee Brewers,14,10,April 16 2018,4
Miami Marlins,1,New York Yankees,13,1,April 16 2018,12
Washington Nationals,0,New York Mets,14,8,April 16 2018,6
Chicago White Sox,1,Oakland Athletics,9,1,April 16 2018,8
Colorado Rockies,0,Pittsburgh Pirates,8,6,April 16 2018,2
Los Angeles Dodgers,0,San Diego Padres,13,10,April 16 2018,3
Houston Astros,1,Seattle Mariners,3,1,April 16 2018,2
Texas Rangers,1,Tampa Bay Rays,12,4,April 16 2018,8
Boston Red Sox,0,Los Angeles Angels,11,10,April 17 2018,1
San Francisco Giants,1,Arizona D'Backs,1,0,April 17 2018,1
Philadelphia Phillies,0,Atlanta Braves,6,5,April 17 2018,1
St. Louis Cardinals,0,Chicago Cubs,8,5,April 17 2018,3
Baltimore Orioles,1,Detroit Tigers,6,2,April 17 2018,4
Cincinnati Reds,1,Milwaukee Brewers,2,0,April 17 2018,2
Cleveland Indians,0,Minnesota Twins,7,6,April 17 2018,1
Miami Marlins,0,New York Yankees,10,9,April 17 2018,1
Washington Nationals,0,New York Mets,7,5,April 17 2018,2
Chicago White Sox,1,Oakland Athletics,12,2,April 17 2018,10
Colorado Rockies,0,Pittsburgh Pirates,2,2,April 17 2018,0
Los Angeles Dodgers,0,San Diego Padres,10,7,April 17 2018,3
Houston Astros,0,Seattle Mariners,5,4,April 17 2018,1
Texas Rangers,0,Tampa Bay Rays,9,7,April 17 2018,2
Kansas City Royals,1,Toronto Blue Jays,14,3,April 17 2018,11
Kansas City Royals,1,Toronto Blue Jays,9,4,April 17 2018,5
Boston Red Sox,0,Los Angeles Angels,9,9,April 18 2018,0
San Francisco Giants,0,Arizona D'Backs,7,4,April 18 2018,3
Philadelphia Phillies,1,Atlanta Braves,10,3,April 18 2018,7
Baltimore Orioles,1,Detroit Tigers,11,5,April 18 2018,6
Cincinnati Reds,1,Milwaukee Brewers,2,0,April 18 2018,2
Cleveland Indians,1,Minnesota Twins,3,1,April 18 2018,2
Washington Nationals,1,New York Mets,16,5,April 18 2018,11
Chicago White Sox,1,Oakland Athletics,23,11,April 18 2018,12
Colorado Rockies,1,Pittsburgh Pirates,12,2,April 18 2018,10
Los Angeles Dodgers,0,San Diego Padres,17,13,April 18 2018,4
Houston Astros,0,Seattle Mariners,8,7,April 18 2018,1
Texas Rangers,1,Tampa Bay Rays,6,2,April 18 2018,4
Kansas City Royals,1,Toronto Blue Jays,20,5,April 18 2018,15
Boston Red Sox,0,Los Angeles Angels,10,8,April 19 2018,2
San Francisco Giants,1,Arizona D'Backs,4,1,April 19 2018,3
New York Mets,1,Atlanta Braves,16,4,April 19 2018,12
St. Louis Cardinals,1,Chicago Cubs,13,5,April 19 2018,8
Baltimore Orioles,1,Detroit Tigers,21,8,April 19 2018,13
Miami Marlins,1,Milwaukee Brewers,15,3,April 19 2018,12
Toronto Blue Jays,1,New York Yankees,7,3,April 19 2018,4
Pittsburgh Pirates,1,Philadelphia Phillies,7,0,April 19 2018,7
Houston Astros,0,Seattle Mariners,11,9,April 19 2018,2
San Francisco Giants,0,Los Angeles Angels,9,8,April 20 2018,1
San Diego Padres,0,Arizona D'Backs,5,4,April 20 2018,1
New York Mets,0,Atlanta Braves,8,5,April 20 2018,3
Cleveland Indians,1,Baltimore Orioles,4,1,April 20 2018,3
Houston Astros,0,Chicago White Sox,10,10,April 20 2018,0
Chicago Cubs,0,Colorado Rockies,21,16,April 20 2018,5
Kansas City Royals,1,Detroit Tigers,5,2,April 20 2018,3
Kansas City Royals,0,Detroit Tigers,5,3,April 20 2018,2
Washington Nationals,0,Los Angeles Dodgers,7,5,April 20 2018,2
Miami Marlins,1,Milwaukee Brewers,8,0,April 20 2018,8
Toronto Blue Jays,0,New York Yankees,13,8,April 20 2018,5
Boston Red Sox,0,Oakland Athletics,10,7,April 20 2018,3
Pittsburgh Pirates,1,Philadelphia Phillies,3,1,April 20 2018,2
Cincinnati Reds,1,St. Louis Cardinals,6,2,April 20 2018,4
Minnesota Twins,1,Tampa Bay Rays,15,7,April 20 2018,8
Seattle Mariners,0,Texas Rangers,8,6,April 20 2018,2
San Francisco Giants,1,Los Angeles Angels,7,3,April 21 2018,4
San Diego Padres,1,Arizona D'Backs,8,2,April 21 2018,6
New York Mets,1,Atlanta Braves,7,3,April 21 2018,4
Cleveland Indians,0,Baltimore Orioles,4,4,April 21 2018,0
Houston Astros,0,Chicago White Sox,11,10,April 21 2018,1
Chicago Cubs,1,Colorado Rockies,7,2,April 21 2018,5
Kansas City Royals,1,Detroit Tigers,16,4,April 21 2018,12
Washington Nationals,1,Los Angeles Dodgers,4,0,April 21 2018,4
Miami Marlins,1,Milwaukee Brewers,11,5,April 21 2018,6
Toronto Blue Jays,1,New York Yankees,10,1,April 21 2018,9
Boston Red Sox,1,Oakland Athletics,3,0,April 21 2018,3
Pittsburgh Pirates,1,Philadelphia Phillies,8,2,April 21 2018,6
Cincinnati Reds,1,St. Louis Cardinals,7,3,April 21 2018,4
Minnesota Twins,1,Tampa Bay Rays,11,1,April 21 2018,10
Seattle Mariners,0,Texas Rangers,16,9,April 21 2018,7
San Francisco Giants,0,Los Angeles Angels,6,4,April 22 2018,2
San Diego Padres,1,Arizona D'Backs,6,2,April 22 2018,4
Cleveland Indians,0,Baltimore Orioles,10,7,April 22 2018,3
Houston Astros,0,Chicago White Sox,8,7,April 22 2018,1
Chicago Cubs,0,Colorado Rockies,16,9,April 22 2018,7
Kansas City Royals,0,Detroit Tigers,13,8,April 22 2018,5
Washington Nationals,1,Los Angeles Dodgers,7,3,April 22 2018,4
Miami Marlins,1,Milwaukee Brewers,6,2,April 22 2018,4
Toronto Blue Jays,1,New York Yankees,6,1,April 22 2018,5
Boston Red Sox,1,Oakland Athletics,5,1,April 22 2018,4
Pittsburgh Pirates,1,Philadelphia Phillies,5,2,April 22 2018,3
Cincinnati Reds,1,St. Louis Cardinals,11,2,April 22 2018,9
Minnesota Twins,1,Tampa Bay Rays,14,6,April 22 2018,8
Seattle Mariners,1,Texas Rangers,11,4,April 22 2018,7
Cleveland Indians,0,Baltimore Orioles,3,2,April 23 2018,1
Seattle Mariners,1,Chicago White Sox,14,4,April 23 2018,10
Atlanta Braves,1,Cincinnati Reds,14,4,April 23 2018,10
San Diego Padres,0,Colorado Rockies,18,13,April 23 2018,5
Los Angeles Angels,0,Houston Astros,2,2,April 23 2018,0
Miami Marlins,1,Los Angeles Dodgers,3,1,April 23 2018,2
Minnesota Twins,1,New York Yankees,15,1,April 23 2018,14
Washington Nationals,1,San Francisco Giants,6,2,April 23 2018,4
Oakland Athletics,0,Texas Rangers,13,9,April 23 2018,4
Seattle Mariners,0,Chicago White Sox,1,1,April 24 2018,0
Atlanta Braves,1,Cincinnati Reds,16,7,April 24 2018,9
Chicago Cubs,0,Cleveland Indians,13,10,April 24 2018,3
San Diego Padres,1,Colorado Rockies,8,0,April 24 2018,8
Los Angeles Angels,0,Houston Astros,15,8,April 24 2018,7
Milwaukee Brewers,0,Kansas City Royals,7,5,April 24 2018,2
Miami Marlins,0,Los Angeles Dodgers,5,3,April 24 2018,2
Minnesota Twins,1,New York Yankees,11,3,April 24 2018,8
Arizona D'Backs,0,Philadelphia Phillies,12,8,April 24 2018,4
Washington Nationals,1,San Francisco Giants,7,3,April 24 2018,4
New York Mets,0,St. Louis Cardinals,11,6,April 24 2018,5
Oakland Athletics,0,Texas Rangers,5,3,April 24 2018,2
Boston Red Sox,1,Toronto Blue Jays,7,3,April 24 2018,4
Tampa Bay Rays,0,Baltimore Orioles,12,8,April 25 2018,4
Seattle Mariners,0,Chicago White Sox,7,4,April 25 2018,3
Atlanta Braves,0,Cincinnati Reds,9,5,April 25 2018,4
Chicago Cubs,1,Cleveland Indians,5,1,April 25 2018,4
San Diego Padres,1,Colorado Rockies,7,2,April 25 2018,5
Los Angeles Angels,1,Houston Astros,7,2,April 25 2018,5
Milwaukee Brewers,0,Kansas City Royals,8,6,April 25 2018,2
Miami Marlins,0,Los Angeles Dodgers,14,8,April 25 2018,6
Minnesota Twins,1,New York Yankees,11,4,April 25 2018,7
Arizona D'Backs,1,Philadelphia Phillies,8,3,April 25 2018,5
Detroit Tigers,0,Pittsburgh Pirates,23,13,April 25 2018,10
Detroit Tigers,1,Pittsburgh Pirates,11,3,April 25 2018,8
Washington Nationals,0,San Francisco Giants,17,15,April 25 2018,2
New York Mets,1,St. Louis Cardinals,10,1,April 25 2018,9
Oakland Athletics,1,Texas Rangers,6,2,April 25 2018,4
Boston Red Sox,0,Toronto Blue Jays,7,4,April 25 2018,3
Tampa Bay Rays,0,Baltimore Orioles,14,9,April 26 2018,5
Milwaukee Brewers,1,Chicago Cubs,1,0,April 26 2018,1
Atlanta Braves,0,Cincinnati Reds,11,7,April 26 2018,4
Seattle Mariners,0,Cleveland Indians,9,5,April 26 2018,4
Chicago White Sox,0,Kansas City Royals,9,6,April 26 2018,3
Minnesota Twins,1,New York Yankees,7,3,April 26 2018,4
Arizona D'Backs,0,Philadelphia Phillies,10,8,April 26 2018,2
Detroit Tigers,1,Pittsburgh Pirates,1,0,April 26 2018,1
New York Mets,1,St. Louis Cardinals,7,3,April 26 2018,4
Boston Red Sox,0,Toronto Blue Jays,9,5,April 26 2018,4
New York Yankees,0,Los Angeles Angels,7,4,April 27 2018,3
Detroit Tigers,1,Baltimore Orioles,6,0,April 27 2018,6
Tampa Bay Rays,0,Boston Red Sox,7,4,April 27 2018,3
Milwaukee Brewers,1,Chicago Cubs,5,2,April 27 2018,3
Seattle Mariners,1,Cleveland Indians,11,5,April 27 2018,6
Oakland Athletics,0,Houston Astros,9,8,April 27 2018,1
Chicago White Sox,0,Kansas City Royals,11,7,April 27 2018,4
Colorado Rockies,0,Miami Marlins,1,1,April 27 2018,0
Cincinnati Reds,0,Minnesota Twins,24,15,April 27 2018,9
Atlanta Braves,1,Philadelphia Phillies,10,3,April 27 2018,7
St. Louis Cardinals,1,Pittsburgh Pirates,11,5,April 27 2018,6
New York Mets,0,San Diego Padres,6,5,April 27 2018,1
Los Angeles Dodgers,1,San Francisco Giants,10,4,April 27 2018,6
Texas Rangers,0,Toronto Blue Jays,10,6,April 27 2018,4
Arizona D'Backs,0,Washington Nationals,9,5,April 27 2018,4
New York Yankees,0,Los Angeles Angels,12,11,April 28 2018,1
Detroit Tigers,0,Baltimore Orioles,14,9,April 28 2018,5
Tampa Bay Rays,0,Boston Red Sox,18,12,April 28 2018,6
Milwaukee Brewers,1,Chicago Cubs,3,0,April 28 2018,3
Seattle Mariners,0,Cleveland Indians,16,12,April 28 2018,4
Oakland Athletics,1,Houston Astros,11,0,April 28 2018,11
Chicago White Sox,0,Kansas City Royals,8,8,April 28 2018,0
Chicago White Sox,1,Kansas City Royals,7,2,April 28 2018,5
Colorado Rockies,1,Miami Marlins,5,1,April 28 2018,4
Cincinnati Reds,1,Minnesota Twins,4,1,April 28 2018,3
Atlanta Braves,0,Philadelphia Phillies,5,4,April 28 2018,1
St. Louis Cardinals,1,Pittsburgh Pirates,8,2,April 28 2018,6
New York Mets,1,San Diego Padres,14,2,April 28 2018,12
Los Angeles Dodgers,0,San Francisco Giants,21,15,April 28 2018,6
Los Angeles Dodgers,1,San Francisco Giants,11,3,April 28 2018,8
Texas Rangers,0,Toronto Blue Jays,11,7,April 28 2018,4
Arizona D'Backs,0,Washington Nationals,7,4,April 28 2018,3
New York Yankees,0,Los Angeles Angels,3,2,April 29 2018,1
Detroit Tigers,1,Baltimore Orioles,8,3,April 29 2018,5
Tampa Bay Rays,1,Boston Red Sox,7,3,April 29 2018,4
Milwaukee Brewers,1,Chicago Cubs,2,0,April 29 2018,2
Seattle Mariners,0,Cleveland Indians,14,10,April 29 2018,4
Oakland Athletics,1,Houston Astros,12,4,April 29 2018,8
Chicago White Sox,1,Kansas City Royals,9,4,April 29 2018,5
Colorado Rockies,1,Miami Marlins,3,0,April 29 2018,3
Cincinnati Reds,0,Minnesota Twins,10,8,April 29 2018,2
Atlanta Braves,0,Philadelphia Phillies,11,10,April 29 2018,1
St. Louis Cardinals,1,Pittsburgh Pirates,5,0,April 29 2018,5
New York Mets,0,San Diego Padres,16,14,April 29 2018,2
Los Angeles Dodgers,1,San Francisco Giants,6,2,April 29 2018,4
Texas Rangers,1,Toronto Blue Jays,9,2,April 29 2018,7
Arizona D'Backs,1,Washington Nationals,4,1,April 29 2018,3
Los Angeles Dodgers,1,Arizona D'Backs,13,5,April 30 2018,8
Kansas City Royals,1,Boston Red Sox,16,6,April 30 2018,10
Colorado Rockies,1,Chicago Cubs,5,2,April 30 2018,3
Milwaukee Brewers,0,Cincinnati Reds,11,6,April 30 2018,5
Texas Rangers,1,Cleveland Indians,12,5,April 30 2018,7
Tampa Bay Rays,0,Detroit Tigers,5,3,April 30 2018,2
New York Yankees,1,Houston Astros,3,1,April 30 2018,2
Philadelphia Phillies,1,Miami Marlins,12,4,April 30 2018,8
Toronto Blue Jays,0,Minnesota Twins,12,7,April 30 2018,5
San Diego Padres,1,San Francisco Giants,11,5,April 30 2018,6
Pittsburgh Pirates,1,Washington Nationals,5,2,April 30 2018,3
Baltimore Orioles,1,Los Angeles Angels,5,2,May 1 2018,3
Los Angeles Dodgers,1,Arizona D'Backs,7,3,May 1 2018,4
Kansas City Royals,0,Boston Red Sox,13,7,May 1 2018,6
Colorado Rockies,0,Chicago Cubs,4,3,May 1 2018,1
Milwaukee Brewers,0,Cincinnati Reds,13,7,May 1 2018,6
Texas Rangers,0,Cleveland Indians,14,8,May 1 2018,6
Tampa Bay Rays,1,Detroit Tigers,3,1,May 1 2018,2
New York Yankees,0,Houston Astros,4,4,May 1 2018,0
Philadelphia Phillies,1,Miami Marlins,3,1,May 1 2018,2
Toronto Blue Jays,0,Minnesota Twins,11,7,May 1 2018,4
Atlanta Braves,0,New York Mets,5,3,May 1 2018,2
Oakland Athletics,1,Seattle Mariners,9,3,May 1 2018,6
San Diego Padres,0,San Francisco Giants,5,3,May 1 2018,2
Chicago White Sox,1,St. Louis Cardinals,5,2,May 1 2018,3
Pittsburgh Pirates,1,Washington Nationals,16,4,May 1 2018,12
Baltimore Orioles,1,Los Angeles Angels,17,7,May 2 2018,10
Los Angeles Dodgers,0,Arizona D'Backs,3,2,May 2 2018,1
Kansas City Royals,1,Boston Red Sox,9,4,May 2 2018,5
Colorado Rockies,0,Chicago Cubs,13,11,May 2 2018,2
Milwaukee Brewers,0,Cincinnati Reds,4,3,May 2 2018,1
Texas Rangers,1,Cleveland Indians,16,4,May 2 2018,12
Tampa Bay Rays,1,Detroit Tigers,5,2,May 2 2018,3
New York Yankees,0,Houston Astros,4,4,May 2 2018,0
Philadelphia Phillies,0,Miami Marlins,6,6,May 2 2018,0
Toronto Blue Jays,1,Minnesota Twins,4,0,May 2 2018,4
Atlanta Braves,0,New York Mets,7,7,May 2 2018,0
Oakland Athletics,0,Seattle Mariners,5,3,May 2 2018,2
San Diego Padres,1,San Francisco Giants,13,4,May 2 2018,9
Chicago White Sox,1,St. Louis Cardinals,5,2,May 2 2018,3
Pittsburgh Pirates,1,Washington Nationals,12,3,May 2 2018,9
Baltimore Orioles,1,Los Angeles Angels,15,3,May 3 2018,12
Los Angeles Dodgers,0,Arizona D'Backs,7,5,May 3 2018,2
Minnesota Twins,1,Chicago White Sox,11,5,May 3 2018,6
Toronto Blue Jays,0,Cleveland Indians,24,13,May 3 2018,11
Toronto Blue Jays,1,Cleveland Indians,17,4,May 3 2018,13
New York Yankees,0,Houston Astros,11,6,May 3 2018,5
Detroit Tigers,1,Kansas City Royals,16,6,May 3 2018,10
Atlanta Braves,0,New York Mets,11,11,May 3 2018,0
Oakland Athletics,1,Seattle Mariners,5,1,May 3 2018,4
Boston Red Sox,1,Texas Rangers,16,5,May 3 2018,11
Pittsburgh Pirates,1,Washington Nationals,4,1,May 3 2018,3
Houston Astros,0,Arizona D'Backs,8,8,May 4 2018,0
San Francisco Giants,0,Atlanta Braves,13,9,May 4 2018,4
Minnesota Twins,0,Chicago White Sox,10,6,May 4 2018,4
Miami Marlins,1,Cincinnati Reds,5,1,May 4 2018,4
Detroit Tigers,1,Kansas City Royals,6,2,May 4 2018,4
Pittsburgh Pirates,0,Milwaukee Brewers,10,6,May 4 2018,4
Cleveland Indians,1,New York Yankees,13,6,May 4 2018,7
Colorado Rockies,0,New York Mets,15,8,May 4 2018,7
Baltimore Orioles,1,Oakland Athletics,10,4,May 4 2018,6
Los Angeles Dodgers,0,San Diego Padres,4,4,May 4 2018,0
Los Angeles Angels,0,Seattle Mariners,5,5,May 4 2018,0
Chicago Cubs,1,St. Louis Cardinals,5,2,May 4 2018,3
Toronto Blue Jays,1,Tampa Bay Rays,8,2,May 4 2018,6
Boston Red Sox,0,Texas Rangers,6,5,May 4 2018,1
Philadelphia Phillies,1,Washington Nationals,10,3,May 4 2018,7
Houston Astros,1,Arizona D'Backs,7,3,May 5 2018,4
San Francisco Giants,0,Atlanta Braves,13,11,May 5 2018,2
Minnesota Twins,0,Chicago White Sox,12,8,May 5 2018,4
Miami Marlins,0,Cincinnati Reds,6,6,May 5 2018,0
Detroit Tigers,0,Kansas City Royals,5,3,May 5 2018,2
Pittsburgh Pirates,1,Milwaukee Brewers,8,3,May 5 2018,5
Cleveland Indians,1,New York Yankees,7,2,May 5 2018,5
Colorado Rockies,0,New York Mets,2,2,May 5 2018,0
Baltimore Orioles,1,Oakland Athletics,2,0,May 5 2018,2
Los Angeles Dodgers,1,San Diego Padres,11,4,May 5 2018,7
Los Angeles Angels,1,Seattle Mariners,17,8,May 5 2018,9
Chicago Cubs,1,St. Louis Cardinals,14,6,May 5 2018,8
Toronto Blue Jays,1,Tampa Bay Rays,8,3,May 5 2018,5
Boston Red Sox,0,Texas Rangers,11,6,May 5 2018,5
Philadelphia Phillies,0,Washington Nationals,4,3,May 5 2018,1
Houston Astros,1,Arizona D'Backs,4,1,May 6 2018,3
San Francisco Giants,0,Atlanta Braves,7,4,May 6 2018,3
Minnesota Twins,0,Chicago White Sox,8,5,May 6 2018,3
Miami Marlins,0,Cincinnati Reds,13,8,May 6 2018,5
Detroit Tigers,1,Kansas City Royals,6,2,May 6 2018,4
Pittsburgh Pirates,0,Milwaukee Brewers,9,9,May 6 2018,0
Cleveland Indians,1,New York Yankees,11,4,May 6 2018,7
Colorado Rockies,0,New York Mets,5,3,May 6 2018,2
Baltimore Orioles,1,Oakland Athletics,3,1,May 6 2018,2
Los Angeles Dodgers,1,San Diego Padres,3,0,May 6 2018,3
Los Angeles Angels,0,Seattle Mariners,10,8,May 6 2018,2
Chicago Cubs,1,St. Louis Cardinals,7,3,May 6 2018,4
Toronto Blue Jays,0,Tampa Bay Rays,3,2,May 6 2018,1
Boston Red Sox,0,Texas Rangers,7,6,May 6 2018,1
Philadelphia Phillies,1,Washington Nationals,9,4,May 6 2018,5
Miami Marlins,1,Chicago Cubs,16,2,May 7 2018,14
New York Mets,0,Cincinnati Reds,13,7,May 7 2018,6
Houston Astros,0,Oakland Athletics,18,16,May 7 2018,2
San Francisco Giants,1,Philadelphia Phillies,11,0,May 7 2018,11
Washington Nationals,0,San Diego Padres,13,8,May 7 2018,5
Minnesota Twins,0,St. Louis Cardinals,6,6,May 7 2018,0
Detroit Tigers,1,Texas Rangers,13,6,May 7 2018,7
Kansas City Royals,0,Baltimore Orioles,22,15,May 8 2018,7
Pittsburgh Pirates,0,Chicago White Sox,16,10,May 8 2018,6
Miami Marlins,1,Chicago Cubs,7,3,May 8 2018,4
New York Mets,1,Cincinnati Reds,9,2,May 8 2018,7
Los Angeles Angels,1,Colorado Rockies,6,2,May 8 2018,4
Arizona D'Backs,0,Los Angeles Dodgers,13,8,May 8 2018,5
Cleveland Indians,1,Milwaukee Brewers,5,2,May 8 2018,3
Boston Red Sox,1,New York Yankees,5,2,May 8 2018,3
Houston Astros,0,Oakland Athletics,6,4,May 8 2018,2
San Francisco Giants,1,Philadelphia Phillies,6,2,May 8 2018,4
Washington Nationals,0,San Diego Padres,4,4,May 8 2018,0
Minnesota Twins,0,St. Louis Cardinals,8,7,May 8 2018,1
Atlanta Braves,0,Tampa Bay Rays,1,1,May 8 2018,0
Detroit Tigers,0,Texas Rangers,11,7,May 8 2018,4
Seattle Mariners,0,Toronto Blue Jays,5,5,May 8 2018,0
Kansas City Royals,1,Baltimore Orioles,8,3,May 9 2018,5
Pittsburgh Pirates,0,Chicago White Sox,11,6,May 9 2018,5
Miami Marlins,1,Chicago Cubs,17,4,May 9 2018,13
New York Mets,1,Cincinnati Reds,3,1,May 9 2018,2
Los Angeles Angels,0,Colorado Rockies,8,8,May 9 2018,0
Arizona D'Backs,1,Los Angeles Dodgers,9,3,May 9 2018,6
Cleveland Indians,0,Milwaukee Brewers,8,6,May 9 2018,2
Boston Red Sox,1,New York Yankees,15,6,May 9 2018,9
Houston Astros,0,Oakland Athletics,5,4,May 9 2018,1
San Francisco Giants,1,Philadelphia Phillies,14,3,May 9 2018,11
Washington Nationals,1,San Diego Padres,3,1,May 9 2018,2
Atlanta Braves,0,Tampa Bay Rays,7,5,May 9 2018,2
Detroit Tigers,1,Texas Rangers,9,4,May 9 2018,5
Seattle Mariners,1,Toronto Blue Jays,7,2,May 9 2018,5
Minnesota Twins,1,Los Angeles Angels,11,4,May 10 2018,7
Washington Nationals,0,Arizona D'Backs,3,2,May 10 2018,1
Kansas City Royals,1,Baltimore Orioles,17,6,May 10 2018,11
Milwaukee Brewers,0,Colorado Rockies,7,5,May 10 2018,2
Cincinnati Reds,0,Los Angeles Dodgers,5,4,May 10 2018,1
Atlanta Braves,0,Miami Marlins,11,9,May 10 2018,2
Boston Red Sox,0,New York Yankees,9,5,May 10 2018,4
San Francisco Giants,1,Philadelphia Phillies,9,3,May 10 2018,6
St. Louis Cardinals,0,San Diego Padres,3,2,May 10 2018,1
Seattle Mariners,0,Toronto Blue Jays,12,9,May 10 2018,3
Minnesota Twins,0,Los Angeles Angels,9,5,May 11 2018,4
Washington Nationals,0,Arizona D'Backs,4,3,May 11 2018,1
Tampa Bay Rays,1,Baltimore Orioles,13,4,May 11 2018,9
Chicago White Sox,1,Chicago Cubs,13,2,May 11 2018,11
Kansas City Royals,0,Cleveland Indians,19,10,May 11 2018,9
Milwaukee Brewers,0,Colorado Rockies,21,11,May 11 2018,10
Texas Rangers,0,Houston Astros,1,1,May 11 2018,0
Cincinnati Reds,0,Los Angeles Dodgers,8,6,May 11 2018,2
Atlanta Braves,1,Miami Marlins,9,3,May 11 2018,6
Oakland Athletics,0,New York Yankees,15,10,May 11 2018,5
New York Mets,0,Philadelphia Phillies,4,3,May 11 2018,1
San Francisco Giants,1,Pittsburgh Pirates,13,2,May 11 2018,11
St. Louis Cardinals,0,San Diego Padres,14,9,May 11 2018,5
Boston Red Sox,1,Toronto Blue Jays,8,3,May 11 2018,5
Minnesota Twins,0,Los Angeles Angels,8,5,May 12 2018,3
Washington Nationals,0,Arizona D'Backs,3,2,May 12 2018,1
Tampa Bay Rays,1,Baltimore Orioles,9,3,May 12 2018,6
Tampa Bay Rays,0,Baltimore Orioles,13,10,May 12 2018,3
Chicago White Sox,1,Chicago Cubs,12,4,May 12 2018,8
Kansas City Royals,1,Cleveland Indians,8,2,May 12 2018,6
Milwaukee Brewers,1,Colorado Rockies,4,0,May 12 2018,4
Seattle Mariners,1,Detroit Tigers,7,3,May 12 2018,4
Seattle Mariners,0,Detroit Tigers,14,9,May 12 2018,5
Texas Rangers,1,Houston Astros,7,1,May 12 2018,6
Cincinnati Reds,0,Los Angeles Dodgers,8,5,May 12 2018,3
Atlanta Braves,0,Miami Marlins,15,10,May 12 2018,5
Oakland Athletics,1,New York Yankees,13,6,May 12 2018,7
San Francisco Giants,1,Pittsburgh Pirates,11,5,May 12 2018,6
St. Louis Cardinals,1,San Diego Padres,3,1,May 12 2018,2
Boston Red Sox,0,Toronto Blue Jays,7,5,May 12 2018,2
Minnesota Twins,1,Los Angeles Angels,3,1,May 13 2018,2
Washington Nationals,0,Arizona D'Backs,10,6,May 13 2018,4
Tampa Bay Rays,1,Baltimore Orioles,18,1,May 13 2018,17
Chicago White Sox,0,Chicago Cubs,8,5,May 13 2018,3
Kansas City Royals,1,Cleveland Indians,13,2,May 13 2018,11
Milwaukee Brewers,0,Colorado Rockies,10,7,May 13 2018,3
Seattle Mariners,1,Detroit Tigers,9,4,May 13 2018,5
Texas Rangers,1,Houston Astros,7,1,May 13 2018,6
Cincinnati Reds,0,Los Angeles Dodgers,8,5,May 13 2018,3
Atlanta Braves,0,Miami Marlins,7,4,May 13 2018,3
Oakland Athletics,1,New York Yankees,8,2,May 13 2018,6
New York Mets,1,Philadelphia Phillies,6,2,May 13 2018,4
San Francisco Giants,0,Pittsburgh Pirates,5,5,May 13 2018,0
St. Louis Cardinals,1,San Diego Padres,8,3,May 13 2018,5
Boston Red Sox,0,Toronto Blue Jays,8,5,May 13 2018,3
Houston Astros,1,Los Angeles Angels,3,1,May 14 2018,2
Milwaukee Brewers,0,Arizona D'Backs,9,7,May 14 2018,2
Oakland Athletics,0,Boston Red Sox,11,6,May 14 2018,5
Atlanta Braves,0,Chicago Cubs,11,6,May 14 2018,5
Cleveland Indians,1,Detroit Tigers,9,3,May 14 2018,6
Tampa Bay Rays,0,Kansas City Royals,3,2,May 14 2018,1
Seattle Mariners,0,Minnesota Twins,1,1,May 14 2018,0
Colorado Rockies,0,San Diego Padres,10,6,May 14 2018,4
Cincinnati Reds,1,San Francisco Giants,17,7,May 14 2018,10
Houston Astros,0,Los Angeles Angels,8,5,May 15 2018,3
Milwaukee Brewers,1,Arizona D'Backs,3,1,May 15 2018,2
Chicago Cubs,0,Atlanta Braves,5,3,May 15 2018,2
Oakland Athletics,0,Boston Red Sox,8,5,May 15 2018,3
Cleveland Indians,1,Detroit Tigers,17,8,May 15 2018,9
Tampa Bay Rays,0,Kansas City Royals,11,6,May 15 2018,5
Los Angeles Dodgers,1,Miami Marlins,6,2,May 15 2018,4
St. Louis Cardinals,1,Minnesota Twins,5,1,May 15 2018,4
Toronto Blue Jays,1,New York Mets,14,2,May 15 2018,12
Chicago White Sox,1,Pittsburgh Pirates,7,0,May 15 2018,7
Colorado Rockies,1,San Diego Padres,4,0,May 15 2018,4
Texas Rangers,1,Seattle Mariners,17,8,May 15 2018,9
Cincinnati Reds,1,San Francisco Giants,8,3,May 15 2018,5
New York Yankees,1,Washington Nationals,8,3,May 15 2018,5
Houston Astros,0,Los Angeles Angels,2,2,May 16 2018,0
Milwaukee Brewers,0,Arizona D'Backs,10,8,May 16 2018,2
Chicago Cubs,1,Atlanta Braves,5,1,May 16 2018,4
Philadelphia Phillies,0,Baltimore Orioles,5,4,May 16 2018,1
Oakland Athletics,1,Boston Red Sox,10,4,May 16 2018,6
Cleveland Indians,0,Detroit Tigers,6,6,May 16 2018,0
Tampa Bay Rays,0,Kansas City Royals,8,5,May 16 2018,3
Los Angeles Dodgers,1,Miami Marlins,11,5,May 16 2018,6
St. Louis Cardinals,0,Minnesota Twins,12,7,May 16 2018,5
Toronto Blue Jays,0,New York Mets,13,12,May 16 2018,1
Chicago White Sox,1,Pittsburgh Pirates,5,2,May 16 2018,3
Texas Rangers,0,Seattle Mariners,6,5,May 16 2018,1
Cincinnati Reds,0,San Francisco Giants,9,6,May 16 2018,3
Tampa Bay Rays,0,Los Angeles Angels,8,7,May 17 2018,1
Baltimore Orioles,1,Boston Red Sox,8,2,May 17 2018,6
Texas Rangers,1,Chicago White Sox,6,2,May 17 2018,4
Los Angeles Dodgers,0,Miami Marlins,7,7,May 17 2018,0
San Diego Padres,1,Pittsburgh Pirates,9,4,May 17 2018,5
Detroit Tigers,0,Seattle Mariners,5,3,May 17 2018,2
Colorado Rockies,0,San Francisco Giants,8,5,May 17 2018,3
Philadelphia Phillies,0,St. Louis Cardinals,8,6,May 17 2018,2
Oakland Athletics,0,Toronto Blue Jays,15,10,May 17 2018,5
Tampa Bay Rays,0,Los Angeles Angels,11,8,May 18 2018,3
Miami Marlins,0,Atlanta Braves,2,2,May 18 2018,0
Baltimore Orioles,0,Boston Red Sox,11,7,May 18 2018,4
Texas Rangers,0,Chicago White Sox,17,12,May 18 2018,5
Chicago Cubs,0,Cincinnati Reds,9,8,May 18 2018,1
Cleveland Indians,1,Houston Astros,5,1,May 18 2018,4
New York Yankees,1,Kansas City Royals,7,2,May 18 2018,5
Milwaukee Brewers,0,Minnesota Twins,11,8,May 18 2018,3
Arizona D'Backs,1,New York Mets,4,1,May 18 2018,3
San Diego Padres,0,Pittsburgh Pirates,5,3,May 18 2018,2
Detroit Tigers,1,Seattle Mariners,9,4,May 18 2018,5
Colorado Rockies,0,San Francisco Giants,7,6,May 18 2018,1
Philadelphia Phillies,1,St. Louis Cardinals,16,4,May 18 2018,12
Oakland Athletics,0,Toronto Blue Jays,4,3,May 18 2018,1
Tampa Bay Rays,0,Los Angeles Angels,8,5,May 19 2018,3
Miami Marlins,1,Atlanta Braves,9,1,May 19 2018,8
Baltimore Orioles,1,Boston Red Sox,9,3,May 19 2018,6
Texas Rangers,1,Chicago White Sox,8,3,May 19 2018,5
Chicago Cubs,1,Cincinnati Reds,9,4,May 19 2018,5
Chicago Cubs,0,Cincinnati Reds,10,10,May 19 2018,0
Cleveland Indians,0,Houston Astros,9,5,May 19 2018,4
New York Yankees,0,Kansas City Royals,11,8,May 19 2018,3
Milwaukee Brewers,0,Minnesota Twins,9,5,May 19 2018,4
Arizona D'Backs,1,New York Mets,9,4,May 19 2018,5
San Diego Padres,0,Pittsburgh Pirates,8,6,May 19 2018,2
Detroit Tigers,1,Seattle Mariners,9,2,May 19 2018,7
Colorado Rockies,1,San Francisco Giants,13,4,May 19 2018,9
Philadelphia Phillies,0,St. Louis Cardinals,13,7,May 19 2018,6
Oakland Athletics,0,Toronto Blue Jays,9,5,May 19 2018,4
Los Angeles Dodgers,0,Washington Nationals,5,4,May 19 2018,1
Los Angeles Dodgers,0,Washington Nationals,9,5,May 19 2018,4
Tampa Bay Rays,1,Los Angeles Angels,7,2,May 20 2018,5
Miami Marlins,1,Atlanta Braves,19,9,May 20 2018,10
Baltimore Orioles,1,Boston Red Sox,5,0,May 20 2018,5
Texas Rangers,1,Chicago White Sox,3,0,May 20 2018,3
Chicago Cubs,0,Cincinnati Reds,7,6,May 20 2018,1
Cleveland Indians,1,Houston Astros,4,1,May 20 2018,3
New York Yankees,0,Kansas City Royals,11,10,May 20 2018,1
Milwaukee Brewers,1,Minnesota Twins,4,1,May 20 2018,3
Arizona D'Backs,1,New York Mets,5,1,May 20 2018,4
San Diego Padres,0,Pittsburgh Pirates,13,8,May 20 2018,5
Detroit Tigers,1,Seattle Mariners,5,2,May 20 2018,3
Colorado Rockies,1,San Francisco Giants,14,5,May 20 2018,9
Philadelphia Phillies,1,St. Louis Cardinals,6,1,May 20 2018,5
Oakland Athletics,0,Toronto Blue Jays,11,9,May 20 2018,2
Los Angeles Dodgers,0,Washington Nationals,9,7,May 20 2018,2
Baltimore Orioles,0,Chicago White Sox,5,3,May 21 2018,2
Colorado Rockies,0,Los Angeles Dodgers,3,2,May 21 2018,1
Arizona D'Backs,1,Milwaukee Brewers,6,2,May 21 2018,4
Detroit Tigers,1,Minnesota Twins,6,2,May 21 2018,4
Miami Marlins,1,New York Mets,2,0,May 21 2018,2
Atlanta Braves,1,Philadelphia Phillies,3,0,May 21 2018,3
Kansas City Royals,1,St. Louis Cardinals,6,0,May 21 2018,6
New York Yankees,0,Texas Rangers,15,10,May 21 2018,5
San Diego Padres,1,Washington Nationals,12,2,May 21 2018,10
Baltimore Orioles,1,Chicago White Sox,5,2,May 22 2018,3
Cleveland Indians,0,Chicago Cubs,11,10,May 22 2018,1
Pittsburgh Pirates,1,Cincinnati Reds,9,2,May 22 2018,7
San Francisco Giants,1,Houston Astros,13,2,May 22 2018,11
Colorado Rockies,1,Los Angeles Dodgers,8,3,May 22 2018,5
Arizona D'Backs,1,Milwaukee Brewers,1,0,May 22 2018,1
Detroit Tigers,1,Minnesota Twins,6,0,May 22 2018,6
Miami Marlins,0,New York Mets,6,5,May 22 2018,1
Seattle Mariners,0,Oakland Athletics,5,3,May 22 2018,2
Atlanta Braves,0,Philadelphia Phillies,4,3,May 22 2018,1
Kansas City Royals,0,St. Louis Cardinals,6,5,May 22 2018,1
Boston Red Sox,0,Tampa Bay Rays,6,4,May 22 2018,2
New York Yankees,1,Texas Rangers,10,4,May 22 2018,6
Los Angeles Angels,1,Toronto Blue Jays,8,3,May 22 2018,5
San Diego Padres,1,Washington Nationals,3,1,May 22 2018,2
Baltimore Orioles,1,Chicago White Sox,12,1,May 23 2018,11
Cleveland Indians,0,Chicago Cubs,1,1,May 23 2018,0
Pittsburgh Pirates,0,Cincinnati Reds,9,5,May 23 2018,4
San Francisco Giants,1,Houston Astros,5,1,May 23 2018,4
Colorado Rockies,1,Los Angeles Dodgers,3,0,May 23 2018,3
Arizona D'Backs,1,Milwaukee Brewers,11,2,May 23 2018,9
Detroit Tigers,0,Minnesota Twins,5,4,May 23 2018,1
Miami Marlins,0,New York Mets,3,2,May 23 2018,1
Seattle Mariners,0,Oakland Athletics,1,1,May 23 2018,0
Atlanta Braves,1,Philadelphia Phillies,4,0,May 23 2018,4
Kansas City Royals,0,St. Louis Cardinals,7,5,May 23 2018,2
Boston Red Sox,0,Tampa Bay Rays,5,4,May 23 2018,1
New York Yankees,1,Texas Rangers,22,10,May 23 2018,12
Los Angeles Angels,0,Toronto Blue Jays,9,5,May 23 2018,4
San Diego Padres,0,Washington Nationals,4,3,May 23 2018,1
Baltimore Orioles,0,Chicago White Sox,12,9,May 24 2018,3
Pittsburgh Pirates,1,Cincinnati Reds,9,4,May 24 2018,5
Houston Astros,0,Cleveland Indians,10,8,May 24 2018,2
New York Mets,0,Milwaukee Brewers,5,5,May 24 2018,0
Seattle Mariners,1,Oakland Athletics,7,3,May 24 2018,4
Boston Red Sox,1,Tampa Bay Rays,9,3,May 24 2018,6
Kansas City Royals,0,Texas Rangers,10,8,May 24 2018,2
Los Angeles Angels,0,Toronto Blue Jays,9,8,May 24 2018,1
Atlanta Braves,1,Boston Red Sox,8,2,May 25 2018,6
San Francisco Giants,1,Chicago Cubs,8,2,May 25 2018,6
Houston Astros,0,Cleveland Indians,13,11,May 25 2018,2
Cincinnati Reds,1,Colorado Rockies,9,4,May 25 2018,5
Chicago White Sox,1,Detroit Tigers,9,4,May 25 2018,5
San Diego Padres,1,Los Angeles Dodgers,5,1,May 25 2018,4
Washington Nationals,0,Miami Marlins,14,9,May 25 2018,5
New York Mets,1,Milwaukee Brewers,7,3,May 25 2018,4
Los Angeles Angels,1,New York Yankees,3,1,May 25 2018,2
Arizona D'Backs,0,Oakland Athletics,8,7,May 25 2018,1
Toronto Blue Jays,0,Philadelphia Phillies,11,6,May 25 2018,5
St. Louis Cardinals,1,Pittsburgh Pirates,9,1,May 25 2018,8
Minnesota Twins,1,Seattle Mariners,3,1,May 25 2018,2
Baltimore Orioles,0,Tampa Bay Rays,2,2,May 25 2018,0
Kansas City Royals,1,Texas Rangers,12,4,May 25 2018,8
Atlanta Braves,1,Boston Red Sox,14,6,May 26 2018,8
San Francisco Giants,0,Chicago Cubs,9,5,May 26 2018,4
Houston Astros,1,Cleveland Indians,14,6,May 26 2018,8
Cincinnati Reds,0,Colorado Rockies,11,6,May 26 2018,5
Chicago White Sox,0,Detroit Tigers,12,8,May 26 2018,4
San Diego Padres,0,Los Angeles Dodgers,12,7,May 26 2018,5
Washington Nationals,0,Miami Marlins,5,4,May 26 2018,1
New York Mets,1,Milwaukee Brewers,23,6,May 26 2018,17
Los Angeles Angels,0,New York Yankees,15,11,May 26 2018,4
Arizona D'Backs,1,Oakland Athletics,3,0,May 26 2018,3
Toronto Blue Jays,1,Philadelphia Phillies,3,1,May 26 2018,2
St. Louis Cardinals,0,Pittsburgh Pirates,5,4,May 26 2018,1
Minnesota Twins,1,Seattle Mariners,7,3,May 26 2018,4
Baltimore Orioles,1,Tampa Bay Rays,6,1,May 26 2018,5
Kansas City Royals,1,Texas Rangers,7,3,May 26 2018,4
Atlanta Braves,0,Boston Red Sox,8,7,May 27 2018,1
San Francisco Giants,1,Chicago Cubs,11,3,May 27 2018,8
Houston Astros,1,Cleveland Indians,19,9,May 27 2018,10
Cincinnati Reds,1,Colorado Rockies,10,2,May 27 2018,8
Chicago White Sox,1,Detroit Tigers,5,2,May 27 2018,3
San Diego Padres,1,Los Angeles Dodgers,7,1,May 27 2018,6
Washington Nationals,0,Miami Marlins,7,5,May 27 2018,2
New York Mets,1,Milwaukee Brewers,15,7,May 27 2018,8
Los Angeles Angels,1,New York Yankees,4,1,May 27 2018,3
Arizona D'Backs,1,Oakland Athletics,3,1,May 27 2018,2
Toronto Blue Jays,0,Philadelphia Phillies,8,5,May 27 2018,3
St. Louis Cardinals,0,Pittsburgh Pirates,10,6,May 27 2018,4
Minnesota Twins,1,Seattle Mariners,4,1,May 27 2018,3
Baltimore Orioles,1,Tampa Bay Rays,11,3,May 27 2018,8
Kansas City Royals,0,Texas Rangers,8,5,May 27 2018,3
Cincinnati Reds,1,Arizona D'Backs,17,5,May 28 2018,12
New York Mets,1,Atlanta Braves,7,3,May 28 2018,4
New York Mets,0,Atlanta Braves,13,8,May 28 2018,5
Washington Nationals,0,Baltimore Orioles,6,6,May 28 2018,0
Toronto Blue Jays,1,Boston Red Sox,11,3,May 28 2018,8
Chicago White Sox,1,Cleveland Indians,15,6,May 28 2018,9
San Francisco Giants,1,Colorado Rockies,11,5,May 28 2018,6
Los Angeles Angels,1,Detroit Tigers,12,3,May 28 2018,9
Minnesota Twins,0,Kansas City Royals,13,8,May 28 2018,5
Philadelphia Phillies,1,Los Angeles Dodgers,9,4,May 28 2018,5
St. Louis Cardinals,1,Milwaukee Brewers,11,3,May 28 2018,8
Houston Astros,0,New York Yankees,6,5,May 28 2018,1
Tampa Bay Rays,0,Oakland Athletics,1,1,May 28 2018,0
Chicago Cubs,0,Pittsburgh Pirates,7,7,May 28 2018,0
Miami Marlins,0,San Diego Padres,9,7,May 28 2018,2
Texas Rangers,1,Seattle Mariners,3,1,May 28 2018,2
Cincinnati Reds,1,Arizona D'Backs,7,2,May 29 2018,5
New York Mets,1,Atlanta Braves,13,6,May 29 2018,7
Washington Nationals,0,Baltimore Orioles,5,3,May 29 2018,2
Toronto Blue Jays,1,Boston Red Sox,11,3,May 29 2018,8
Chicago White Sox,1,Cleveland Indians,10,3,May 29 2018,7
San Francisco Giants,1,Colorado Rockies,15,4,May 29 2018,11
Los Angeles Angels,0,Detroit Tigers,11,9,May 29 2018,2
Minnesota Twins,1,Kansas City Royals,3,1,May 29 2018,2
Philadelphia Phillies,0,Los Angeles Dodgers,7,6,May 29 2018,1
St. Louis Cardinals,0,Milwaukee Brewers,7,6,May 29 2018,1
Houston Astros,1,New York Yankees,11,5,May 29 2018,6
Tampa Bay Rays,0,Oakland Athletics,7,4,May 29 2018,3
Chicago Cubs,0,Pittsburgh Pirates,14,8,May 29 2018,6
Miami Marlins,1,San Diego Padres,14,5,May 29 2018,9
Texas Rangers,0,Seattle Mariners,14,9,May 29 2018,5
Cincinnati Reds,0,Arizona D'Backs,11,7,May 30 2018,4
New York Mets,0,Atlanta Braves,5,4,May 30 2018,1
Washington Nationals,0,Baltimore Orioles,2,2,May 30 2018,0
Toronto Blue Jays,1,Boston Red Sox,10,4,May 30 2018,6
Chicago White Sox,1,Cleveland Indians,10,1,May 30 2018,9
San Francisco Giants,0,Colorado Rockies,11,7,May 30 2018,4
Los Angeles Angels,1,Detroit Tigers,7,1,May 30 2018,6
Minnesota Twins,1,Kansas City Royals,19,8,May 30 2018,11
Philadelphia Phillies,1,Los Angeles Dodgers,10,2,May 30 2018,8
St. Louis Cardinals,1,Milwaukee Brewers,5,2,May 30 2018,3
Houston Astros,1,New York Yankees,8,3,May 30 2018,5
Tampa Bay Rays,0,Oakland Athletics,6,6,May 30 2018,0
Chicago Cubs,1,Pittsburgh Pirates,3,1,May 30 2018,2
Miami Marlins,1,San Diego Padres,5,2,May 30 2018,3
Texas Rangers,0,Seattle Mariners,13,7,May 30 2018,6
Washington Nationals,1,Atlanta Braves,6,2,May 31 2018,4
Los Angeles Angels,1,Detroit Tigers,8,2,May 31 2018,6
Boston Red Sox,1,Houston Astros,6,2,May 31 2018,4
Philadelphia Phillies,0,Los Angeles Dodgers,3,2,May 31 2018,1
Cleveland Indians,0,Minnesota Twins,17,9,May 31 2018,8
Chicago Cubs,0,New York Mets,6,5,May 31 2018,1
Tampa Bay Rays,1,Oakland Athletics,10,3,May 31 2018,7
Miami Marlins,1,San Diego Padres,11,3,May 31 2018,8
Texas Rangers,1,Seattle Mariners,7,1,May 31 2018,6
Pittsburgh Pirates,1,St. Louis Cardinals,18,8,May 31 2018,10
Texas Rangers,1,Los Angeles Angels,6,0,June 1 2018,6
Miami Marlins,1,Arizona D'Backs,10,1,June 1 2018,9
Washington Nationals,1,Atlanta Braves,4,0,June 1 2018,4
New York Yankees,0,Baltimore Orioles,5,4,June 1 2018,1
Milwaukee Brewers,1,Chicago White Sox,11,3,June 1 2018,8
Los Angeles Dodgers,0,Colorado Rockies,19,11,June 1 2018,8
Toronto Blue Jays,1,Detroit Tigers,7,2,June 1 2018,5
Boston Red Sox,1,Houston Astros,10,3,June 1 2018,7
Oakland Athletics,0,Kansas City Royals,16,16,June 1 2018,0
Cleveland Indians,1,Minnesota Twins,11,4,June 1 2018,7
Chicago Cubs,0,New York Mets,11,7,June 1 2018,4
Cincinnati Reds,0,San Diego Padres,9,7,June 1 2018,2
Tampa Bay Rays,1,Seattle Mariners,7,3,June 1 2018,4
Philadelphia Phillies,1,San Francisco Giants,4,0,June 1 2018,4
Pittsburgh Pirates,0,St. Louis Cardinals,4,4,June 1 2018,0
Texas Rangers,0,Los Angeles Angels,5,3,June 2 2018,2
Miami Marlins,1,Arizona D'Backs,8,2,June 2 2018,6
Washington Nationals,0,Atlanta Braves,8,5,June 2 2018,3
New York Yankees,0,Baltimore Orioles,13,8,June 2 2018,5
Milwaukee Brewers,0,Chicago White Sox,5,5,June 2 2018,0
Los Angeles Dodgers,0,Colorado Rockies,16,12,June 2 2018,4
Toronto Blue Jays,1,Detroit Tigers,11,4,June 2 2018,7
Boston Red Sox,0,Houston Astros,9,5,June 2 2018,4
Oakland Athletics,1,Kansas City Royals,9,4,June 2 2018,5
Cleveland Indians,1,Minnesota Twins,8,1,June 2 2018,7
Chicago Cubs,0,New York Mets,8,7,June 2 2018,1
Cincinnati Reds,1,San Diego Padres,10,2,June 2 2018,8
Tampa Bay Rays,1,Seattle Mariners,4,1,June 2 2018,3
Philadelphia Phillies,1,San Francisco Giants,2,0,June 2 2018,2
Pittsburgh Pirates,1,St. Louis Cardinals,5,2,June 2 2018,3
Texas Rangers,1,Los Angeles Angels,4,1,June 3 2018,3
Miami Marlins,1,Arizona D'Backs,7,1,June 3 2018,6
Washington Nationals,1,Atlanta Braves,6,2,June 3 2018,4
Milwaukee Brewers,1,Chicago White Sox,7,1,June 3 2018,6
Los Angeles Dodgers,0,Colorado Rockies,17,10,June 3 2018,7
Toronto Blue Jays,0,Detroit Tigers,12,8,June 3 2018,4
Boston Red Sox,0,Houston Astros,12,9,June 3 2018,3
Oakland Athletics,0,Kansas City Royals,6,5,June 3 2018,1
Cleveland Indians,1,Minnesota Twins,12,5,June 3 2018,7
Chicago Cubs,0,New York Mets,2,2,June 3 2018,0
Cincinnati Reds,1,San Diego Padres,9,3,June 3 2018,6
Tampa Bay Rays,1,Seattle Mariners,3,1,June 3 2018,2
Philadelphia Phillies,1,San Francisco Giants,7,1,June 3 2018,6
Pittsburgh Pirates,1,St. Louis Cardinals,5,0,June 3 2018,5
Kansas City Royals,1,Los Angeles Angels,15,6,June 4 2018,9
New York Yankees,0,Detroit Tigers,11,7,June 4 2018,4
New York Yankees,1,Detroit Tigers,6,2,June 4 2018,4
Atlanta Braves,1,San Diego Padres,15,4,June 4 2018,11
Arizona D'Backs,1,San Francisco Giants,13,3,June 4 2018,10
Kansas City Royals,1,Los Angeles Angels,1,0,June 5 2018,1
Detroit Tigers,1,Boston Red Sox,6,0,June 5 2018,6
Philadelphia Phillies,0,Chicago Cubs,7,6,June 5 2018,1
Colorado Rockies,0,Cincinnati Reds,15,9,June 5 2018,6
Milwaukee Brewers,1,Cleveland Indians,5,2,June 5 2018,3
Seattle Mariners,0,Houston Astros,8,7,June 5 2018,1
Chicago White Sox,1,Minnesota Twins,6,2,June 5 2018,4
Chicago White Sox,0,Minnesota Twins,9,6,June 5 2018,3
Baltimore Orioles,0,New York Mets,3,2,June 5 2018,1
Los Angeles Dodgers,0,Pittsburgh Pirates,5,5,June 5 2018,0
Atlanta Braves,0,San Diego Padres,15,14,June 5 2018,1
Arizona D'Backs,0,San Francisco Giants,5,3,June 5 2018,2
Miami Marlins,0,St. Louis Cardinals,11,7,June 5 2018,4
Oakland Athletics,1,Texas Rangers,11,4,June 5 2018,7
New York Yankees,0,Toronto Blue Jays,9,7,June 5 2018,2
Tampa Bay Rays,1,Washington Nationals,6,2,June 5 2018,4
Kansas City Royals,1,Los Angeles Angels,7,3,June 6 2018,4
Detroit Tigers,1,Boston Red Sox,8,1,June 6 2018,7
Philadelphia Phillies,1,Chicago Cubs,12,5,June 6 2018,7
Colorado Rockies,0,Cincinnati Reds,9,6,June 6 2018,3
Milwaukee Brewers,1,Cleveland Indians,4,1,June 6 2018,3
Seattle Mariners,1,Houston Astros,12,5,June 6 2018,7
Chicago White Sox,0,Minnesota Twins,7,5,June 6 2018,2
Baltimore Orioles,0,New York Mets,1,1,June 6 2018,0
Los Angeles Dodgers,1,Pittsburgh Pirates,20,9,June 6 2018,11
Atlanta Braves,1,San Diego Padres,4,1,June 6 2018,3
Arizona D'Backs,1,San Francisco Giants,9,4,June 6 2018,5
Miami Marlins,0,St. Louis Cardinals,14,11,June 6 2018,3
Oakland Athletics,1,Texas Rangers,10,2,June 6 2018,8
New York Yankees,0,Toronto Blue Jays,3,3,June 6 2018,0
Tampa Bay Rays,1,Washington Nationals,13,2,June 6 2018,11
Detroit Tigers,0,Boston Red Sox,9,7,June 7 2018,2
Philadelphia Phillies,1,Chicago Cubs,7,3,June 7 2018,4
Colorado Rockies,1,Cincinnati Reds,12,5,June 7 2018,7
Chicago White Sox,1,Minnesota Twins,9,2,June 7 2018,7
Kansas City Royals,1,Oakland Athletics,5,1,June 7 2018,4
Los Angeles Dodgers,0,Pittsburgh Pirates,15,8,June 7 2018,7
Miami Marlins,1,St. Louis Cardinals,5,1,June 7 2018,4
Seattle Mariners,0,Tampa Bay Rays,9,5,June 7 2018,4
Houston Astros,0,Texas Rangers,7,5,June 7 2018,2
Baltimore Orioles,1,Toronto Blue Jays,9,4,June 7 2018,5
Chicago White Sox,0,Boston Red Sox,1,1,June 8 2018,0
Pittsburgh Pirates,1,Chicago Cubs,4,1,June 8 2018,3
St. Louis Cardinals,0,Cincinnati Reds,13,7,June 8 2018,6
Arizona D'Backs,0,Colorado Rockies,13,9,June 8 2018,4
Cleveland Indians,0,Detroit Tigers,5,4,June 8 2018,1
Atlanta Braves,1,Los Angeles Dodgers,10,3,June 8 2018,7
San Diego Padres,1,Miami Marlins,4,0,June 8 2018,4
Los Angeles Angels,0,Minnesota Twins,6,4,June 8 2018,2
New York Yankees,0,New York Mets,5,4,June 8 2018,1
Kansas City Royals,1,Oakland Athletics,9,2,June 8 2018,7
Milwaukee Brewers,0,Philadelphia Phillies,16,12,June 8 2018,4
Seattle Mariners,0,Tampa Bay Rays,7,4,June 8 2018,3
Houston Astros,0,Texas Rangers,10,7,June 8 2018,3
Baltimore Orioles,1,Toronto Blue Jays,6,1,June 8 2018,5
San Francisco Giants,0,Washington Nationals,14,9,June 8 2018,5
Chicago White Sox,1,Boston Red Sox,6,2,June 9 2018,4
Pittsburgh Pirates,1,Chicago Cubs,2,0,June 9 2018,2
St. Louis Cardinals,0,Cincinnati Reds,10,6,June 9 2018,4
Arizona D'Backs,0,Colorado Rockies,19,12,June 9 2018,7
Cleveland Indians,1,Detroit Tigers,6,2,June 9 2018,4
Atlanta Braves,0,Los Angeles Dodgers,8,5,June 9 2018,3
San Diego Padres,0,Miami Marlins,9,5,June 9 2018,4
Los Angeles Angels,0,Minnesota Twins,3,2,June 9 2018,1
New York Yankees,0,New York Mets,7,4,June 9 2018,3
Kansas City Royals,0,Oakland Athletics,2,2,June 9 2018,0
Milwaukee Brewers,0,Philadelphia Phillies,15,12,June 9 2018,3
Seattle Mariners,1,Tampa Bay Rays,10,3,June 9 2018,7
Houston Astros,0,Texas Rangers,7,4,June 9 2018,3
Baltimore Orioles,1,Toronto Blue Jays,7,3,June 9 2018,4
San Francisco Giants,1,Washington Nationals,12,5,June 9 2018,7
Chicago White Sox,0,Boston Red Sox,7,5,June 10 2018,2
Pittsburgh Pirates,0,Chicago Cubs,8,7,June 10 2018,1
St. Louis Cardinals,1,Cincinnati Reds,9,3,June 10 2018,6
Arizona D'Backs,0,Colorado Rockies,11,8,June 10 2018,3
Cleveland Indians,0,Detroit Tigers,11,9,June 10 2018,2
Atlanta Braves,1,Los Angeles Dodgers,9,2,June 10 2018,7
San Diego Padres,0,Miami Marlins,4,3,June 10 2018,1
Los Angeles Angels,1,Minnesota Twins,12,5,June 10 2018,7
New York Yankees,1,New York Mets,2,0,June 10 2018,2
Kansas City Royals,1,Oakland Athletics,5,2,June 10 2018,3
Milwaukee Brewers,1,Philadelphia Phillies,7,3,June 10 2018,4
Seattle Mariners,0,Tampa Bay Rays,9,5,June 10 2018,4
Houston Astros,0,Texas Rangers,15,8,June 10 2018,7
Baltimore Orioles,1,Toronto Blue Jays,16,3,June 10 2018,13
San Francisco Giants,0,Washington Nationals,2,2,June 10 2018,0
Pittsburgh Pirates,1,Arizona D'Backs,14,5,June 11 2018,9
Boston Red Sox,0,Baltimore Orioles,2,2,June 11 2018,0
Cleveland Indians,0,Chicago White Sox,4,4,June 11 2018,0
San Francisco Giants,1,Miami Marlins,12,5,June 11 2018,7
Chicago Cubs,0,Milwaukee Brewers,9,7,June 11 2018,2
Los Angeles Angels,1,Seattle Mariners,8,3,June 11 2018,5
San Diego Padres,1,St. Louis Cardinals,7,2,June 11 2018,5
Toronto Blue Jays,1,Tampa Bay Rays,12,4,June 11 2018,8
Pittsburgh Pirates,1,Arizona D'Backs,21,8,June 12 2018,13
New York Mets,1,Atlanta Braves,10,2,June 12 2018,8
Boston Red Sox,0,Baltimore Orioles,10,6,June 12 2018,4
Cleveland Indians,1,Chicago White Sox,6,1,June 12 2018,5
Minnesota Twins,0,Detroit Tigers,10,6,June 12 2018,4
Cincinnati Reds,0,Kansas City Royals,6,5,June 12 2018,1
Texas Rangers,1,Los Angeles Dodgers,17,5,June 12 2018,12
San Francisco Giants,1,Miami Marlins,4,1,June 12 2018,3
Chicago Cubs,1,Milwaukee Brewers,4,0,June 12 2018,4
Washington Nationals,1,New York Yankees,3,0,June 12 2018,3
Houston Astros,0,Oakland Athletics,9,6,June 12 2018,3
Colorado Rockies,1,Philadelphia Phillies,9,4,June 12 2018,5
Los Angeles Angels,1,Seattle Mariners,9,3,June 12 2018,6
San Diego Padres,0,St. Louis Cardinals,6,4,June 12 2018,2
Toronto Blue Jays,1,Tampa Bay Rays,5,1,June 12 2018,4
Pittsburgh Pirates,0,Arizona D'Backs,9,5,June 13 2018,4
New York Mets,1,Atlanta Braves,2,0,June 13 2018,2
Boston Red Sox,0,Baltimore Orioles,6,5,June 13 2018,1
Cleveland Indians,1,Chicago White Sox,5,2,June 13 2018,3
Minnesota Twins,1,Detroit Tigers,7,2,June 13 2018,5
Cincinnati Reds,0,Kansas City Royals,7,7,June 13 2018,0
Texas Rangers,1,Los Angeles Dodgers,5,2,June 13 2018,3
San Francisco Giants,1,Miami Marlins,9,4,June 13 2018,5
Chicago Cubs,1,Milwaukee Brewers,1,0,June 13 2018,1
Washington Nationals,0,New York Yankees,9,5,June 13 2018,4
Houston Astros,0,Oakland Athletics,18,13,June 13 2018,5
Colorado Rockies,0,Philadelphia Phillies,9,7,June 13 2018,2
Los Angeles Angels,1,Seattle Mariners,14,6,June 13 2018,8
San Diego Padres,0,St. Louis Cardinals,6,4,June 13 2018,2
Toronto Blue Jays,1,Tampa Bay Rays,1,0,June 13 2018,1
New York Mets,1,Arizona D'Backs,9,3,June 14 2018,6
San Diego Padres,1,Atlanta Braves,6,2,June 14 2018,4
Cleveland Indians,0,Chicago White Sox,7,5,June 14 2018,2
Minnesota Twins,1,Detroit Tigers,4,1,June 14 2018,3
San Francisco Giants,0,Miami Marlins,9,6,June 14 2018,3
Tampa Bay Rays,1,New York Yankees,7,3,June 14 2018,4
Houston Astros,0,Oakland Athletics,10,7,June 14 2018,3
Colorado Rockies,1,Philadelphia Phillies,12,3,June 14 2018,9
Boston Red Sox,0,Seattle Mariners,3,2,June 14 2018,1
New York Mets,1,Arizona D'Backs,10,3,June 15 2018,7
San Diego Padres,0,Atlanta Braves,12,9,June 15 2018,3
Miami Marlins,0,Baltimore Orioles,2,2,June 15 2018,0
Detroit Tigers,0,Chicago White Sox,7,4,June 15 2018,3
Minnesota Twins,0,Cleveland Indians,9,6,June 15 2018,3
Houston Astros,0,Kansas City Royals,10,7,June 15 2018,3
San Francisco Giants,1,Los Angeles Dodgers,5,2,June 15 2018,3
Philadelphia Phillies,1,Milwaukee Brewers,15,2,June 15 2018,13
Tampa Bay Rays,1,New York Yankees,5,0,June 15 2018,5
Los Angeles Angels,0,Oakland Athletics,12,8,June 15 2018,4
Cincinnati Reds,1,Pittsburgh Pirates,5,2,June 15 2018,3
Boston Red Sox,1,Seattle Mariners,13,6,June 15 2018,7
Chicago Cubs,0,St. Louis Cardinals,18,13,June 15 2018,5
Colorado Rockies,0,Texas Rangers,14,9,June 15 2018,5
Washington Nationals,1,Toronto Blue Jays,11,5,June 15 2018,6
New York Mets,0,Arizona D'Backs,6,5,June 16 2018,1
San Diego Padres,1,Atlanta Braves,1,0,June 16 2018,1
Miami Marlins,0,Baltimore Orioles,9,5,June 16 2018,4
Detroit Tigers,0,Chicago White Sox,12,7,June 16 2018,5
Minnesota Twins,0,Cleveland Indians,12,9,June 16 2018,3
Houston Astros,0,Kansas City Royals,12,10,June 16 2018,2
San Francisco Giants,1,Los Angeles Dodgers,4,1,June 16 2018,3
Philadelphia Phillies,0,Milwaukee Brewers,5,4,June 16 2018,1
Tampa Bay Rays,1,New York Yankees,5,1,June 16 2018,4
Los Angeles Angels,1,Oakland Athletics,10,4,June 16 2018,6
Cincinnati Reds,1,Pittsburgh Pirates,8,2,June 16 2018,6
Boston Red Sox,1,Seattle Mariners,1,0,June 16 2018,1
Chicago Cubs,0,St. Louis Cardinals,9,6,June 16 2018,3
Colorado Rockies,1,Texas Rangers,7,2,June 16 2018,5
Washington Nationals,1,Toronto Blue Jays,2,0,June 16 2018,2
New York Mets,0,Arizona D'Backs,8,5,June 17 2018,3
San Diego Padres,1,Atlanta Braves,5,1,June 17 2018,4
Miami Marlins,1,Baltimore Orioles,14,4,June 17 2018,10
Detroit Tigers,0,Chicago White Sox,4,3,June 17 2018,1
Minnesota Twins,1,Cleveland Indians,5,1,June 17 2018,4
Houston Astros,0,Kansas City Royals,11,7,June 17 2018,4
San Francisco Giants,0,Los Angeles Dodgers,5,4,June 17 2018,1
Philadelphia Phillies,0,Milwaukee Brewers,19,10,June 17 2018,9
Tampa Bay Rays,0,New York Yankees,4,3,June 17 2018,1
Los Angeles Angels,1,Oakland Athletics,11,5,June 17 2018,6
Cincinnati Reds,0,Pittsburgh Pirates,14,8,June 17 2018,6
Boston Red Sox,0,Seattle Mariners,12,9,June 17 2018,3
Chicago Cubs,1,St. Louis Cardinals,5,0,June 17 2018,5
Colorado Rockies,1,Texas Rangers,25,12,June 17 2018,13
Washington Nationals,1,Toronto Blue Jays,14,6,June 17 2018,8
Arizona D'Backs,0,Los Angeles Angels,11,7,June 18 2018,4
Chicago White Sox,1,Cleveland Indians,8,2,June 18 2018,6
New York Mets,0,Colorado Rockies,14,12,June 18 2018,2
Tampa Bay Rays,1,Houston Astros,9,4,June 18 2018,5
Texas Rangers,0,Kansas City Royals,9,6,June 18 2018,3
St. Louis Cardinals,1,Philadelphia Phillies,11,5,June 18 2018,6
Milwaukee Brewers,1,Pittsburgh Pirates,1,0,June 18 2018,1
Miami Marlins,0,San Francisco Giants,9,5,June 18 2018,4
New York Yankees,0,Washington Nationals,6,4,June 18 2018,2
Arizona D'Backs,1,Los Angeles Angels,9,4,June 19 2018,5
Los Angeles Dodgers,0,Chicago Cubs,7,4,June 19 2018,3
Los Angeles Dodgers,1,Chicago Cubs,3,1,June 19 2018,2
Detroit Tigers,1,Cincinnati Reds,14,5,June 19 2018,9
Chicago White Sox,1,Cleveland Indians,9,3,June 19 2018,6
New York Mets,1,Colorado Rockies,18,8,June 19 2018,10
Tampa Bay Rays,0,Houston Astros,3,2,June 19 2018,1
Texas Rangers,0,Kansas City Royals,5,4,June 19 2018,1
Boston Red Sox,1,Minnesota Twins,8,2,June 19 2018,6
Seattle Mariners,1,New York Yankees,9,2,June 19 2018,7
St. Louis Cardinals,0,Philadelphia Phillies,13,7,June 19 2018,6
Milwaukee Brewers,0,Pittsburgh Pirates,5,3,June 19 2018,2
Oakland Athletics,0,San Diego Padres,6,4,June 19 2018,2
Miami Marlins,1,San Francisco Giants,9,3,June 19 2018,6
Atlanta Braves,0,Toronto Blue Jays,15,11,June 19 2018,4
Baltimore Orioles,1,Washington Nationals,16,7,June 19 2018,9
Los Angeles Dodgers,1,Chicago Cubs,4,0,June 20 2018,4
Detroit Tigers,1,Cincinnati Reds,8,3,June 20 2018,5
Chicago White Sox,1,Cleveland Indians,12,0,June 20 2018,12
New York Mets,1,Colorado Rockies,18,8,June 20 2018,10
Tampa Bay Rays,1,Houston Astros,6,1,June 20 2018,5
Texas Rangers,0,Kansas City Royals,5,3,June 20 2018,2
Boston Red Sox,1,Minnesota Twins,5,1,June 20 2018,4
Seattle Mariners,1,New York Yankees,12,5,June 20 2018,7
St. Louis Cardinals,1,Philadelphia Phillies,7,3,June 20 2018,4
Oakland Athletics,0,San Diego Padres,16,12,June 20 2018,4
Miami Marlins,1,San Francisco Giants,11,5,June 20 2018,6
Atlanta Braves,1,Toronto Blue Jays,9,4,June 20 2018,5
Baltimore Orioles,0,Washington Nationals,3,3,June 20 2018,0
Toronto Blue Jays,1,Los Angeles Angels,13,5,June 21 2018,8
Chicago Cubs,1,Cincinnati Reds,8,2,June 21 2018,6
New York Mets,1,Colorado Rockies,10,4,June 21 2018,6
St. Louis Cardinals,1,Milwaukee Brewers,14,3,June 21 2018,11
Boston Red Sox,0,Minnesota Twins,11,9,June 21 2018,2
Seattle Mariners,1,New York Yankees,7,3,June 21 2018,4
Arizona D'Backs,0,Pittsburgh Pirates,12,9,June 21 2018,3
San Diego Padres,1,San Francisco Giants,3,0,June 21 2018,3
Baltimore Orioles,1,Washington Nationals,6,2,June 21 2018,4
Toronto Blue Jays,1,Los Angeles Angels,3,1,June 22 2018,2
Baltimore Orioles,0,Atlanta Braves,17,10,June 22 2018,7
Seattle Mariners,1,Boston Red Sox,24,10,June 22 2018,14
Oakland Athletics,0,Chicago White Sox,13,11,June 22 2018,2
Oakland Athletics,1,Chicago White Sox,10,4,June 22 2018,6
Chicago Cubs,1,Cincinnati Reds,9,3,June 22 2018,6
Detroit Tigers,1,Cleveland Indians,10,0,June 22 2018,10
Miami Marlins,1,Colorado Rockies,14,3,June 22 2018,11
Kansas City Royals,0,Houston Astros,1,1,June 22 2018,0
St. Louis Cardinals,1,Milwaukee Brewers,3,1,June 22 2018,2
Texas Rangers,0,Minnesota Twins,9,8,June 22 2018,1
Los Angeles Dodgers,0,New York Mets,7,5,June 22 2018,2
Arizona D'Backs,0,Pittsburgh Pirates,3,2,June 22 2018,1
San Diego Padres,0,San Francisco Giants,8,6,June 22 2018,2
New York Yankees,1,Tampa Bay Rays,3,1,June 22 2018,2
Philadelphia Phillies,0,Washington Nationals,14,12,June 22 2018,2
Toronto Blue Jays,0,Los Angeles Angels,5,4,June 23 2018,1
Baltimore Orioles,0,Atlanta Braves,12,7,June 23 2018,5
Seattle Mariners,0,Boston Red Sox,9,7,June 23 2018,2
Oakland Athletics,0,Chicago White Sox,13,7,June 23 2018,6
Chicago Cubs,1,Cincinnati Reds,13,2,June 23 2018,11
Detroit Tigers,1,Cleveland Indians,5,1,June 23 2018,4
Miami Marlins,0,Colorado Rockies,8,6,June 23 2018,2
Kansas City Royals,1,Houston Astros,7,3,June 23 2018,4
St. Louis Cardinals,0,Milwaukee Brewers,5,3,June 23 2018,2
Texas Rangers,0,Minnesota Twins,15,9,June 23 2018,6
Los Angeles Dodgers,0,New York Mets,11,8,June 23 2018,3
Arizona D'Backs,0,Pittsburgh Pirates,9,7,June 23 2018,2
San Diego Padres,1,San Francisco Giants,8,3,June 23 2018,5
New York Yankees,1,Tampa Bay Rays,4,0,June 23 2018,4
Philadelphia Phillies,0,Washington Nationals,8,5,June 23 2018,3
Toronto Blue Jays,0,Los Angeles Angels,13,7,June 24 2018,6
Baltimore Orioles,1,Atlanta Braves,10,3,June 24 2018,7
Seattle Mariners,1,Boston Red Sox,5,0,June 24 2018,5
Oakland Athletics,1,Chicago White Sox,13,3,June 24 2018,10
Chicago Cubs,1,Cincinnati Reds,14,6,June 24 2018,8
Detroit Tigers,1,Cleveland Indians,14,2,June 24 2018,12
Miami Marlins,0,Colorado Rockies,13,8,June 24 2018,5
Kansas City Royals,1,Houston Astros,14,3,June 24 2018,11
St. Louis Cardinals,0,Milwaukee Brewers,10,8,June 24 2018,2
Texas Rangers,1,Minnesota Twins,2,0,June 24 2018,2
Los Angeles Dodgers,0,New York Mets,15,8,June 24 2018,7
Arizona D'Backs,0,Pittsburgh Pirates,3,3,June 24 2018,0
San Diego Padres,1,San Francisco Giants,5,2,June 24 2018,3
New York Yankees,1,Tampa Bay Rays,13,6,June 24 2018,7
Philadelphia Phillies,1,Washington Nationals,14,6,June 24 2018,8
Cincinnati Reds,1,Atlanta Braves,9,4,June 25 2018,5
Seattle Mariners,0,Baltimore Orioles,8,5,June 25 2018,3
Oakland Athletics,0,Detroit Tigers,9,5,June 25 2018,4
Toronto Blue Jays,0,Houston Astros,9,6,June 25 2018,3
Los Angeles Angels,1,Kansas City Royals,2,0,June 25 2018,2
Chicago Cubs,1,Los Angeles Dodgers,3,1,June 25 2018,2
Arizona D'Backs,1,Miami Marlins,14,5,June 25 2018,9
Pittsburgh Pirates,0,New York Mets,10,6,June 25 2018,4
New York Yankees,0,Philadelphia Phillies,6,4,June 25 2018,2
Cleveland Indians,1,St. Louis Cardinals,4,0,June 25 2018,4
Washington Nationals,1,Tampa Bay Rays,11,0,June 25 2018,11
San Diego Padres,1,Texas Rangers,11,4,June 25 2018,7
Cincinnati Reds,0,Atlanta Braves,8,5,June 26 2018,3
Seattle Mariners,0,Baltimore Orioles,5,3,June 26 2018,2
Los Angeles Angels,1,Boston Red Sox,10,1,June 26 2018,9
Minnesota Twins,1,Chicago White Sox,12,4,June 26 2018,8
Oakland Athletics,0,Detroit Tigers,16,9,June 26 2018,7
Toronto Blue Jays,1,Houston Astros,7,0,June 26 2018,7
Chicago Cubs,0,Los Angeles Dodgers,13,9,June 26 2018,4
Arizona D'Backs,0,Miami Marlins,8,5,June 26 2018,3
Kansas City Royals,1,Milwaukee Brewers,6,1,June 26 2018,5
Pittsburgh Pirates,1,New York Mets,7,3,June 26 2018,4
New York Yankees,0,Philadelphia Phillies,6,6,June 26 2018,0
Colorado Rockies,1,San Francisco Giants,5,2,June 26 2018,3
Cleveland Indians,1,St. Louis Cardinals,13,2,June 26 2018,11
Washington Nationals,1,Tampa Bay Rays,1,0,June 26 2018,1
San Diego Padres,0,Texas Rangers,5,3,June 26 2018,2
Cincinnati Reds,0,Atlanta Braves,11,6,June 27 2018,5
Seattle Mariners,0,Baltimore Orioles,15,8,June 27 2018,7
Los Angeles Angels,1,Boston Red Sox,15,6,June 27 2018,9
Minnesota Twins,1,Chicago White Sox,7,1,June 27 2018,6
Oakland Athletics,0,Detroit Tigers,3,3,June 27 2018,0
Toronto Blue Jays,1,Houston Astros,13,6,June 27 2018,7
Chicago Cubs,1,Los Angeles Dodgers,12,5,June 27 2018,7
Arizona D'Backs,0,Miami Marlins,3,2,June 27 2018,1
Kansas City Royals,0,Milwaukee Brewers,9,5,June 27 2018,4
Pittsburgh Pirates,0,New York Mets,8,5,June 27 2018,3
New York Yankees,1,Philadelphia Phillies,3,0,June 27 2018,3
Colorado Rockies,1,San Francisco Giants,1,0,June 27 2018,1
Cleveland Indians,0,St. Louis Cardinals,6,5,June 27 2018,1
San Diego Padres,1,Texas Rangers,7,2,June 27 2018,5
Seattle Mariners,0,Baltimore Orioles,6,4,June 28 2018,2
Los Angeles Angels,1,Boston Red Sox,6,2,June 28 2018,4
Minnesota Twins,0,Chicago White Sox,3,2,June 28 2018,1
Milwaukee Brewers,0,Cincinnati Reds,10,6,June 28 2018,4
Oakland Athletics,0,Detroit Tigers,6,4,June 28 2018,2
Chicago Cubs,0,Los Angeles Dodgers,16,11,June 28 2018,5
Arizona D'Backs,0,Miami Marlins,4,4,June 28 2018,0
Washington Nationals,1,Philadelphia Phillies,7,3,June 28 2018,4
Colorado Rockies,0,San Francisco Giants,17,9,June 28 2018,8
Houston Astros,0,Tampa Bay Rays,1,1,June 28 2018,0
San Francisco Giants,0,Arizona D'Backs,3,2,June 29 2018,1
Los Angeles Angels,0,Baltimore Orioles,8,7,June 29 2018,1
Minnesota Twins,1,Chicago Cubs,16,6,June 29 2018,10
Milwaukee Brewers,0,Cincinnati Reds,10,8,June 29 2018,2
Colorado Rockies,0,Los Angeles Dodgers,4,3,June 29 2018,1
New York Mets,1,Miami Marlins,10,2,June 29 2018,8
Boston Red Sox,1,New York Yankees,9,1,June 29 2018,8
Cleveland Indians,1,Oakland Athletics,4,1,June 29 2018,3
Washington Nationals,0,Philadelphia Phillies,24,17,June 29 2018,7
Pittsburgh Pirates,0,San Diego Padres,9,6,June 29 2018,3
Kansas City Royals,1,Seattle Mariners,5,1,June 29 2018,4
Atlanta Braves,0,St. Louis Cardinals,6,5,June 29 2018,1
Houston Astros,1,Tampa Bay Rays,5,2,June 29 2018,3
Chicago White Sox,1,Texas Rangers,14,3,June 29 2018,11
Detroit Tigers,1,Toronto Blue Jays,5,2,June 29 2018,3
San Francisco Giants,0,Arizona D'Backs,7,7,June 30 2018,0
Los Angeles Angels,0,Baltimore Orioles,8,6,June 30 2018,2
Minnesota Twins,1,Chicago Cubs,23,9,June 30 2018,14
Milwaukee Brewers,1,Cincinnati Reds,15,3,June 30 2018,12
Colorado Rockies,0,Los Angeles Dodgers,4,3,June 30 2018,1
New York Mets,1,Miami Marlins,7,2,June 30 2018,5
Boston Red Sox,0,New York Yankees,11,11,June 30 2018,0
Cleveland Indians,1,Oakland Athletics,9,2,June 30 2018,7
Washington Nationals,1,Philadelphia Phillies,5,2,June 30 2018,3
Pittsburgh Pirates,1,San Diego Padres,7,3,June 30 2018,4
Kansas City Royals,1,Seattle Mariners,10,4,June 30 2018,6
Atlanta Braves,0,St. Louis Cardinals,15,11,June 30 2018,4
Houston Astros,1,Tampa Bay Rays,7,2,June 30 2018,5
Chicago White Sox,1,Texas Rangers,17,4,June 30 2018,13
Detroit Tigers,1,Toronto Blue Jays,7,3,June 30 2018,4
San Francisco Giants,0,Arizona D'Backs,15,9,July 1 2018,6
Los Angeles Angels,1,Baltimore Orioles,10,2,July 1 2018,8
Minnesota Twins,1,Chicago Cubs,21,10,July 1 2018,11
Milwaukee Brewers,1,Cincinnati Reds,10,2,July 1 2018,8
Colorado Rockies,1,Los Angeles Dodgers,10,4,July 1 2018,6
New York Mets,0,Miami Marlins,7,5,July 1 2018,2
Boston Red Sox,1,New York Yankees,12,1,July 1 2018,11
Cleveland Indians,0,Oakland Athletics,18,15,July 1 2018,3
Washington Nationals,1,Philadelphia Phillies,7,3,July 1 2018,4
Pittsburgh Pirates,0,San Diego Padres,12,7,July 1 2018,5
Kansas City Royals,1,Seattle Mariners,1,0,July 1 2018,1
Atlanta Braves,0,St. Louis Cardinals,11,6,July 1 2018,5
Houston Astros,1,Tampa Bay Rays,5,2,July 1 2018,3
Chicago White Sox,0,Texas Rangers,15,10,July 1 2018,5
Detroit Tigers,0,Toronto Blue Jays,10,9,July 1 2018,1
St. Louis Cardinals,0,Arizona D'Backs,9,6,July 2 2018,3
Chicago White Sox,1,Cincinnati Reds,8,3,July 2 2018,5
San Francisco Giants,1,Colorado Rockies,7,2,July 2 2018,5
Cleveland Indians,0,Kansas City Royals,12,9,July 2 2018,3
Pittsburgh Pirates,1,Los Angeles Dodgers,18,1,July 2 2018,17
Tampa Bay Rays,1,Miami Marlins,5,2,July 2 2018,3
Minnesota Twins,1,Milwaukee Brewers,11,5,July 2 2018,6
Atlanta Braves,0,New York Yankees,8,5,July 2 2018,3
Detroit Tigers,0,Toronto Blue Jays,5,3,July 2 2018,2
Boston Red Sox,0,Washington Nationals,7,4,July 2 2018,3
St. Louis Cardinals,1,Arizona D'Backs,6,2,July 3 2018,4
Detroit Tigers,1,Chicago Cubs,8,3,July 3 2018,5
Chicago White Sox,0,Cincinnati Reds,20,12,July 3 2018,8
San Francisco Giants,1,Colorado Rockies,9,1,July 3 2018,8
Cleveland Indians,0,Kansas City Royals,10,6,July 3 2018,4
Pittsburgh Pirates,1,Los Angeles Dodgers,11,3,July 3 2018,8
Tampa Bay Rays,0,Miami Marlins,15,9,July 3 2018,6
Minnesota Twins,1,Milwaukee Brewers,2,0,July 3 2018,2
Atlanta Braves,1,New York Yankees,13,5,July 3 2018,8
San Diego Padres,1,Oakland Athletics,8,2,July 3 2018,6
Baltimore Orioles,1,Philadelphia Phillies,5,2,July 3 2018,3
Los Angeles Angels,1,Seattle Mariners,5,1,July 3 2018,4
Houston Astros,0,Texas Rangers,8,5,July 3 2018,3
New York Mets,1,Toronto Blue Jays,14,6,July 3 2018,8
Boston Red Sox,0,Washington Nationals,15,11,July 3 2018,4
St. Louis Cardinals,0,Arizona D'Backs,12,8,July 4 2018,4
Detroit Tigers,1,Chicago Cubs,7,2,July 4 2018,5
Chicago White Sox,1,Cincinnati Reds,11,4,July 4 2018,7
San Francisco Giants,1,Colorado Rockies,1,0,July 4 2018,1
Cleveland Indians,0,Kansas City Royals,5,3,July 4 2018,2
Pittsburgh Pirates,1,Los Angeles Dodgers,10,4,July 4 2018,6
Tampa Bay Rays,1,Miami Marlins,3,0,July 4 2018,3
Minnesota Twins,1,Milwaukee Brewers,5,2,July 4 2018,3
Atlanta Braves,1,New York Yankees,8,2,July 4 2018,6
San Diego Padres,1,Oakland Athletics,6,2,July 4 2018,4
Baltimore Orioles,1,Philadelphia Phillies,5,1,July 4 2018,4
Los Angeles Angels,0,Seattle Mariners,11,7,July 4 2018,4
Houston Astros,0,Texas Rangers,9,5,July 4 2018,4
New York Mets,0,Toronto Blue Jays,9,6,July 4 2018,3
Boston Red Sox,0,Washington Nationals,3,3,July 4 2018,0
San Diego Padres,0,Arizona D'Backs,9,6,July 5 2018,3
Texas Rangers,0,Detroit Tigers,12,7,July 5 2018,5
Chicago White Sox,1,Houston Astros,7,3,July 5 2018,4
Atlanta Braves,1,Milwaukee Brewers,9,2,July 5 2018,7
Baltimore Orioles,1,Minnesota Twins,7,2,July 5 2018,5
Los Angeles Angels,1,Seattle Mariners,5,1,July 5 2018,4
St. Louis Cardinals,0,San Francisco Giants,13,11,July 5 2018,2
Miami Marlins,1,Washington Nationals,26,12,July 5 2018,14
Los Angeles Dodgers,1,Los Angeles Angels,5,2,July 6 2018,3
San Diego Padres,1,Arizona D'Backs,4,1,July 6 2018,3
Cincinnati Reds,0,Chicago Cubs,5,3,July 6 2018,2
Oakland Athletics,1,Cleveland Indians,14,4,July 6 2018,10
Texas Rangers,1,Detroit Tigers,4,1,July 6 2018,3
Chicago White Sox,1,Houston Astros,15,4,July 6 2018,11
Boston Red Sox,0,Kansas City Royals,15,10,July 6 2018,5
Atlanta Braves,1,Milwaukee Brewers,9,4,July 6 2018,5
Baltimore Orioles,1,Minnesota Twins,8,2,July 6 2018,6
Tampa Bay Rays,1,New York Mets,6,1,July 6 2018,5
Philadelphia Phillies,0,Pittsburgh Pirates,22,17,July 6 2018,5
Colorado Rockies,0,Seattle Mariners,8,7,July 6 2018,1
St. Louis Cardinals,1,San Francisco Giants,5,2,July 6 2018,3
New York Yankees,1,Toronto Blue Jays,8,2,July 6 2018,6
Miami Marlins,1,Washington Nationals,5,2,July 6 2018,3
Los Angeles Dodgers,0,Los Angeles Angels,4,3,July 7 2018,1
San Diego Padres,1,Arizona D'Backs,25,5,July 7 2018,20
Cincinnati Reds,1,Chicago Cubs,15,7,July 7 2018,8
Oakland Athletics,0,Cleveland Indians,9,6,July 7 2018,3
Texas Rangers,1,Detroit Tigers,9,2,July 7 2018,7
Chicago White Sox,1,Houston Astros,18,6,July 7 2018,12
Boston Red Sox,0,Kansas City Royals,19,15,July 7 2018,4
Atlanta Braves,0,Milwaukee Brewers,6,5,July 7 2018,1
Baltimore Orioles,1,Minnesota Twins,9,4,July 7 2018,5
Tampa Bay Rays,0,New York Mets,3,3,July 7 2018,0
Philadelphia Phillies,0,Pittsburgh Pirates,5,3,July 7 2018,2
Colorado Rockies,0,Seattle Mariners,6,5,July 7 2018,1
St. Louis Cardinals,0,San Francisco Giants,5,3,July 7 2018,2
New York Yankees,0,Toronto Blue Jays,13,8,July 7 2018,5
Miami Marlins,1,Washington Nationals,22,4,July 7 2018,18
Los Angeles Dodgers,1,Los Angeles Angels,7,3,July 8 2018,4
San Diego Padres,0,Arizona D'Backs,7,4,July 8 2018,3
Cincinnati Reds,1,Chicago Cubs,11,5,July 8 2018,6
Oakland Athletics,0,Cleveland Indians,6,6,July 8 2018,0
Texas Rangers,0,Detroit Tigers,3,3,July 8 2018,0
Chicago White Sox,1,Houston Astros,3,1,July 8 2018,2
Boston Red Sox,0,Kansas City Royals,11,7,July 8 2018,4
Atlanta Braves,1,Milwaukee Brewers,13,3,July 8 2018,10
Baltimore Orioles,1,Minnesota Twins,11,1,July 8 2018,10
Tampa Bay Rays,0,New York Mets,9,9,July 8 2018,0
Philadelphia Phillies,1,Pittsburgh Pirates,5,1,July 8 2018,4
Colorado Rockies,1,Seattle Mariners,10,4,July 8 2018,6
St. Louis Cardinals,1,San Francisco Giants,21,8,July 8 2018,13
New York Yankees,0,Toronto Blue Jays,3,2,July 8 2018,1
Miami Marlins,0,Washington Nationals,12,10,July 8 2018,2
New York Yankees,1,Baltimore Orioles,9,4,July 9 2018,5
New York Yankees,0,Baltimore Orioles,12,10,July 9 2018,2
Texas Rangers,1,Boston Red Sox,5,0,July 9 2018,5
Cincinnati Reds,0,Cleveland Indians,12,7,July 9 2018,5
Oakland Athletics,0,Houston Astros,2,2,July 9 2018,0
Milwaukee Brewers,1,Miami Marlins,7,3,July 9 2018,4
Kansas City Royals,1,Minnesota Twins,4,1,July 9 2018,3
Philadelphia Phillies,1,New York Mets,7,3,July 9 2018,4
Philadelphia Phillies,0,New York Mets,4,3,July 9 2018,1
Washington Nationals,1,Pittsburgh Pirates,9,3,July 9 2018,6
Los Angeles Dodgers,0,San Diego Padres,10,8,July 9 2018,2
Chicago Cubs,1,San Francisco Giants,3,1,July 9 2018,2
Detroit Tigers,1,Tampa Bay Rays,19,9,July 9 2018,10
Seattle Mariners,1,Los Angeles Angels,12,3,July 10 2018,9
Toronto Blue Jays,0,Atlanta Braves,8,6,July 10 2018,2
New York Yankees,1,Baltimore Orioles,11,5,July 10 2018,6
Texas Rangers,1,Boston Red Sox,12,4,July 10 2018,8
St. Louis Cardinals,0,Chicago White Sox,16,14,July 10 2018,2
Cincinnati Reds,0,Cleveland Indians,11,7,July 10 2018,4
Arizona D'Backs,0,Colorado Rockies,8,5,July 10 2018,3
Oakland Athletics,1,Houston Astros,11,5,July 10 2018,6
Milwaukee Brewers,0,Miami Marlins,12,8,July 10 2018,4
Kansas City Royals,0,Minnesota Twins,13,9,July 10 2018,4
Philadelphia Phillies,0,New York Mets,10,7,July 10 2018,3
Washington Nationals,0,Pittsburgh Pirates,6,5,July 10 2018,1
Los Angeles Dodgers,1,San Diego Padres,5,1,July 10 2018,4
Chicago Cubs,0,San Francisco Giants,2,2,July 10 2018,0
Detroit Tigers,1,Tampa Bay Rays,7,2,July 10 2018,5
Seattle Mariners,0,Los Angeles Angels,3,3,July 11 2018,0
Toronto Blue Jays,1,Atlanta Braves,14,5,July 11 2018,9
New York Yankees,0,Baltimore Orioles,9,9,July 11 2018,0
Texas Rangers,1,Boston Red Sox,6,2,July 11 2018,4
St. Louis Cardinals,1,Chicago White Sox,4,0,July 11 2018,4
Cincinnati Reds,1,Cleveland Indians,23,4,July 11 2018,19
Arizona D'Backs,1,Colorado Rockies,21,2,July 11 2018,19
Oakland Athletics,0,Houston Astros,11,8,July 11 2018,3
Milwaukee Brewers,1,Miami Marlins,9,4,July 11 2018,5
Kansas City Royals,1,Minnesota Twins,13,5,July 11 2018,8
Philadelphia Phillies,1,New York Mets,3,0,July 11 2018,3
Washington Nationals,1,Pittsburgh Pirates,2,0,July 11 2018,2
Los Angeles Dodgers,0,San Diego Padres,6,4,July 11 2018,2
Chicago Cubs,1,San Francisco Giants,9,4,July 11 2018,5
Detroit Tigers,1,Tampa Bay Rays,6,2,July 11 2018,4
Seattle Mariners,1,Los Angeles Angels,13,2,July 12 2018,11
Philadelphia Phillies,0,Baltimore Orioles,9,5,July 12 2018,4
Toronto Blue Jays,1,Boston Red Sox,10,4,July 12 2018,6
New York Yankees,0,Cleveland Indians,11,7,July 12 2018,4
Arizona D'Backs,1,Colorado Rockies,6,1,July 12 2018,5
Oakland Athletics,0,Houston Astros,10,6,July 12 2018,4
Tampa Bay Rays,1,Minnesota Twins,6,1,July 12 2018,5
Washington Nationals,0,New York Mets,9,5,July 12 2018,4
Milwaukee Brewers,1,Pittsburgh Pirates,9,3,July 12 2018,6
Los Angeles Dodgers,0,San Diego Padres,5,3,July 12 2018,2
Arizona D'Backs,0,Atlanta Braves,3,2,July 13 2018,1
Texas Rangers,0,Baltimore Orioles,9,5,July 13 2018,4
Toronto Blue Jays,0,Boston Red Sox,20,13,July 13 2018,7
Kansas City Royals,1,Chicago White Sox,15,6,July 13 2018,9
New York Yankees,1,Cleveland Indians,11,5,July 13 2018,6
Seattle Mariners,1,Colorado Rockies,17,7,July 13 2018,10
Detroit Tigers,1,Houston Astros,3,0,July 13 2018,3
Los Angeles Angels,1,Los Angeles Dodgers,5,2,July 13 2018,3
Philadelphia Phillies,0,Miami Marlins,2,2,July 13 2018,0
Tampa Bay Rays,1,Minnesota Twins,19,8,July 13 2018,11
Washington Nationals,1,New York Mets,6,2,July 13 2018,4
Milwaukee Brewers,1,Pittsburgh Pirates,10,3,July 13 2018,7
Chicago Cubs,0,San Diego Padres,9,5,July 13 2018,4
Oakland Athletics,1,San Francisco Giants,8,1,July 13 2018,7
Cincinnati Reds,0,St. Louis Cardinals,10,9,July 13 2018,1
Arizona D'Backs,0,Atlanta Braves,3,3,July 14 2018,0
Texas Rangers,1,Baltimore Orioles,1,0,July 14 2018,1
Toronto Blue Jays,1,Boston Red Sox,8,2,July 14 2018,6
Kansas City Royals,0,Chicago White Sox,5,5,July 14 2018,0
New York Yankees,0,Cleveland Indians,9,5,July 14 2018,4
Seattle Mariners,1,Colorado Rockies,5,1,July 14 2018,4
Detroit Tigers,1,Houston Astros,10,1,July 14 2018,9
Los Angeles Angels,0,Los Angeles Dodgers,9,5,July 14 2018,4
Philadelphia Phillies,1,Miami Marlins,2,0,July 14 2018,2
Tampa Bay Rays,0,Minnesota Twins,25,19,July 14 2018,6
Washington Nationals,1,New York Mets,11,4,July 14 2018,7
Milwaukee Brewers,1,Pittsburgh Pirates,3,1,July 14 2018,2
Milwaukee Brewers,1,Pittsburgh Pirates,8,2,July 14 2018,6
Chicago Cubs,0,San Diego Padres,17,11,July 14 2018,6
Oakland Athletics,0,San Francisco Giants,7,4,July 14 2018,3
Cincinnati Reds,0,St. Louis Cardinals,10,8,July 14 2018,2
Arizona D'Backs,1,Atlanta Braves,6,1,July 15 2018,5
Texas Rangers,1,Baltimore Orioles,11,5,July 15 2018,6
Toronto Blue Jays,1,Boston Red Sox,7,2,July 15 2018,5
Kansas City Royals,1,Chicago White Sox,11,1,July 15 2018,10
New York Yankees,1,Cleveland Indians,7,2,July 15 2018,5
Seattle Mariners,1,Colorado Rockies,7,3,July 15 2018,4
Detroit Tigers,0,Houston Astros,9,6,July 15 2018,3
Los Angeles Angels,1,Los Angeles Dodgers,8,3,July 15 2018,5
Philadelphia Phillies,1,Miami Marlins,15,5,July 15 2018,10
Tampa Bay Rays,1,Minnesota Twins,18,7,July 15 2018,11
Washington Nationals,0,New York Mets,7,6,July 15 2018,1
Milwaukee Brewers,1,Pittsburgh Pirates,13,6,July 15 2018,7
Chicago Cubs,0,San Diego Padres,11,7,July 15 2018,4
Oakland Athletics,0,San Francisco Giants,8,6,July 15 2018,2
Cincinnati Reds,1,St. Louis Cardinals,10,4,July 15 2018,6
St. Louis Cardinals,1,Chicago Cubs,15,6,July 19 2018,9
Houston Astros,0,Los Angeles Angels,4,3,July 20 2018,1
Colorado Rockies,0,Arizona D'Backs,21,11,July 20 2018,10
St. Louis Cardinals,0,Chicago Cubs,23,18,July 20 2018,5
Pittsburgh Pirates,0,Cincinnati Reds,13,12,July 20 2018,1
Boston Red Sox,0,Detroit Tigers,1,1,July 20 2018,0
Minnesota Twins,1,Kansas City Royals,11,5,July 20 2018,6
Los Angeles Dodgers,0,Milwaukee Brewers,10,6,July 20 2018,4
New York Mets,0,New York Yankees,12,7,July 20 2018,5
San Francisco Giants,0,Oakland Athletics,6,5,July 20 2018,1
San Diego Padres,1,Philadelphia Phillies,16,5,July 20 2018,11
Chicago White Sox,1,Seattle Mariners,4,1,July 20 2018,3
Miami Marlins,0,Tampa Bay Rays,11,6,July 20 2018,5
Cleveland Indians,0,Texas Rangers,17,9,July 20 2018,8
Baltimore Orioles,1,Toronto Blue Jays,15,7,July 20 2018,8
Atlanta Braves,0,Washington Nationals,13,8,July 20 2018,5
Houston Astros,0,Los Angeles Angels,7,7,July 21 2018,0
Colorado Rockies,0,Arizona D'Backs,11,6,July 21 2018,5
St. Louis Cardinals,1,Chicago Cubs,9,2,July 21 2018,7
St. Louis Cardinals,0,Chicago Cubs,9,6,July 21 2018,3
Pittsburgh Pirates,0,Cincinnati Reds,8,6,July 21 2018,2
Boston Red Sox,1,Detroit Tigers,5,0,July 21 2018,5
Minnesota Twins,1,Kansas City Royals,6,2,July 21 2018,4
Los Angeles Dodgers,1,Milwaukee Brewers,6,2,July 21 2018,4
New York Mets,1,New York Yankees,13,6,July 21 2018,7
San Francisco Giants,1,Oakland Athletics,7,3,July 21 2018,4
Chicago White Sox,0,Seattle Mariners,5,5,July 21 2018,0
Miami Marlins,0,Tampa Bay Rays,5,3,July 21 2018,2
Cleveland Indians,0,Texas Rangers,19,16,July 21 2018,3
Baltimore Orioles,1,Toronto Blue Jays,5,1,July 21 2018,4
Houston Astros,1,Los Angeles Angels,19,5,July 22 2018,14
Colorado Rockies,1,Arizona D'Backs,7,1,July 22 2018,6
St. Louis Cardinals,1,Chicago Cubs,9,2,July 22 2018,7
Pittsburgh Pirates,0,Cincinnati Reds,11,9,July 22 2018,2
Boston Red Sox,0,Detroit Tigers,10,9,July 22 2018,1
Minnesota Twins,1,Kansas City Royals,8,3,July 22 2018,5
Los Angeles Dodgers,0,Milwaukee Brewers,13,11,July 22 2018,2
San Francisco Giants,1,Oakland Athletics,11,5,July 22 2018,6
San Diego Padres,0,Philadelphia Phillies,12,10,July 22 2018,2
San Diego Padres,1,Philadelphia Phillies,5,0,July 22 2018,5
Chicago White Sox,1,Seattle Mariners,10,2,July 22 2018,8
Miami Marlins,1,Tampa Bay Rays,10,4,July 22 2018,6
Cleveland Indians,1,Texas Rangers,5,0,July 22 2018,5
Baltimore Orioles,1,Toronto Blue Jays,9,4,July 22 2018,5
Atlanta Braves,1,Washington Nationals,8,2,July 22 2018,6
Chicago White Sox,0,Los Angeles Angels,8,5,July 23 2018,3
Boston Red Sox,0,Baltimore Orioles,8,5,July 23 2018,3
Arizona D'Backs,0,Chicago Cubs,8,7,July 23 2018,1
St. Louis Cardinals,1,Cincinnati Reds,3,1,July 23 2018,2
Pittsburgh Pirates,0,Cleveland Indians,7,7,July 23 2018,0
Detroit Tigers,0,Kansas City Royals,9,5,July 23 2018,4
Atlanta Braves,0,Miami Marlins,13,12,July 23 2018,1
Washington Nationals,1,Milwaukee Brewers,7,1,July 23 2018,6
San Diego Padres,0,New York Mets,5,3,July 23 2018,2
Los Angeles Dodgers,0,Philadelphia Phillies,13,7,July 23 2018,6
New York Yankees,1,Tampa Bay Rays,13,6,July 23 2018,7
Oakland Athletics,0,Texas Rangers,18,15,July 23 2018,3
Minnesota Twins,0,Toronto Blue Jays,11,8,July 23 2018,3
Chicago White Sox,0,Los Angeles Angels,6,4,July 24 2018,2
Boston Red Sox,1,Baltimore Orioles,13,6,July 24 2018,7
Arizona D'Backs,0,Chicago Cubs,6,5,July 24 2018,1
St. Louis Cardinals,0,Cincinnati Reds,6,4,July 24 2018,2
Pittsburgh Pirates,0,Cleveland Indians,13,9,July 24 2018,4
Houston Astros,0,Colorado Rockies,10,8,July 24 2018,2
Detroit Tigers,1,Kansas City Royals,9,4,July 24 2018,5
Atlanta Braves,1,Miami Marlins,12,3,July 24 2018,9
Washington Nationals,1,Milwaukee Brewers,9,4,July 24 2018,5
San Diego Padres,1,New York Mets,9,3,July 24 2018,6
Los Angeles Dodgers,1,Philadelphia Phillies,11,4,July 24 2018,7
San Francisco Giants,0,Seattle Mariners,7,4,July 24 2018,3
New York Yankees,0,Tampa Bay Rays,4,4,July 24 2018,0
Oakland Athletics,0,Texas Rangers,23,13,July 24 2018,10
Minnesota Twins,0,Toronto Blue Jays,5,5,July 24 2018,0
Chicago White Sox,1,Los Angeles Angels,14,3,July 25 2018,11
Arizona D'Backs,1,Chicago Cubs,3,1,July 25 2018,2
St. Louis Cardinals,1,Cincinnati Reds,10,3,July 25 2018,7
Pittsburgh Pirates,1,Cleveland Indians,4,0,July 25 2018,4
Houston Astros,1,Colorado Rockies,5,2,July 25 2018,3
Detroit Tigers,0,Kansas City Royals,12,8,July 25 2018,4
Washington Nationals,0,Milwaukee Brewers,10,7,July 25 2018,3
San Diego Padres,1,New York Mets,10,4,July 25 2018,6
Los Angeles Dodgers,1,Philadelphia Phillies,10,3,July 25 2018,7
San Francisco Giants,1,Seattle Mariners,5,2,July 25 2018,3
New York Yankees,1,Tampa Bay Rays,5,2,July 25 2018,3
Oakland Athletics,0,Texas Rangers,11,6,July 25 2018,5
Minnesota Twins,0,Toronto Blue Jays,18,12,July 25 2018,6
Chicago White Sox,1,Los Angeles Angels,20,8,July 26 2018,12
Los Angeles Dodgers,0,Atlanta Braves,10,8,July 26 2018,2
Tampa Bay Rays,0,Baltimore Orioles,7,4,July 26 2018,3
Minnesota Twins,0,Boston Red Sox,3,2,July 26 2018,1
Arizona D'Backs,1,Chicago Cubs,13,6,July 26 2018,7
Philadelphia Phillies,0,Cincinnati Reds,13,9,July 26 2018,4
Washington Nationals,0,Miami Marlins,13,10,July 26 2018,3
Kansas City Royals,1,New York Yankees,9,2,July 26 2018,7
New York Mets,0,Pittsburgh Pirates,18,12,July 26 2018,6
Milwaukee Brewers,0,San Francisco Giants,12,7,July 26 2018,5
Oakland Athletics,0,Texas Rangers,13,7,July 26 2018,6
Seattle Mariners,1,Los Angeles Angels,7,3,July 27 2018,4
Los Angeles Dodgers,0,Atlanta Braves,5,4,July 27 2018,1
Tampa Bay Rays,1,Baltimore Orioles,20,5,July 27 2018,15
Minnesota Twins,1,Boston Red Sox,7,3,July 27 2018,4
Toronto Blue Jays,0,Chicago White Sox,15,10,July 27 2018,5
Philadelphia Phillies,1,Cincinnati Reds,10,4,July 27 2018,6
Oakland Athletics,1,Colorado Rockies,4,1,July 27 2018,3
Cleveland Indians,0,Detroit Tigers,11,8,July 27 2018,3
Texas Rangers,0,Houston Astros,13,11,July 27 2018,2
Washington Nationals,0,Miami Marlins,10,9,July 27 2018,1
New York Mets,1,Pittsburgh Pirates,9,4,July 27 2018,5
Arizona D'Backs,0,San Diego Padres,8,6,July 27 2018,2
Milwaukee Brewers,0,San Francisco Giants,4,3,July 27 2018,1
Chicago Cubs,1,St. Louis Cardinals,7,2,July 27 2018,5
Seattle Mariners,1,Los Angeles Angels,16,5,July 28 2018,11
Los Angeles Dodgers,0,Atlanta Braves,6,5,July 28 2018,1
Tampa Bay Rays,1,Baltimore Orioles,13,2,July 28 2018,11
Minnesota Twins,1,Boston Red Sox,14,4,July 28 2018,10
Toronto Blue Jays,1,Chicago White Sox,14,5,July 28 2018,9
Philadelphia Phillies,1,Cincinnati Reds,8,2,July 28 2018,6
Oakland Athletics,1,Colorado Rockies,5,1,July 28 2018,4
Cleveland Indians,1,Detroit Tigers,3,1,July 28 2018,2
Texas Rangers,0,Houston Astros,10,7,July 28 2018,3
Washington Nationals,1,Miami Marlins,3,1,July 28 2018,2
Kansas City Royals,0,New York Yankees,15,10,July 28 2018,5
Kansas City Royals,1,New York Yankees,9,4,July 28 2018,5
New York Mets,1,Pittsburgh Pirates,5,0,July 28 2018,5
Arizona D'Backs,0,San Diego Padres,13,9,July 28 2018,4
Milwaukee Brewers,0,San Francisco Giants,8,7,July 28 2018,1
Chicago Cubs,1,St. Louis Cardinals,8,2,July 28 2018,6
Seattle Mariners,0,Los Angeles Angels,13,8,July 29 2018,5
Los Angeles Dodgers,1,Atlanta Braves,5,1,July 29 2018,4
Tampa Bay Rays,1,Baltimore Orioles,16,5,July 29 2018,11
Minnesota Twins,1,Boston Red Sox,3,0,July 29 2018,3
Toronto Blue Jays,0,Chicago White Sox,11,7,July 29 2018,4
Philadelphia Phillies,1,Cincinnati Reds,4,0,July 29 2018,4
Oakland Athletics,1,Colorado Rockies,5,2,July 29 2018,3
Cleveland Indians,0,Detroit Tigers,9,8,July 29 2018,1
Texas Rangers,0,Houston Astros,7,4,July 29 2018,3
Washington Nationals,1,Miami Marlins,5,0,July 29 2018,5
Kansas City Royals,1,New York Yankees,9,3,July 29 2018,6
New York Mets,0,Pittsburgh Pirates,1,1,July 29 2018,0
Arizona D'Backs,0,San Diego Padres,9,5,July 29 2018,4
Milwaukee Brewers,1,San Francisco Giants,13,5,July 29 2018,8
Chicago Cubs,0,St. Louis Cardinals,7,5,July 29 2018,2
Texas Rangers,0,Arizona D'Backs,14,9,July 30 2018,5
Miami Marlins,1,Atlanta Braves,8,3,July 30 2018,5
Philadelphia Phillies,1,Boston Red Sox,3,1,July 30 2018,2
Milwaukee Brewers,0,Los Angeles Dodgers,7,5,July 30 2018,2
Cleveland Indians,1,Minnesota Twins,9,4,July 30 2018,5
Toronto Blue Jays,1,Oakland Athletics,11,1,July 30 2018,10
San Francisco Giants,0,San Diego Padres,8,5,July 30 2018,3
Houston Astros,1,Seattle Mariners,2,0,July 30 2018,2
Colorado Rockies,1,St. Louis Cardinals,9,4,July 30 2018,5
Texas Rangers,1,Arizona D'Backs,6,0,July 31 2018,6
Miami Marlins,1,Atlanta Braves,17,6,July 31 2018,11
Philadelphia Phillies,0,Boston Red Sox,4,3,July 31 2018,1
Kansas City Royals,0,Chicago White Sox,6,4,July 31 2018,2
Cincinnati Reds,1,Detroit Tigers,3,1,July 31 2018,2
Milwaukee Brewers,0,Los Angeles Dodgers,1,1,July 31 2018,0
Cleveland Indians,0,Minnesota Twins,8,6,July 31 2018,2
Baltimore Orioles,1,New York Yankees,9,3,July 31 2018,6
Toronto Blue Jays,1,Oakland Athletics,8,2,July 31 2018,6
Chicago Cubs,1,Pittsburgh Pirates,9,4,July 31 2018,5
San Francisco Giants,0,San Diego Padres,5,3,July 31 2018,2
Houston Astros,0,Seattle Mariners,7,5,July 31 2018,2
Colorado Rockies,0,St. Louis Cardinals,9,6,July 31 2018,3
Los Angeles Angels,1,Tampa Bay Rays,16,6,July 31 2018,10
New York Mets,1,Washington Nationals,29,4,July 31 2018,25
Kansas City Royals,0,Chicago White Sox,15,10,August 1 2018,5
Cincinnati Reds,1,Detroit Tigers,11,4,August 1 2018,7
Milwaukee Brewers,1,Los Angeles Dodgers,10,4,August 1 2018,6
Cleveland Indians,0,Minnesota Twins,2,2,August 1 2018,0
Baltimore Orioles,0,New York Yankees,12,7,August 1 2018,5
Toronto Blue Jays,1,Oakland Athletics,11,3,August 1 2018,8
Chicago Cubs,0,Pittsburgh Pirates,11,9,August 1 2018,2
Houston Astros,0,Seattle Mariners,11,8,August 1 2018,3
Colorado Rockies,1,St. Louis Cardinals,9,3,August 1 2018,6
Los Angeles Angels,1,Tampa Bay Rays,9,2,August 1 2018,7
New York Mets,1,Washington Nationals,8,3,August 1 2018,5
San Francisco Giants,0,Arizona D'Backs,9,8,August 2 2018,1
New York Yankees,1,Boston Red Sox,22,7,August 2 2018,15
Kansas City Royals,1,Chicago White Sox,10,4,August 2 2018,6
San Diego Padres,0,Chicago Cubs,7,6,August 2 2018,1
Milwaukee Brewers,1,Los Angeles Dodgers,26,5,August 2 2018,21
Atlanta Braves,0,New York Mets,6,4,August 2 2018,2
Miami Marlins,1,Philadelphia Phillies,7,2,August 2 2018,5
Toronto Blue Jays,0,Seattle Mariners,10,7,August 2 2018,3
Colorado Rockies,1,St. Louis Cardinals,5,2,August 2 2018,3
Los Angeles Angels,1,Tampa Bay Rays,6,2,August 2 2018,4
Baltimore Orioles,1,Texas Rangers,25,8,August 2 2018,17
Cincinnati Reds,1,Washington Nationals,14,4,August 2 2018,10
San Francisco Giants,1,Arizona D'Backs,9,3,August 3 2018,6
New York Yankees,1,Boston Red Sox,5,1,August 3 2018,4
San Diego Padres,1,Chicago Cubs,9,4,August 3 2018,5
Los Angeles Angels,0,Cleveland Indians,11,7,August 3 2018,4
Houston Astros,0,Los Angeles Dodgers,3,2,August 3 2018,1
Colorado Rockies,1,Milwaukee Brewers,8,3,August 3 2018,5
Kansas City Royals,1,Minnesota Twins,10,4,August 3 2018,6
Atlanta Braves,0,New York Mets,3,2,August 3 2018,1
Detroit Tigers,1,Oakland Athletics,1,0,August 3 2018,1
Miami Marlins,1,Philadelphia Phillies,6,1,August 3 2018,5
St. Louis Cardinals,1,Pittsburgh Pirates,13,6,August 3 2018,7
Toronto Blue Jays,0,Seattle Mariners,9,7,August 3 2018,2
Chicago White Sox,0,Tampa Bay Rays,5,3,August 3 2018,2
Baltimore Orioles,1,Texas Rangers,14,3,August 3 2018,11
San Francisco Giants,1,Arizona D'Backs,12,3,August 4 2018,9
New York Yankees,1,Boston Red Sox,5,1,August 4 2018,4
San Diego Padres,1,Chicago Cubs,9,4,August 4 2018,5
Los Angeles Angels,1,Cleveland Indians,3,0,August 4 2018,3
Houston Astros,0,Los Angeles Dodgers,14,14,August 4 2018,0
Colorado Rockies,1,Milwaukee Brewers,12,4,August 4 2018,8
Kansas City Royals,1,Minnesota Twins,10,2,August 4 2018,8
Atlanta Braves,1,New York Mets,3,0,August 4 2018,3
Detroit Tigers,1,Oakland Athletics,3,1,August 4 2018,2
Miami Marlins,1,Philadelphia Phillies,11,3,August 4 2018,8
St. Louis Cardinals,0,Pittsburgh Pirates,12,8,August 4 2018,4
Toronto Blue Jays,0,Seattle Mariners,6,5,August 4 2018,1
Chicago White Sox,0,Tampa Bay Rays,3,2,August 4 2018,1
Baltimore Orioles,1,Texas Rangers,4,1,August 4 2018,3
Cincinnati Reds,0,Washington Nationals,8,7,August 4 2018,1
Cincinnati Reds,1,Washington Nationals,8,2,August 4 2018,6
San Francisco Giants,0,Arizona D'Backs,5,3,August 5 2018,2
New York Yankees,1,Boston Red Sox,9,4,August 5 2018,5
San Diego Padres,0,Chicago Cubs,16,10,August 5 2018,6
Los Angeles Angels,1,Cleveland Indians,7,3,August 5 2018,4
Houston Astros,1,Los Angeles Dodgers,5,2,August 5 2018,3
Colorado Rockies,0,Milwaukee Brewers,9,5,August 5 2018,4
Kansas City Royals,1,Minnesota Twins,11,5,August 5 2018,6
Atlanta Braves,0,New York Mets,9,5,August 5 2018,4
Detroit Tigers,1,Oakland Athletics,6,0,August 5 2018,6
Miami Marlins,1,Philadelphia Phillies,8,3,August 5 2018,5
St. Louis Cardinals,0,Pittsburgh Pirates,3,2,August 5 2018,1
Toronto Blue Jays,1,Seattle Mariners,9,3,August 5 2018,6
Chicago White Sox,0,Tampa Bay Rays,15,8,August 5 2018,7
Baltimore Orioles,0,Texas Rangers,15,9,August 5 2018,6
Cincinnati Reds,1,Washington Nationals,3,1,August 5 2018,2
Detroit Tigers,1,Los Angeles Angels,8,2,August 6 2018,6
Philadelphia Phillies,1,Arizona D'Backs,5,2,August 6 2018,3
New York Yankees,0,Chicago White Sox,7,7,August 6 2018,0
Minnesota Twins,1,Cleveland Indians,10,0,August 6 2018,10
Pittsburgh Pirates,1,Colorado Rockies,2,0,August 6 2018,2
Chicago Cubs,0,Kansas City Royals,4,3,August 6 2018,1
St. Louis Cardinals,1,Miami Marlins,3,1,August 6 2018,2
Cincinnati Reds,1,New York Mets,10,4,August 6 2018,6
Houston Astros,0,San Francisco Giants,4,3,August 6 2018,1
Seattle Mariners,0,Texas Rangers,7,4,August 6 2018,3
Detroit Tigers,1,Los Angeles Angels,16,5,August 7 2018,11
Philadelphia Phillies,0,Arizona D'Backs,7,5,August 7 2018,2
New York Yankees,0,Chicago White Sox,7,4,August 7 2018,3
Minnesota Twins,0,Cleveland Indians,5,3,August 7 2018,2
Pittsburgh Pirates,0,Colorado Rockies,12,10,August 7 2018,2
Chicago Cubs,0,Kansas City Royals,5,5,August 7 2018,0
St. Louis Cardinals,0,Miami Marlins,5,3,August 7 2018,2
San Diego Padres,0,Milwaukee Brewers,16,11,August 7 2018,5
Cincinnati Reds,0,New York Mets,7,6,August 7 2018,1
Los Angeles Dodgers,0,Oakland Athletics,6,4,August 7 2018,2
Houston Astros,0,San Francisco Giants,3,2,August 7 2018,1
Baltimore Orioles,1,Tampa Bay Rays,7,3,August 7 2018,4
Seattle Mariners,1,Texas Rangers,15,4,August 7 2018,11
Boston Red Sox,0,Toronto Blue Jays,17,10,August 7 2018,7
Atlanta Braves,1,Washington Nationals,11,3,August 7 2018,8
Atlanta Braves,0,Washington Nationals,4,3,August 7 2018,1
Detroit Tigers,1,Los Angeles Angels,6,0,August 8 2018,6
Philadelphia Phillies,1,Arizona D'Backs,6,0,August 8 2018,6
New York Yankees,0,Chicago White Sox,10,7,August 8 2018,3
Minnesota Twins,1,Cleveland Indians,7,2,August 8 2018,5
Pittsburgh Pirates,0,Colorado Rockies,7,4,August 8 2018,3
Chicago Cubs,1,Kansas City Royals,9,0,August 8 2018,9
St. Louis Cardinals,0,Miami Marlins,8,7,August 8 2018,1
San Diego Padres,1,Milwaukee Brewers,12,4,August 8 2018,8
Cincinnati Reds,1,New York Mets,8,0,August 8 2018,8
Los Angeles Dodgers,1,Oakland Athletics,5,2,August 8 2018,3
Baltimore Orioles,0,Tampa Bay Rays,9,5,August 8 2018,4
Seattle Mariners,1,Texas Rangers,18,7,August 8 2018,11
Boston Red Sox,0,Toronto Blue Jays,15,10,August 8 2018,5
Atlanta Braves,0,Washington Nationals,11,8,August 8 2018,3
Minnesota Twins,1,Cleveland Indians,9,4,August 9 2018,5
Los Angeles Dodgers,0,Colorado Rockies,13,8,August 9 2018,5
Seattle Mariners,0,Houston Astros,14,8,August 9 2018,6
San Diego Padres,0,Milwaukee Brewers,12,8,August 9 2018,4
Texas Rangers,1,New York Yankees,10,3,August 9 2018,7
Pittsburgh Pirates,0,San Francisco Giants,15,10,August 9 2018,5
Baltimore Orioles,1,Tampa Bay Rays,9,4,August 9 2018,5
Boston Red Sox,1,Toronto Blue Jays,13,5,August 9 2018,8
Atlanta Braves,1,Washington Nationals,9,3,August 9 2018,6
Oakland Athletics,1,Los Angeles Angels,7,3,August 10 2018,4
Milwaukee Brewers,1,Atlanta Braves,11,1,August 10 2018,10
Boston Red Sox,0,Baltimore Orioles,31,19,August 10 2018,12
Cleveland Indians,1,Chicago White Sox,1,0,August 10 2018,1
Washington Nationals,1,Chicago Cubs,5,2,August 10 2018,3
Arizona D'Backs,1,Cincinnati Reds,3,0,August 10 2018,3
Los Angeles Dodgers,1,Colorado Rockies,9,4,August 10 2018,5
Minnesota Twins,1,Detroit Tigers,8,3,August 10 2018,5
Seattle Mariners,0,Houston Astros,7,5,August 10 2018,2
St. Louis Cardinals,0,Kansas City Royals,7,7,August 10 2018,0
New York Mets,0,Miami Marlins,8,6,August 10 2018,2
Texas Rangers,0,New York Yankees,19,12,August 10 2018,7
Philadelphia Phillies,1,San Diego Padres,2,0,August 10 2018,2
Pittsburgh Pirates,1,San Francisco Giants,23,10,August 10 2018,13
Tampa Bay Rays,0,Toronto Blue Jays,7,7,August 10 2018,0
Oakland Athletics,0,Los Angeles Angels,7,7,August 11 2018,0
Milwaukee Brewers,0,Atlanta Braves,6,4,August 11 2018,2
Boston Red Sox,0,Baltimore Orioles,5,5,August 11 2018,0
Boston Red Sox,0,Baltimore Orioles,10,6,August 11 2018,4
Cleveland Indians,0,Chicago White Sox,4,3,August 11 2018,1
Washington Nationals,0,Chicago Cubs,13,9,August 11 2018,4
Arizona D'Backs,1,Cincinnati Reds,9,3,August 11 2018,6
Los Angeles Dodgers,1,Colorado Rockies,5,2,August 11 2018,3
Minnesota Twins,0,Detroit Tigers,7,4,August 11 2018,3
Seattle Mariners,0,Houston Astros,5,3,August 11 2018,2
St. Louis Cardinals,0,Kansas City Royals,11,8,August 11 2018,3
New York Mets,1,Miami Marlins,7,3,August 11 2018,4
Texas Rangers,1,New York Yankees,8,3,August 11 2018,5
Philadelphia Phillies,0,San Diego Padres,6,5,August 11 2018,1
Pittsburgh Pirates,0,San Francisco Giants,4,4,August 11 2018,0
Tampa Bay Rays,0,Toronto Blue Jays,4,3,August 11 2018,1
Oakland Athletics,0,Los Angeles Angels,15,8,August 12 2018,7
Milwaukee Brewers,1,Atlanta Braves,15,7,August 12 2018,8
Boston Red Sox,0,Baltimore Orioles,5,4,August 12 2018,1
Cleveland Indians,0,Chicago White Sox,16,9,August 12 2018,7
Washington Nationals,1,Chicago Cubs,7,3,August 12 2018,4
Arizona D'Backs,0,Cincinnati Reds,11,9,August 12 2018,2
Los Angeles Dodgers,1,Colorado Rockies,7,3,August 12 2018,4
Minnesota Twins,1,Detroit Tigers,6,2,August 12 2018,4
Seattle Mariners,0,Houston Astros,7,4,August 12 2018,3
St. Louis Cardinals,0,Kansas City Royals,10,8,August 12 2018,2
New York Mets,0,Miami Marlins,7,4,August 12 2018,3
Texas Rangers,1,New York Yankees,9,2,August 12 2018,7
Philadelphia Phillies,1,San Diego Padres,12,3,August 12 2018,9
Pittsburgh Pirates,1,San Francisco Giants,7,3,August 12 2018,4
Tampa Bay Rays,1,Toronto Blue Jays,3,1,August 12 2018,2
Miami Marlins,1,Atlanta Braves,10,1,August 13 2018,9
Miami Marlins,1,Atlanta Braves,7,1,August 13 2018,6
Cleveland Indians,0,Cincinnati Reds,13,10,August 13 2018,3
Chicago White Sox,1,Detroit Tigers,14,5,August 13 2018,9
Toronto Blue Jays,1,Kansas City Royals,4,1,August 13 2018,3
San Francisco Giants,0,Los Angeles Dodgers,7,5,August 13 2018,2
New York Mets,0,New York Yankees,13,8,August 13 2018,5
Seattle Mariners,1,Oakland Athletics,13,6,August 13 2018,7
Los Angeles Angels,0,San Diego Padres,9,6,August 13 2018,3
Washington Nationals,1,St. Louis Cardinals,13,6,August 13 2018,7
Arizona D'Backs,1,Texas Rangers,8,3,August 13 2018,5
Miami Marlins,1,Atlanta Braves,16,6,August 14 2018,10
New York Mets,1,Baltimore Orioles,9,3,August 14 2018,6
Milwaukee Brewers,0,Chicago Cubs,7,7,August 14 2018,0
Cleveland Indians,0,Cincinnati Reds,9,8,August 14 2018,1
Chicago White Sox,0,Detroit Tigers,9,6,August 14 2018,3
Colorado Rockies,0,Houston Astros,6,5,August 14 2018,1
Toronto Blue Jays,0,Kansas City Royals,11,6,August 14 2018,5
San Francisco Giants,0,Los Angeles Dodgers,3,2,August 14 2018,1
Pittsburgh Pirates,1,Minnesota Twins,7,2,August 14 2018,5
Tampa Bay Rays,1,New York Yankees,5,1,August 14 2018,4
Seattle Mariners,1,Oakland Athletics,5,2,August 14 2018,3
Boston Red Sox,0,Philadelphia Phillies,3,2,August 14 2018,1
Los Angeles Angels,0,San Diego Padres,10,7,August 14 2018,3
Washington Nationals,1,St. Louis Cardinals,10,4,August 14 2018,6
Arizona D'Backs,0,Texas Rangers,10,6,August 14 2018,4
Miami Marlins,1,Atlanta Braves,7,2,August 15 2018,5
New York Mets,0,Baltimore Orioles,21,16,August 15 2018,5
Milwaukee Brewers,1,Chicago Cubs,12,4,August 15 2018,8
Cleveland Indians,0,Cincinnati Reds,7,4,August 15 2018,3
Chicago White Sox,0,Detroit Tigers,11,6,August 15 2018,5
Colorado Rockies,1,Houston Astros,13,1,August 15 2018,12
Toronto Blue Jays,0,Kansas City Royals,11,6,August 15 2018,5
San Francisco Giants,1,Los Angeles Dodgers,7,3,August 15 2018,4
Pittsburgh Pirates,1,Minnesota Twins,10,4,August 15 2018,6
Tampa Bay Rays,0,New York Yankees,7,6,August 15 2018,1
Seattle Mariners,0,Oakland Athletics,2,2,August 15 2018,0
Boston Red Sox,1,Philadelphia Phillies,11,4,August 15 2018,7
Los Angeles Angels,0,San Diego Padres,5,3,August 15 2018,2
Washington Nationals,1,St. Louis Cardinals,6,2,August 15 2018,4
Colorado Rockies,0,Atlanta Braves,8,5,August 16 2018,3
Toronto Blue Jays,1,Kansas City Royals,8,2,August 16 2018,6
Detroit Tigers,1,Minnesota Twins,23,8,August 16 2018,15
Tampa Bay Rays,0,New York Yankees,4,3,August 16 2018,1
New York Mets,0,Philadelphia Phillies,28,24,August 16 2018,4
New York Mets,1,Philadelphia Phillies,15,6,August 16 2018,9
Chicago Cubs,0,Pittsburgh Pirates,1,1,August 16 2018,0
Arizona D'Backs,0,San Diego Padres,6,5,August 16 2018,1
Washington Nationals,0,St. Louis Cardinals,9,5,August 16 2018,4
Los Angeles Angels,1,Texas Rangers,14,6,August 16 2018,8
Colorado Rockies,0,Atlanta Braves,16,11,August 17 2018,5
Tampa Bay Rays,1,Boston Red Sox,10,3,August 17 2018,7
Kansas City Royals,1,Chicago White Sox,12,3,August 17 2018,9
San Francisco Giants,1,Cincinnati Reds,3,1,August 17 2018,2
Baltimore Orioles,1,Cleveland Indians,3,1,August 17 2018,2
Detroit Tigers,1,Minnesota Twins,9,4,August 17 2018,5
Toronto Blue Jays,1,New York Yankees,12,5,August 17 2018,7
Houston Astros,1,Oakland Athletics,7,3,August 17 2018,4
New York Mets,1,Philadelphia Phillies,6,2,August 17 2018,4
Chicago Cubs,0,Pittsburgh Pirates,1,1,August 17 2018,0
Arizona D'Backs,0,San Diego Padres,13,9,August 17 2018,4
Los Angeles Dodgers,0,Seattle Mariners,12,11,August 17 2018,1
Milwaukee Brewers,1,St. Louis Cardinals,7,2,August 17 2018,5
Los Angeles Angels,1,Texas Rangers,10,4,August 17 2018,6
Miami Marlins,1,Washington Nationals,10,2,August 17 2018,8
Colorado Rockies,0,Atlanta Braves,8,5,August 18 2018,3
Tampa Bay Rays,1,Boston Red Sox,7,2,August 18 2018,5
Kansas City Royals,0,Chicago White Sox,4,3,August 18 2018,1
San Francisco Giants,1,Cincinnati Reds,8,1,August 18 2018,7
Baltimore Orioles,0,Cleveland Indians,6,4,August 18 2018,2
Detroit Tigers,0,Minnesota Twins,12,7,August 18 2018,5
Toronto Blue Jays,1,New York Yankees,17,6,August 18 2018,11
Houston Astros,1,Oakland Athletics,8,1,August 18 2018,7
New York Mets,0,Philadelphia Phillies,4,3,August 18 2018,1
Chicago Cubs,1,Pittsburgh Pirates,4,1,August 18 2018,3
Arizona D'Backs,1,San Diego Padres,13,6,August 18 2018,7
Los Angeles Dodgers,1,Seattle Mariners,9,4,August 18 2018,5
Milwaukee Brewers,1,St. Louis Cardinals,9,2,August 18 2018,7
Los Angeles Angels,0,Texas Rangers,18,11,August 18 2018,7
Miami Marlins,0,Washington Nationals,12,7,August 18 2018,5
Colorado Rockies,0,Atlanta Braves,6,4,August 19 2018,2
Tampa Bay Rays,0,Boston Red Sox,2,2,August 19 2018,0
Kansas City Royals,1,Chicago White Sox,13,6,August 19 2018,7
San Francisco Giants,1,Cincinnati Reds,15,4,August 19 2018,11
Baltimore Orioles,1,Cleveland Indians,8,0,August 19 2018,8
Detroit Tigers,1,Minnesota Twins,9,4,August 19 2018,5
Toronto Blue Jays,1,New York Yankees,12,2,August 19 2018,10
Houston Astros,0,Oakland Athletics,13,9,August 19 2018,4
New York Mets,0,Philadelphia Phillies,10,8,August 19 2018,2
Chicago Cubs,1,Pittsburgh Pirates,3,1,August 19 2018,2
Arizona D'Backs,0,San Diego Padres,7,4,August 19 2018,3
Los Angeles Dodgers,0,Seattle Mariners,13,12,August 19 2018,1
Milwaukee Brewers,0,St. Louis Cardinals,3,2,August 19 2018,1
Los Angeles Angels,1,Texas Rangers,6,2,August 19 2018,4
Miami Marlins,0,Washington Nationals,13,12,August 19 2018,1
Cleveland Indians,0,Boston Red Sox,9,5,August 20 2018,4
St. Louis Cardinals,0,Los Angeles Dodgers,8,5,August 20 2018,3
Cincinnati Reds,1,Milwaukee Brewers,7,2,August 20 2018,5
Chicago White Sox,0,Minnesota Twins,13,8,August 20 2018,5
San Francisco Giants,0,New York Mets,3,2,August 20 2018,1
Texas Rangers,1,Oakland Athletics,9,0,August 20 2018,9
Atlanta Braves,0,Pittsburgh Pirates,1,1,August 20 2018,0
Houston Astros,1,Seattle Mariners,11,4,August 20 2018,7
Kansas City Royals,1,Tampa Bay Rays,1,0,August 20 2018,1
Baltimore Orioles,1,Toronto Blue Jays,8,3,August 20 2018,5
Los Angeles Angels,1,Arizona D'Backs,9,4,August 21 2018,5
Cleveland Indians,0,Boston Red Sox,9,6,August 21 2018,3
Minnesota Twins,0,Chicago White Sox,7,5,August 21 2018,2
San Diego Padres,0,Colorado Rockies,7,4,August 21 2018,3
Chicago Cubs,1,Detroit Tigers,3,1,August 21 2018,2
St. Louis Cardinals,0,Los Angeles Dodgers,7,5,August 21 2018,2
New York Yankees,0,Miami Marlins,3,2,August 21 2018,1
Cincinnati Reds,0,Milwaukee Brewers,16,9,August 21 2018,7
San Francisco Giants,1,New York Mets,9,3,August 21 2018,6
Texas Rangers,1,Oakland Athletics,6,0,August 21 2018,6
Atlanta Braves,0,Pittsburgh Pirates,7,6,August 21 2018,1
Houston Astros,0,Seattle Mariners,5,3,August 21 2018,2
Kansas City Royals,1,Tampa Bay Rays,5,1,August 21 2018,4
Baltimore Orioles,1,Toronto Blue Jays,10,2,August 21 2018,8
Philadelphia Phillies,1,Washington Nationals,14,4,August 21 2018,10
Los Angeles Angels,1,Arizona D'Backs,6,1,August 22 2018,5
Cleveland Indians,1,Boston Red Sox,14,4,August 22 2018,10
Minnesota Twins,1,Chicago White Sox,10,3,August 22 2018,7
San Diego Padres,1,Colorado Rockies,8,2,August 22 2018,6
Chicago Cubs,0,Detroit Tigers,10,8,August 22 2018,2
St. Louis Cardinals,0,Los Angeles Dodgers,4,3,August 22 2018,1
New York Yankees,1,Miami Marlins,12,3,August 22 2018,9
Cincinnati Reds,1,Milwaukee Brewers,4,0,August 22 2018,4
San Francisco Giants,1,New York Mets,8,3,August 22 2018,5
Texas Rangers,0,Oakland Athletics,6,4,August 22 2018,2
Atlanta Braves,0,Pittsburgh Pirates,3,2,August 22 2018,1
Houston Astros,0,Seattle Mariners,17,10,August 22 2018,7
Kansas City Royals,1,Tampa Bay Rays,9,3,August 22 2018,6
Baltimore Orioles,1,Toronto Blue Jays,6,0,August 22 2018,6
Philadelphia Phillies,1,Washington Nationals,15,7,August 22 2018,8
Cleveland Indians,1,Boston Red Sox,7,0,August 23 2018,7
Cincinnati Reds,1,Chicago Cubs,8,1,August 23 2018,7
San Diego Padres,1,Colorado Rockies,7,3,August 23 2018,4
Chicago White Sox,1,Detroit Tigers,9,2,August 23 2018,7
Atlanta Braves,0,Miami Marlins,5,5,August 23 2018,0
Oakland Athletics,1,Minnesota Twins,10,4,August 23 2018,6
San Francisco Giants,0,New York Mets,4,3,August 23 2018,1
Kansas City Royals,1,Tampa Bay Rays,7,3,August 23 2018,4
Philadelphia Phillies,0,Washington Nationals,2,2,August 23 2018,0
Houston Astros,0,Los Angeles Angels,12,9,August 24 2018,3
Seattle Mariners,0,Arizona D'Backs,9,6,August 24 2018,3
New York Yankees,0,Baltimore Orioles,12,7,August 24 2018,5
Cincinnati Reds,1,Chicago Cubs,5,2,August 24 2018,3
St. Louis Cardinals,0,Colorado Rockies,12,7,August 24 2018,5
Chicago White Sox,0,Detroit Tigers,9,6,August 24 2018,3
Cleveland Indians,1,Kansas City Royals,9,4,August 24 2018,5
San Diego Padres,1,Los Angeles Dodgers,12,1,August 24 2018,11
Atlanta Braves,1,Miami Marlins,1,0,August 24 2018,1
Pittsburgh Pirates,1,Milwaukee Brewers,13,6,August 24 2018,7
Oakland Athletics,0,Minnesota Twins,8,7,August 24 2018,1
Washington Nationals,1,New York Mets,3,0,August 24 2018,3
Texas Rangers,0,San Francisco Giants,13,7,August 24 2018,6
Boston Red Sox,1,Tampa Bay Rays,13,3,August 24 2018,10
Philadelphia Phillies,1,Toronto Blue Jays,6,2,August 24 2018,4
Houston Astros,0,Los Angeles Angels,11,8,August 25 2018,3
Seattle Mariners,0,Arizona D'Backs,7,4,August 25 2018,3
New York Yankees,0,Baltimore Orioles,13,10,August 25 2018,3
New York Yankees,0,Baltimore Orioles,6,5,August 25 2018,1
Cincinnati Reds,1,Chicago Cubs,16,6,August 25 2018,10
St. Louis Cardinals,1,Colorado Rockies,10,1,August 25 2018,9
Chicago White Sox,0,Detroit Tigers,7,6,August 25 2018,1
Cleveland Indians,1,Kansas City Royals,8,1,August 25 2018,7
San Diego Padres,1,Los Angeles Dodgers,9,4,August 25 2018,5
Atlanta Braves,1,Miami Marlins,4,1,August 25 2018,3
Pittsburgh Pirates,0,Milwaukee Brewers,10,9,August 25 2018,1
Oakland Athletics,0,Minnesota Twins,8,6,August 25 2018,2
Washington Nationals,1,New York Mets,3,0,August 25 2018,3
Texas Rangers,1,San Francisco Giants,8,3,August 25 2018,5
Boston Red Sox,1,Tampa Bay Rays,6,1,August 25 2018,5
Philadelphia Phillies,1,Toronto Blue Jays,14,6,August 25 2018,8
Houston Astros,0,Los Angeles Angels,4,3,August 26 2018,1
Seattle Mariners,1,Arizona D'Backs,7,2,August 26 2018,5
New York Yankees,0,Baltimore Orioles,8,5,August 26 2018,3
Cincinnati Reds,1,Chicago Cubs,9,0,August 26 2018,9
St. Louis Cardinals,0,Colorado Rockies,15,12,August 26 2018,3
Chicago White Sox,0,Detroit Tigers,9,7,August 26 2018,2
Cleveland Indians,0,Kansas City Royals,17,12,August 26 2018,5
San Diego Padres,1,Los Angeles Dodgers,10,3,August 26 2018,7
Atlanta Braves,0,Miami Marlins,4,4,August 26 2018,0
Pittsburgh Pirates,1,Milwaukee Brewers,11,4,August 26 2018,7
Oakland Athletics,0,Minnesota Twins,8,6,August 26 2018,2
Washington Nationals,0,New York Mets,15,15,August 26 2018,0
Texas Rangers,1,San Francisco Giants,4,1,August 26 2018,3
Boston Red Sox,1,Tampa Bay Rays,10,1,August 26 2018,9
Philadelphia Phillies,0,Toronto Blue Jays,11,8,August 26 2018,3
Colorado Rockies,1,Los Angeles Angels,17,7,August 27 2018,10
Toronto Blue Jays,1,Baltimore Orioles,7,0,August 27 2018,7
New York Mets,1,Chicago Cubs,11,4,August 27 2018,7
Oakland Athletics,1,Houston Astros,15,4,August 27 2018,11
Chicago White Sox,0,New York Yankees,8,6,August 27 2018,2
Washington Nationals,0,Philadelphia Phillies,8,5,August 27 2018,3
Arizona D'Backs,1,San Francisco Giants,2,0,August 27 2018,2
Colorado Rockies,0,Los Angeles Angels,5,3,August 28 2018,2
Tampa Bay Rays,1,Atlanta Braves,14,5,August 28 2018,9
Toronto Blue Jays,1,Baltimore Orioles,17,5,August 28 2018,12
Miami Marlins,1,Boston Red Sox,15,7,August 28 2018,8
New York Mets,1,Chicago Cubs,3,1,August 28 2018,2
Milwaukee Brewers,1,Cincinnati Reds,16,7,August 28 2018,9
Minnesota Twins,1,Cleveland Indians,9,1,August 28 2018,8
Oakland Athletics,0,Houston Astros,7,4,August 28 2018,3
Detroit Tigers,1,Kansas City Royals,8,2,August 28 2018,6
Chicago White Sox,1,New York Yankees,9,4,August 28 2018,5
Washington Nationals,0,Philadelphia Phillies,9,5,August 28 2018,4
Seattle Mariners,1,San Diego Padres,3,1,August 28 2018,2
Arizona D'Backs,1,San Francisco Giants,1,0,August 28 2018,1
Pittsburgh Pirates,1,St. Louis Cardinals,7,2,August 28 2018,5
Los Angeles Dodgers,0,Texas Rangers,12,8,August 28 2018,4
Tampa Bay Rays,0,Atlanta Braves,13,8,August 29 2018,5
Toronto Blue Jays,1,Baltimore Orioles,15,5,August 29 2018,10
Miami Marlins,1,Boston Red Sox,20,6,August 29 2018,14
New York Mets,0,Chicago Cubs,13,10,August 29 2018,3
Milwaukee Brewers,0,Cincinnati Reds,25,13,August 29 2018,12
Minnesota Twins,0,Cleveland Indians,7,4,August 29 2018,3
Oakland Athletics,1,Houston Astros,9,4,August 29 2018,5
Detroit Tigers,1,Kansas City Royals,11,2,August 29 2018,9
Chicago White Sox,0,New York Yankees,5,4,August 29 2018,1
Washington Nationals,1,Philadelphia Phillies,14,6,August 29 2018,8
Seattle Mariners,1,San Diego Padres,11,3,August 29 2018,8
Arizona D'Backs,0,San Francisco Giants,4,3,August 29 2018,1
Pittsburgh Pirates,0,St. Louis Cardinals,2,2,August 29 2018,0
Los Angeles Dodgers,0,Texas Rangers,4,3,August 29 2018,1
Chicago Cubs,0,Atlanta Braves,9,5,August 30 2018,4
Boston Red Sox,0,Chicago White Sox,13,9,August 30 2018,4
Milwaukee Brewers,0,Cincinnati Reds,3,2,August 30 2018,1
Minnesota Twins,1,Cleveland Indians,8,3,August 30 2018,5
Los Angeles Angels,0,Houston Astros,7,5,August 30 2018,2
Arizona D'Backs,0,Los Angeles Dodgers,4,3,August 30 2018,1
Detroit Tigers,0,New York Yankees,15,8,August 30 2018,7
Seattle Mariners,0,Oakland Athletics,8,7,August 30 2018,1
Colorado Rockies,1,San Diego Padres,5,2,August 30 2018,3
Pittsburgh Pirates,1,St. Louis Cardinals,5,0,August 30 2018,5
Pittsburgh Pirates,0,Atlanta Braves,5,3,August 31 2018,2
Boston Red Sox,1,Chicago White Sox,7,1,August 31 2018,6
Tampa Bay Rays,1,Cleveland Indians,3,0,August 31 2018,3
Los Angeles Angels,0,Houston Astros,3,3,August 31 2018,0
Baltimore Orioles,1,Kansas City Royals,11,2,August 31 2018,9
Arizona D'Backs,1,Los Angeles Dodgers,5,2,August 31 2018,3
Toronto Blue Jays,0,Miami Marlins,11,6,August 31 2018,5
Detroit Tigers,1,New York Yankees,12,5,August 31 2018,7
Seattle Mariners,1,Oakland Athletics,12,5,August 31 2018,7
Chicago Cubs,1,Philadelphia Phillies,3,1,August 31 2018,2
Colorado Rockies,1,San Diego Padres,7,0,August 31 2018,7
New York Mets,1,San Francisco Giants,7,0,August 31 2018,7
Cincinnati Reds,1,St. Louis Cardinals,17,5,August 31 2018,12
Minnesota Twins,0,Texas Rangers,17,10,August 31 2018,7
Milwaukee Brewers,0,Washington Nationals,5,4,August 31 2018,1
Pittsburgh Pirates,1,Atlanta Braves,8,3,September 1 2018,5
Boston Red Sox,0,Chicago White Sox,7,6,September 1 2018,1
Tampa Bay Rays,0,Cleveland Indians,8,5,September 1 2018,3
Los Angeles Angels,1,Houston Astros,10,3,September 1 2018,7
Baltimore Orioles,1,Kansas City Royals,9,4,September 1 2018,5
Arizona D'Backs,1,Los Angeles Dodgers,5,2,September 1 2018,3
Toronto Blue Jays,1,Miami Marlins,9,3,September 1 2018,6
Detroit Tigers,1,New York Yankees,3,1,September 1 2018,2
Seattle Mariners,0,Oakland Athletics,15,8,September 1 2018,7
Chicago Cubs,0,Philadelphia Phillies,8,7,September 1 2018,1
Colorado Rockies,0,San Diego Padres,6,4,September 1 2018,2
New York Mets,0,San Francisco Giants,3,2,September 1 2018,1
Cincinnati Reds,0,St. Louis Cardinals,4,4,September 1 2018,0
Minnesota Twins,1,Texas Rangers,11,4,September 1 2018,7
Milwaukee Brewers,1,Washington Nationals,9,4,September 1 2018,5
Pittsburgh Pirates,1,Atlanta Braves,6,1,September 2 2018,5
Boston Red Sox,1,Chicago White Sox,8,0,September 2 2018,8
Tampa Bay Rays,0,Cleveland Indians,10,6,September 2 2018,4
Los Angeles Angels,1,Houston Astros,6,2,September 2 2018,4
Baltimore Orioles,1,Kansas City Royals,10,1,September 2 2018,9
Arizona D'Backs,1,Los Angeles Dodgers,5,2,September 2 2018,3
Toronto Blue Jays,0,Miami Marlins,7,6,September 2 2018,1
Detroit Tigers,0,New York Yankees,18,11,September 2 2018,7
Seattle Mariners,1,Oakland Athletics,10,2,September 2 2018,8
Chicago Cubs,0,Philadelphia Phillies,9,8,September 2 2018,1
Colorado Rockies,0,San Diego Padres,10,7,September 2 2018,3
New York Mets,0,San Francisco Giants,5,4,September 2 2018,1
Cincinnati Reds,0,St. Louis Cardinals,10,6,September 2 2018,4
Minnesota Twins,1,Texas Rangers,22,4,September 2 2018,18
Milwaukee Brewers,0,Washington Nationals,13,9,September 2 2018,4
San Diego Padres,0,Arizona D'Backs,8,6,September 3 2018,2
Boston Red Sox,0,Atlanta Braves,10,8,September 3 2018,2
Detroit Tigers,1,Chicago White Sox,6,2,September 3 2018,4
Kansas City Royals,0,Cleveland Indians,6,5,September 3 2018,1
San Francisco Giants,1,Colorado Rockies,17,8,September 3 2018,9
Minnesota Twins,1,Houston Astros,5,1,September 3 2018,4
New York Mets,0,Los Angeles Dodgers,6,4,September 3 2018,2
Philadelphia Phillies,1,Miami Marlins,4,1,September 3 2018,3
Chicago Cubs,1,Milwaukee Brewers,7,3,September 3 2018,4
New York Yankees,1,Oakland Athletics,9,3,September 3 2018,6
Cincinnati Reds,1,Pittsburgh Pirates,6,1,September 3 2018,5
Baltimore Orioles,1,Seattle Mariners,3,1,September 3 2018,2
Los Angeles Angels,0,Texas Rangers,4,3,September 3 2018,1
Tampa Bay Rays,0,Toronto Blue Jays,8,7,September 3 2018,1
St. Louis Cardinals,1,Washington Nationals,7,3,September 3 2018,4
San Diego Padres,1,Arizona D'Backs,6,0,September 4 2018,6
Boston Red Sox,0,Atlanta Braves,6,5,September 4 2018,1
Detroit Tigers,0,Chicago White Sox,11,8,September 4 2018,3
Kansas City Royals,1,Cleveland Indians,12,3,September 4 2018,9
San Francisco Giants,1,Colorado Rockies,8,2,September 4 2018,6
Minnesota Twins,1,Houston Astros,7,2,September 4 2018,5
New York Mets,1,Los Angeles Dodgers,15,4,September 4 2018,11
Philadelphia Phillies,0,Miami Marlins,13,9,September 4 2018,4
Chicago Cubs,1,Milwaukee Brewers,12,1,September 4 2018,11
New York Yankees,0,Oakland Athletics,6,5,September 4 2018,1
Cincinnati Reds,1,Pittsburgh Pirates,10,3,September 4 2018,7
Baltimore Orioles,0,Seattle Mariners,8,5,September 4 2018,3
Los Angeles Angels,1,Texas Rangers,6,2,September 4 2018,4
Tampa Bay Rays,0,Toronto Blue Jays,4,4,September 4 2018,0
St. Louis Cardinals,0,Washington Nationals,19,11,September 4 2018,8
Boston Red Sox,0,Atlanta Braves,17,9,September 5 2018,8
Detroit Tigers,0,Chicago White Sox,12,10,September 5 2018,2
Kansas City Royals,1,Cleveland Indians,4,1,September 5 2018,3
San Francisco Giants,1,Colorado Rockies,8,3,September 5 2018,5
Minnesota Twins,1,Houston Astros,10,1,September 5 2018,9
New York Mets,0,Los Angeles Dodgers,10,7,September 5 2018,3
Philadelphia Phillies,1,Miami Marlins,3,1,September 5 2018,2
Chicago Cubs,0,Milwaukee Brewers,10,6,September 5 2018,4
New York Yankees,1,Oakland Athletics,10,2,September 5 2018,8
Cincinnati Reds,1,Pittsburgh Pirates,5,2,September 5 2018,3
Baltimore Orioles,1,Seattle Mariners,7,2,September 5 2018,5
Los Angeles Angels,0,Texas Rangers,12,9,September 5 2018,3
Tampa Bay Rays,1,Toronto Blue Jays,13,3,September 5 2018,10
St. Louis Cardinals,0,Washington Nationals,13,7,September 5 2018,6
Atlanta Braves,0,Arizona D'Backs,13,7,September 6 2018,6
San Diego Padres,0,Cincinnati Reds,8,6,September 6 2018,2
Cleveland Indians,0,Toronto Blue Jays,13,9,September 6 2018,4
Chicago Cubs,0,Washington Nationals,10,6,September 6 2018,4
Atlanta Braves,1,Arizona D'Backs,8,3,September 7 2018,5
Houston Astros,0,Boston Red Sox,9,6,September 7 2018,3
Los Angeles Angels,0,Chicago White Sox,7,5,September 7 2018,2
San Diego Padres,1,Cincinnati Reds,18,6,September 7 2018,12
Los Angeles Dodgers,0,Colorado Rockies,6,4,September 7 2018,2
St. Louis Cardinals,1,Detroit Tigers,8,3,September 7 2018,5
San Francisco Giants,1,Milwaukee Brewers,6,2,September 7 2018,4
Kansas City Royals,1,Minnesota Twins,16,6,September 7 2018,10
Philadelphia Phillies,0,New York Mets,7,4,September 7 2018,3
Texas Rangers,1,Oakland Athletics,12,4,September 7 2018,8
Miami Marlins,1,Pittsburgh Pirates,8,3,September 7 2018,5
New York Yankees,0,Seattle Mariners,4,4,September 7 2018,0
Baltimore Orioles,1,Tampa Bay Rays,16,2,September 7 2018,14
Cleveland Indians,1,Toronto Blue Jays,5,2,September 7 2018,3
Atlanta Braves,0,Arizona D'Backs,9,5,September 8 2018,4
Houston Astros,0,Boston Red Sox,8,5,September 8 2018,3
Los Angeles Angels,0,Chicago White Sox,15,12,September 8 2018,3
San Diego Padres,1,Cincinnati Reds,9,2,September 8 2018,7
Los Angeles Dodgers,1,Colorado Rockies,6,2,September 8 2018,4
St. Louis Cardinals,1,Detroit Tigers,7,3,September 8 2018,4
San Francisco Giants,1,Milwaukee Brewers,7,3,September 8 2018,4
Kansas City Royals,0,Minnesota Twins,5,4,September 8 2018,1
Philadelphia Phillies,1,New York Mets,15,5,September 8 2018,10
Texas Rangers,1,Oakland Athletics,14,6,September 8 2018,8
Miami Marlins,1,Pittsburgh Pirates,6,1,September 8 2018,5
New York Yankees,0,Seattle Mariners,6,4,September 8 2018,2
Baltimore Orioles,1,Tampa Bay Rays,15,5,September 8 2018,10
Cleveland Indians,0,Toronto Blue Jays,17,9,September 8 2018,8
Chicago Cubs,1,Washington Nationals,13,3,September 8 2018,10
Chicago Cubs,1,Washington Nationals,11,5,September 8 2018,6
Atlanta Braves,0,Arizona D'Backs,14,9,September 9 2018,5
Houston Astros,1,Boston Red Sox,11,5,September 9 2018,6
Los Angeles Angels,0,Chicago White Sox,1,1,September 9 2018,0
San Diego Padres,0,Cincinnati Reds,13,7,September 9 2018,6
Los Angeles Dodgers,0,Colorado Rockies,15,9,September 9 2018,6
St. Louis Cardinals,0,Detroit Tigers,7,5,September 9 2018,2
San Francisco Giants,1,Milwaukee Brewers,9,3,September 9 2018,6
Kansas City Royals,1,Minnesota Twins,4,1,September 9 2018,3
Philadelphia Phillies,1,New York Mets,10,4,September 9 2018,6
Texas Rangers,1,Oakland Athletics,10,3,September 9 2018,7
New York Yankees,1,Seattle Mariners,5,2,September 9 2018,3
Baltimore Orioles,1,Tampa Bay Rays,11,3,September 9 2018,8
Cleveland Indians,1,Toronto Blue Jays,8,2,September 9 2018,6
Texas Rangers,0,Los Angeles Angels,7,5,September 10 2018,2
Milwaukee Brewers,0,Chicago Cubs,5,3,September 10 2018,2
Los Angeles Dodgers,1,Cincinnati Reds,16,6,September 10 2018,10
Arizona D'Backs,1,Colorado Rockies,15,2,September 10 2018,13
Houston Astros,0,Detroit Tigers,5,3,September 10 2018,2
Chicago White Sox,1,Kansas City Royals,7,3,September 10 2018,4
New York Yankees,0,Minnesota Twins,9,7,September 10 2018,2
Atlanta Braves,0,San Francisco Giants,5,4,September 10 2018,1
Pittsburgh Pirates,1,St. Louis Cardinals,15,7,September 10 2018,8
Cleveland Indians,1,Tampa Bay Rays,11,5,September 10 2018,6
Texas Rangers,1,Los Angeles Angels,1,0,September 11 2018,1
Oakland Athletics,0,Baltimore Orioles,5,3,September 11 2018,2
Toronto Blue Jays,1,Boston Red Sox,9,2,September 11 2018,7
Milwaukee Brewers,1,Chicago Cubs,3,0,September 11 2018,3
Los Angeles Dodgers,1,Cincinnati Reds,4,1,September 11 2018,3
Arizona D'Backs,0,Colorado Rockies,9,6,September 11 2018,3
Houston Astros,0,Detroit Tigers,9,5,September 11 2018,4
Chicago White Sox,1,Kansas City Royals,9,3,September 11 2018,6
New York Yankees,1,Minnesota Twins,15,5,September 11 2018,10
Miami Marlins,0,New York Mets,8,5,September 11 2018,3
Washington Nationals,0,Philadelphia Phillies,4,3,September 11 2018,1
Washington Nationals,0,Philadelphia Phillies,13,7,September 11 2018,6
San Diego Padres,0,Seattle Mariners,3,2,September 11 2018,1
Atlanta Braves,0,San Francisco Giants,5,4,September 11 2018,1
Pittsburgh Pirates,1,St. Louis Cardinals,16,5,September 11 2018,11
Cleveland Indians,0,Tampa Bay Rays,2,2,September 11 2018,0
Texas Rangers,1,Los Angeles Angels,9,1,September 12 2018,8
Oakland Athletics,0,Baltimore Orioles,10,10,September 12 2018,0
Toronto Blue Jays,1,Boston Red Sox,1,0,September 12 2018,1
Milwaukee Brewers,0,Chicago Cubs,6,5,September 12 2018,1
Los Angeles Dodgers,0,Cincinnati Reds,9,8,September 12 2018,1
Arizona D'Backs,1,Colorado Rockies,9,4,September 12 2018,5
Houston Astros,0,Detroit Tigers,9,5,September 12 2018,4
Chicago White Sox,0,Kansas City Royals,6,4,September 12 2018,2
New York Yankees,1,Minnesota Twins,4,1,September 12 2018,3
Miami Marlins,1,New York Mets,13,0,September 12 2018,13
Washington Nationals,0,Philadelphia Phillies,6,5,September 12 2018,1
San Diego Padres,0,Seattle Mariners,9,5,September 12 2018,4
Atlanta Braves,0,San Francisco Giants,3,2,September 12 2018,1
Pittsburgh Pirates,0,St. Louis Cardinals,7,4,September 12 2018,3
Cleveland Indians,1,Tampa Bay Rays,4,1,September 12 2018,3
Seattle Mariners,0,Los Angeles Angels,10,8,September 13 2018,2
Oakland Athletics,1,Baltimore Orioles,8,3,September 13 2018,5
Toronto Blue Jays,1,Boston Red Sox,7,3,September 13 2018,4
Arizona D'Backs,1,Colorado Rockies,13,3,September 13 2018,10
Minnesota Twins,1,Kansas City Royals,10,4,September 13 2018,6
Miami Marlins,1,New York Mets,7,3,September 13 2018,4
Miami Marlins,1,New York Mets,7,2,September 13 2018,5
Los Angeles Dodgers,0,St. Louis Cardinals,16,9,September 13 2018,7
Chicago Cubs,0,Washington Nationals,7,4,September 13 2018,3
Seattle Mariners,0,Los Angeles Angels,5,5,September 14 2018,0
Washington Nationals,1,Atlanta Braves,15,5,September 14 2018,10
Chicago White Sox,0,Baltimore Orioles,14,8,September 14 2018,6
New York Mets,0,Boston Red Sox,8,8,September 14 2018,0
Cincinnati Reds,1,Chicago Cubs,5,2,September 14 2018,3
Detroit Tigers,0,Cleveland Indians,9,5,September 14 2018,4
Arizona D'Backs,0,Houston Astros,6,4,September 14 2018,2
Minnesota Twins,1,Kansas City Royals,12,4,September 14 2018,8
Pittsburgh Pirates,1,Milwaukee Brewers,11,4,September 14 2018,7
Toronto Blue Jays,1,New York Yankees,11,0,September 14 2018,11
Miami Marlins,1,Philadelphia Phillies,16,2,September 14 2018,14
Texas Rangers,0,San Diego Padres,4,4,September 14 2018,0
Colorado Rockies,1,San Francisco Giants,2,0,September 14 2018,2
Los Angeles Dodgers,0,St. Louis Cardinals,3,3,September 14 2018,0
Oakland Athletics,0,Tampa Bay Rays,3,2,September 14 2018,1
Seattle Mariners,0,Los Angeles Angels,11,6,September 15 2018,5
Washington Nationals,0,Atlanta Braves,8,7,September 15 2018,1
Chicago White Sox,0,Baltimore Orioles,2,2,September 15 2018,0
New York Mets,1,Boston Red Sox,8,3,September 15 2018,5
Cincinnati Reds,1,Chicago Cubs,1,0,September 15 2018,1
Detroit Tigers,1,Cleveland Indians,15,0,September 15 2018,15
Arizona D'Backs,1,Houston Astros,14,4,September 15 2018,10
Minnesota Twins,1,Kansas City Royals,13,3,September 15 2018,10
Pittsburgh Pirates,0,Milwaukee Brewers,4,3,September 15 2018,1
Toronto Blue Jays,0,New York Yankees,15,8,September 15 2018,7
Miami Marlins,1,Philadelphia Phillies,9,4,September 15 2018,5
Texas Rangers,0,San Diego Padres,9,6,September 15 2018,3
Colorado Rockies,1,San Francisco Giants,3,0,September 15 2018,3
Los Angeles Dodgers,0,St. Louis Cardinals,21,17,September 15 2018,4
Oakland Athletics,1,Tampa Bay Rays,12,5,September 15 2018,7
Seattle Mariners,1,Los Angeles Angels,7,3,September 16 2018,4
Washington Nationals,0,Atlanta Braves,10,6,September 16 2018,4
Chicago White Sox,1,Baltimore Orioles,12,4,September 16 2018,8
New York Mets,1,Boston Red Sox,7,3,September 16 2018,4
Cincinnati Reds,0,Chicago Cubs,3,2,September 16 2018,1
Detroit Tigers,0,Cleveland Indians,10,6,September 16 2018,4
Arizona D'Backs,1,Houston Astros,9,4,September 16 2018,5
Minnesota Twins,0,Kansas City Royals,15,9,September 16 2018,6
Pittsburgh Pirates,0,Milwaukee Brewers,5,3,September 16 2018,2
Toronto Blue Jays,0,New York Yankees,5,3,September 16 2018,2
Miami Marlins,0,Philadelphia Phillies,10,6,September 16 2018,4
Texas Rangers,1,San Diego Padres,10,3,September 16 2018,7
Colorado Rockies,0,San Francisco Giants,5,3,September 16 2018,2
Los Angeles Dodgers,1,St. Louis Cardinals,5,0,September 16 2018,5
Oakland Athletics,1,Tampa Bay Rays,9,4,September 16 2018,5
Chicago Cubs,0,Arizona D'Backs,6,5,September 17 2018,1
St. Louis Cardinals,0,Atlanta Braves,17,11,September 17 2018,6
Toronto Blue Jays,0,Baltimore Orioles,5,5,September 17 2018,0
Minnesota Twins,0,Detroit Tigers,7,6,September 17 2018,1
Seattle Mariners,0,Houston Astros,5,4,September 17 2018,1
Colorado Rockies,1,Los Angeles Dodgers,10,2,September 17 2018,8
Washington Nationals,1,Miami Marlins,13,5,September 17 2018,8
Cincinnati Reds,1,Milwaukee Brewers,8,0,September 17 2018,8
New York Mets,0,Philadelphia Phillies,13,9,September 17 2018,4
Kansas City Royals,1,Pittsburgh Pirates,13,6,September 17 2018,7
San Francisco Giants,0,San Diego Padres,6,4,September 17 2018,2
Tampa Bay Rays,0,Texas Rangers,3,3,September 17 2018,0
Chicago Cubs,0,Arizona D'Backs,10,9,September 18 2018,1
St. Louis Cardinals,0,Atlanta Braves,9,8,September 18 2018,1
Toronto Blue Jays,0,Baltimore Orioles,10,6,September 18 2018,4
Chicago White Sox,1,Cleveland Indians,8,3,September 18 2018,5
Minnesota Twins,0,Detroit Tigers,8,5,September 18 2018,3
Seattle Mariners,1,Houston Astros,7,0,September 18 2018,7
Colorado Rockies,1,Los Angeles Dodgers,5,2,September 18 2018,3
Washington Nationals,0,Miami Marlins,6,4,September 18 2018,2
Cincinnati Reds,0,Milwaukee Brewers,4,3,September 18 2018,1
Boston Red Sox,1,New York Yankees,5,2,September 18 2018,3
Los Angeles Angels,0,Oakland Athletics,16,9,September 18 2018,7
New York Mets,1,Philadelphia Phillies,7,2,September 18 2018,5
Kansas City Royals,1,Pittsburgh Pirates,3,1,September 18 2018,2
San Francisco Giants,0,San Diego Padres,9,5,September 18 2018,4
Tampa Bay Rays,0,Texas Rangers,4,4,September 18 2018,0
Chicago Cubs,1,Arizona D'Backs,9,0,September 19 2018,9
St. Louis Cardinals,1,Atlanta Braves,10,3,September 19 2018,7
Toronto Blue Jays,1,Baltimore Orioles,3,1,September 19 2018,2
Chicago White Sox,1,Cleveland Indians,5,1,September 19 2018,4
Minnesota Twins,0,Detroit Tigers,10,8,September 19 2018,2
Seattle Mariners,0,Houston Astros,9,9,September 19 2018,0
Colorado Rockies,1,Los Angeles Dodgers,7,2,September 19 2018,5
Cincinnati Reds,1,Milwaukee Brewers,7,0,September 19 2018,7
Boston Red Sox,1,New York Yankees,11,1,September 19 2018,10
Los Angeles Angels,1,Oakland Athletics,10,0,September 19 2018,10
New York Mets,1,Philadelphia Phillies,4,0,September 19 2018,4
Kansas City Royals,1,Pittsburgh Pirates,3,1,September 19 2018,2
San Francisco Giants,1,San Diego Padres,12,4,September 19 2018,8
Tampa Bay Rays,0,Texas Rangers,12,9,September 19 2018,3
Philadelphia Phillies,1,Atlanta Braves,11,3,September 20 2018,8
Chicago White Sox,0,Cleveland Indians,9,5,September 20 2018,4
Kansas City Royals,1,Detroit Tigers,19,8,September 20 2018,11
Cincinnati Reds,0,Miami Marlins,6,4,September 20 2018,2
Boston Red Sox,0,New York Yankees,17,11,September 20 2018,6
Los Angeles Angels,1,Oakland Athletics,24,3,September 20 2018,21
Tampa Bay Rays,1,Toronto Blue Jays,17,8,September 20 2018,9
New York Mets,0,Washington Nationals,9,5,September 20 2018,4
Colorado Rockies,0,Arizona D'Backs,8,6,September 21 2018,2
Philadelphia Phillies,1,Atlanta Braves,11,5,September 21 2018,6
Chicago Cubs,1,Chicago White Sox,14,4,September 21 2018,10
Boston Red Sox,0,Cleveland Indians,12,7,September 21 2018,5
Kansas City Royals,0,Detroit Tigers,7,4,September 21 2018,3
Los Angeles Angels,1,Houston Astros,14,3,September 21 2018,11
San Diego Padres,0,Los Angeles Dodgers,8,5,September 21 2018,3
Cincinnati Reds,1,Miami Marlins,1,0,September 21 2018,1
Baltimore Orioles,1,New York Yankees,18,8,September 21 2018,10
Minnesota Twins,1,Oakland Athletics,13,6,September 21 2018,7
Milwaukee Brewers,0,Pittsburgh Pirates,11,8,September 21 2018,3
San Francisco Giants,1,St. Louis Cardinals,8,3,September 21 2018,5
Seattle Mariners,1,Texas Rangers,11,3,September 21 2018,8
Tampa Bay Rays,0,Toronto Blue Jays,14,11,September 21 2018,3
New York Mets,0,Washington Nationals,6,4,September 21 2018,2
Colorado Rockies,0,Arizona D'Backs,6,5,September 22 2018,1
Philadelphia Phillies,1,Atlanta Braves,8,3,September 22 2018,5
Chicago Cubs,0,Chicago White Sox,11,8,September 22 2018,3
Boston Red Sox,1,Cleveland Indians,9,4,September 22 2018,5
Kansas City Royals,1,Detroit Tigers,9,4,September 22 2018,5
Los Angeles Angels,1,Houston Astros,15,5,September 22 2018,10
San Diego Padres,1,Los Angeles Dodgers,9,2,September 22 2018,7
Cincinnati Reds,1,Miami Marlins,6,1,September 22 2018,5
Baltimore Orioles,1,New York Yankees,5,2,September 22 2018,3
Minnesota Twins,1,Oakland Athletics,5,2,September 22 2018,3
Milwaukee Brewers,1,Pittsburgh Pirates,3,0,September 22 2018,3
San Francisco Giants,1,St. Louis Cardinals,9,4,September 22 2018,5
Seattle Mariners,0,Texas Rangers,13,13,September 22 2018,0
Tampa Bay Rays,1,Toronto Blue Jays,7,2,September 22 2018,5
New York Mets,1,Washington Nationals,6,0,September 22 2018,6
Colorado Rockies,0,Arizona D'Backs,2,2,September 23 2018,0
Philadelphia Phillies,1,Atlanta Braves,3,1,September 23 2018,2
Chicago Cubs,0,Chicago White Sox,7,6,September 23 2018,1
Boston Red Sox,1,Cleveland Indians,7,3,September 23 2018,4
Kansas City Royals,0,Detroit Tigers,5,3,September 23 2018,2
Los Angeles Angels,1,Houston Astros,8,2,September 23 2018,6
San Diego Padres,1,Los Angeles Dodgers,14,0,September 23 2018,14
Cincinnati Reds,1,Miami Marlins,6,0,September 23 2018,6
Baltimore Orioles,0,New York Yankees,9,6,September 23 2018,3
Minnesota Twins,0,Oakland Athletics,6,5,September 23 2018,1
Milwaukee Brewers,0,Pittsburgh Pirates,19,13,September 23 2018,6
San Francisco Giants,1,St. Louis Cardinals,11,2,September 23 2018,9
Seattle Mariners,1,Texas Rangers,7,1,September 23 2018,6
Tampa Bay Rays,0,Toronto Blue Jays,7,5,September 23 2018,2
New York Mets,0,Washington Nationals,14,8,September 23 2018,6
Texas Rangers,1,Los Angeles Angels,9,4,September 24 2018,5
Los Angeles Dodgers,0,Arizona D'Backs,11,7,September 24 2018,4
Baltimore Orioles,1,Boston Red Sox,8,2,September 24 2018,6
Cleveland Indians,0,Chicago White Sox,4,4,September 24 2018,0
Pittsburgh Pirates,0,Chicago Cubs,6,5,September 24 2018,1
Philadelphia Phillies,1,Colorado Rockies,11,1,September 24 2018,10
Oakland Athletics,0,Seattle Mariners,10,7,September 24 2018,3
San Diego Padres,0,San Francisco Giants,5,5,September 24 2018,0
Milwaukee Brewers,0,St. Louis Cardinals,10,6,September 24 2018,4
New York Yankees,0,Tampa Bay Rays,5,4,September 24 2018,1
Houston Astros,0,Toronto Blue Jays,8,5,September 24 2018,3
Miami Marlins,1,Washington Nationals,10,3,September 24 2018,7
Texas Rangers,1,Los Angeles Angels,5,1,September 25 2018,4
Los Angeles Dodgers,1,Arizona D'Backs,7,3,September 25 2018,4
Cleveland Indians,1,Chicago White Sox,9,4,September 25 2018,5
Pittsburgh Pirates,0,Chicago Cubs,6,6,September 25 2018,0
Kansas City Royals,0,Cincinnati Reds,7,4,September 25 2018,3
Philadelphia Phillies,1,Colorado Rockies,13,3,September 25 2018,10
Detroit Tigers,0,Minnesota Twins,6,4,September 25 2018,2
Atlanta Braves,0,New York Mets,10,7,September 25 2018,3
Oakland Athletics,1,Seattle Mariners,18,8,September 25 2018,10
San Diego Padres,1,San Francisco Giants,9,4,September 25 2018,5
Milwaukee Brewers,0,St. Louis Cardinals,16,12,September 25 2018,4
New York Yankees,0,Tampa Bay Rays,11,9,September 25 2018,2
Houston Astros,0,Toronto Blue Jays,5,4,September 25 2018,1
Miami Marlins,1,Washington Nationals,13,4,September 25 2018,9
Texas Rangers,1,Los Angeles Angels,5,2,September 26 2018,3
Los Angeles Dodgers,1,Arizona D'Backs,9,2,September 26 2018,7
Baltimore Orioles,1,Boston Red Sox,22,3,September 26 2018,19
Baltimore Orioles,0,Boston Red Sox,13,10,September 26 2018,3
Cleveland Indians,0,Chicago White Sox,12,10,September 26 2018,2
Pittsburgh Pirates,1,Chicago Cubs,13,6,September 26 2018,7
Kansas City Royals,0,Cincinnati Reds,7,6,September 26 2018,1
Philadelphia Phillies,1,Colorado Rockies,14,0,September 26 2018,14
Detroit Tigers,1,Minnesota Twins,15,4,September 26 2018,11
Atlanta Braves,1,New York Mets,3,0,September 26 2018,3
Oakland Athletics,0,Seattle Mariners,12,9,September 26 2018,3
San Diego Padres,0,San Francisco Giants,5,3,September 26 2018,2
Milwaukee Brewers,0,St. Louis Cardinals,3,2,September 26 2018,1
New York Yankees,1,Tampa Bay Rays,15,7,September 26 2018,8
Houston Astros,1,Toronto Blue Jays,4,1,September 26 2018,3
Miami Marlins,1,Washington Nationals,12,3,September 26 2018,9
Pittsburgh Pirates,1,Chicago Cubs,3,0,September 27 2018,3
Philadelphia Phillies,1,Colorado Rockies,8,3,September 27 2018,5
Cleveland Indians,1,Kansas City Royals,3,1,September 27 2018,2
Detroit Tigers,1,Minnesota Twins,12,3,September 27 2018,9
Atlanta Braves,1,New York Mets,5,1,September 27 2018,4
Texas Rangers,0,Seattle Mariners,2,2,September 27 2018,0
New York Yankees,0,Tampa Bay Rays,13,12,September 27 2018,1
Oakland Athletics,1,Los Angeles Angels,13,5,September 28 2018,8
Houston Astros,0,Baltimore Orioles,3,2,September 28 2018,1
New York Yankees,0,Boston Red Sox,17,11,September 28 2018,6
St. Louis Cardinals,1,Chicago Cubs,12,4,September 28 2018,8
Pittsburgh Pirates,0,Cincinnati Reds,12,8,September 28 2018,4
Washington Nationals,1,Colorado Rockies,7,2,September 28 2018,5
Cleveland Indians,0,Kansas City Royals,20,14,September 28 2018,6
Detroit Tigers,1,Milwaukee Brewers,11,5,September 28 2018,6
Chicago White Sox,1,Minnesota Twins,3,1,September 28 2018,2
Chicago White Sox,1,Minnesota Twins,16,4,September 28 2018,12
Miami Marlins,0,New York Mets,9,8,September 28 2018,1
Atlanta Braves,0,Philadelphia Phillies,12,10,September 28 2018,2
Arizona D'Backs,1,San Diego Padres,5,2,September 28 2018,3
Texas Rangers,1,Seattle Mariners,18,6,September 28 2018,12
Los Angeles Dodgers,0,San Francisco Giants,4,3,September 28 2018,1
Toronto Blue Jays,0,Tampa Bay Rays,13,7,September 28 2018,6
Oakland Athletics,0,Los Angeles Angels,7,5,September 29 2018,2
Houston Astros,0,Baltimore Orioles,7,4,September 29 2018,3
Houston Astros,0,Baltimore Orioles,7,5,September 29 2018,2
New York Yankees,0,Boston Red Sox,13,8,September 29 2018,5
St. Louis Cardinals,0,Chicago Cubs,3,2,September 29 2018,1
Pittsburgh Pirates,1,Cincinnati Reds,3,0,September 29 2018,3
Washington Nationals,0,Colorado Rockies,14,12,September 29 2018,2
Cleveland Indians,1,Kansas City Royals,13,4,September 29 2018,9
Detroit Tigers,1,Milwaukee Brewers,11,5,September 29 2018,6
Chicago White Sox,1,Minnesota Twins,11,3,September 29 2018,8
Miami Marlins,1,New York Mets,1,0,September 29 2018,1
Atlanta Braves,1,Philadelphia Phillies,3,0,September 29 2018,3
Arizona D'Backs,0,San Diego Padres,9,5,September 29 2018,4
Texas Rangers,1,Seattle Mariners,5,1,September 29 2018,4
Los Angeles Dodgers,0,San Francisco Giants,16,10,September 29 2018,6
Toronto Blue Jays,1,Tampa Bay Rays,7,3,September 29 2018,4
Oakland Athletics,1,Los Angeles Angels,9,4,September 30 2018,5
Houston Astros,1,Baltimore Orioles,4,0,September 30 2018,4
New York Yankees,1,Boston Red Sox,12,2,September 30 2018,10
St. Louis Cardinals,1,Chicago Cubs,15,5,September 30 2018,10
Pittsburgh Pirates,0,Cincinnati Reds,11,6,September 30 2018,5
Washington Nationals,1,Colorado Rockies,12,0,September 30 2018,12
Cleveland Indians,0,Kansas City Royals,3,2,September 30 2018,1
Detroit Tigers,1,Milwaukee Brewers,11,0,September 30 2018,11
Chicago White Sox,1,Minnesota Twins,9,4,September 30 2018,5
Miami Marlins,1,New York Mets,1,0,September 30 2018,1
Atlanta Braves,1,Philadelphia Phillies,4,1,September 30 2018,3
Arizona D'Backs,1,San Diego Padres,7,3,September 30 2018,4
Texas Rangers,1,Seattle Mariners,4,1,September 30 2018,3
Los Angeles Dodgers,0,San Francisco Giants,15,15,September 30 2018,0
Toronto Blue Jays,1,Tampa Bay Rays,13,4,September 30 2018,9
Milwaukee Brewers,0,Chicago Cubs,4,3,October 1 2018,1
Colorado Rockies,1,Los Angeles Dodgers,7,2,October 1 2018,5
Colorado Rockies,0,Chicago Cubs,3,2,October 2 2018,1
Oakland Athletics,1,New York Yankees,9,2,October 3 2018,7
Atlanta Braves,1,Los Angeles Dodgers,6,0,October 4 2018,6
Colorado Rockies,1,Milwaukee Brewers,5,2,October 4 2018,3
New York Yankees,1,Boston Red Sox,9,4,October 5 2018,5
Cleveland Indians,1,Houston Astros,9,2,October 5 2018,7
Atlanta Braves,1,Los Angeles Dodgers,3,0,October 5 2018,3
Colorado Rockies,1,Milwaukee Brewers,4,0,October 5 2018,4
New York Yankees,0,Boston Red Sox,8,6,October 6 2018,2
Cleveland Indians,1,Houston Astros,4,1,October 6 2018,3
Los Angeles Dodgers,1,Atlanta Braves,11,5,October 7 2018,6
Milwaukee Brewers,0,Colorado Rockies,6,6,October 7 2018,0
Los Angeles Dodgers,0,Atlanta Braves,8,6,October 8 2018,2
Houston Astros,0,Cleveland Indians,14,11,October 8 2018,3
Boston Red Sox,0,New York Yankees,17,16,October 8 2018,1
Boston Red Sox,0,New York Yankees,7,4,October 9 2018,3
Los Angeles Dodgers,1,Milwaukee Brewers,11,5,October 12 2018,6
Houston Astros,0,Boston Red Sox,9,7,October 13 2018,2
Los Angeles Dodgers,0,Milwaukee Brewers,7,4,October 13 2018,3
Houston Astros,1,Boston Red Sox,12,5,October 14 2018,7
Milwaukee Brewers,0,Los Angeles Dodgers,4,4,October 15 2018,0
Boston Red Sox,0,Houston Astros,10,8,October 16 2018,2
Milwaukee Brewers,1,Los Angeles Dodgers,3,1,October 16 2018,2
Boston Red Sox,0,Houston Astros,14,8,October 17 2018,6
Milwaukee Brewers,1,Los Angeles Dodgers,7,2,October 17 2018,5
Boston Red Sox,0,Houston Astros,5,4,October 18 2018,1
Los Angeles Dodgers,1,Milwaukee Brewers,9,2,October 19 2018,7
Los Angeles Dodgers,0,Milwaukee Brewers,6,5,October 20 2018,1
Los Angeles Dodgers,1,Boston Red Sox,12,4,October 23 2018,8
Los Angeles Dodgers,1,Boston Red Sox,6,2,October 24 2018,4
Boston Red Sox,1,Los Angeles Dodgers,5,2,October 26 2018,3
Boston Red Sox,0,Los Angeles Dodgers,15,9,October 27 2018,6
Boston Red Sox,0,Los Angeles Dodgers,6,5,October 28 2018,1