Away,HW,Home,Total_Runs,awayRuns,date,homeRuns
Texas Rangers,1,Houston Astros,10,2,March 31 2013,8
St. Louis Cardinals,1,Arizona D'Backs,8,2,April 1 2013,6
Philadelphia Phillies,1,Atlanta Braves,12,5,April 1 2013,7
Kansas City Royals,1,Chicago White Sox,1,0,April 1 2013,1
LA Angels of Anaheim,0,Cincinnati Reds,4,3,April 1 2013,1
San Francisco Giants,1,Los Angeles Dodgers,4,0,April 1 2013,4
Colorado Rockies,1,Milwaukee Brewers,9,4,April 1 2013,5
Detroit Tigers,0,Minnesota Twins,6,4,April 1 2013,2
Boston Red Sox,0,New York Yankees,10,8,April 1 2013,2
San Diego Padres,1,New York Mets,13,2,April 1 2013,11
Seattle Mariners,0,Oakland Athletics,2,2,April 1 2013,0
Chicago Cubs,0,Pittsburgh Pirates,4,3,April 1 2013,1
Miami Marlins,1,Washington Nationals,2,0,April 1 2013,2
St. Louis Cardinals,0,Arizona D'Backs,7,6,April 2 2013,1
Texas Rangers,0,Houston Astros,7,7,April 2 2013,0
San Francisco Giants,0,Los Angeles Dodgers,3,3,April 2 2013,0
Colorado Rockies,0,Milwaukee Brewers,12,8,April 2 2013,4
Seattle Mariners,0,Oakland Athletics,8,7,April 2 2013,1
Baltimore Orioles,0,Tampa Bay Rays,11,7,April 2 2013,4
Cleveland Indians,0,Toronto Blue Jays,5,4,April 2 2013,1
St. Louis Cardinals,1,Arizona D'Backs,19,9,April 3 2013,10
Philadelphia Phillies,1,Atlanta Braves,11,2,April 3 2013,9
Kansas City Royals,1,Chicago White Sox,7,2,April 3 2013,5
LA Angels of Anaheim,1,Cincinnati Reds,9,4,April 3 2013,5
Texas Rangers,0,Houston Astros,4,4,April 3 2013,0
San Francisco Giants,0,Los Angeles Dodgers,8,5,April 3 2013,3
Colorado Rockies,0,Milwaukee Brewers,10,7,April 3 2013,3
Detroit Tigers,1,Minnesota Twins,5,2,April 3 2013,3
Boston Red Sox,0,New York Yankees,11,7,April 3 2013,4
San Diego Padres,1,New York Mets,12,4,April 3 2013,8
Seattle Mariners,1,Oakland Athletics,8,2,April 3 2013,6
Chicago Cubs,1,Pittsburgh Pirates,3,0,April 3 2013,3
Baltimore Orioles,1,Tampa Bay Rays,15,7,April 3 2013,8
Cleveland Indians,0,Toronto Blue Jays,5,3,April 3 2013,2
Miami Marlins,1,Washington Nationals,3,0,April 3 2013,3
Philadelphia Phillies,0,Atlanta Braves,2,2,April 4 2013,0
Kansas City Royals,0,Chicago White Sox,4,3,April 4 2013,1
LA Angels of Anaheim,1,Cincinnati Reds,9,4,April 4 2013,5
Detroit Tigers,1,Minnesota Twins,10,2,April 4 2013,8
Boston Red Sox,1,New York Yankees,6,2,April 4 2013,4
San Diego Padres,0,New York Mets,3,2,April 4 2013,1
Seattle Mariners,1,Oakland Athletics,10,2,April 4 2013,8
Chicago Cubs,0,Pittsburgh Pirates,5,3,April 4 2013,2
Baltimore Orioles,0,Tampa Bay Rays,9,6,April 4 2013,3
Cleveland Indians,1,Toronto Blue Jays,18,8,April 4 2013,10
Miami Marlins,1,Washington Nationals,7,1,April 4 2013,6
Chicago Cubs,1,Atlanta Braves,5,1,April 5 2013,4
Minnesota Twins,1,Baltimore Orioles,14,5,April 5 2013,9
Seattle Mariners,0,Chicago White Sox,15,8,April 5 2013,7
Washington Nationals,1,Cincinnati Reds,15,0,April 5 2013,15
San Diego Padres,1,Colorado Rockies,7,2,April 5 2013,5
New York Yankees,1,Detroit Tigers,11,3,April 5 2013,8
Oakland Athletics,0,Houston Astros,11,8,April 5 2013,3
Pittsburgh Pirates,1,Los Angeles Dodgers,3,0,April 5 2013,3
Arizona D'Backs,0,Milwaukee Brewers,4,3,April 5 2013,1
Miami Marlins,0,New York Mets,12,7,April 5 2013,5
Kansas City Royals,0,Philadelphia Phillies,17,13,April 5 2013,4
St. Louis Cardinals,1,San Francisco Giants,1,0,April 5 2013,1
Cleveland Indians,1,Tampa Bay Rays,4,0,April 5 2013,4
LA Angels of Anaheim,1,Texas Rangers,5,2,April 5 2013,3
Boston Red Sox,0,Toronto Blue Jays,10,6,April 5 2013,4
Chicago Cubs,1,Atlanta Braves,11,5,April 6 2013,6
Minnesota Twins,0,Baltimore Orioles,11,6,April 6 2013,5
Seattle Mariners,1,Chicago White Sox,7,3,April 6 2013,4
Washington Nationals,0,Cincinnati Reds,13,7,April 6 2013,6
San Diego Padres,1,Colorado Rockies,9,3,April 6 2013,6
New York Yankees,1,Detroit Tigers,12,4,April 6 2013,8
Oakland Athletics,0,Houston Astros,9,6,April 6 2013,3
Pittsburgh Pirates,1,Los Angeles Dodgers,1,0,April 6 2013,1
Arizona D'Backs,0,Milwaukee Brewers,11,9,April 6 2013,2
Miami Marlins,1,New York Mets,10,3,April 6 2013,7
Kansas City Royals,1,Philadelphia Phillies,7,3,April 6 2013,4
St. Louis Cardinals,0,San Francisco Giants,9,6,April 6 2013,3
Cleveland Indians,1,Tampa Bay Rays,6,0,April 6 2013,6
LA Angels of Anaheim,0,Texas Rangers,12,8,April 6 2013,4
Boston Red Sox,1,Toronto Blue Jays,5,0,April 6 2013,5
Chicago Cubs,1,Atlanta Braves,6,1,April 7 2013,5
Minnesota Twins,0,Baltimore Orioles,7,4,April 7 2013,3
Seattle Mariners,1,Chicago White Sox,7,3,April 7 2013,4
Washington Nationals,1,Cincinnati Reds,9,3,April 7 2013,6
San Diego Padres,1,Colorado Rockies,10,1,April 7 2013,9
New York Yankees,0,Detroit Tigers,7,7,April 7 2013,0
Oakland Athletics,0,Houston Astros,12,9,April 7 2013,3
Pittsburgh Pirates,1,Los Angeles Dodgers,8,2,April 7 2013,6
Arizona D'Backs,0,Milwaukee Brewers,15,8,April 7 2013,7
Miami Marlins,1,New York Mets,7,3,April 7 2013,4
Kansas City Royals,0,Philadelphia Phillies,17,9,April 7 2013,8
St. Louis Cardinals,0,San Francisco Giants,17,14,April 7 2013,3
Cleveland Indians,0,Tampa Bay Rays,13,13,April 7 2013,0
LA Angels of Anaheim,1,Texas Rangers,10,3,April 7 2013,7
Boston Red Sox,0,Toronto Blue Jays,13,13,April 7 2013,0
Pittsburgh Pirates,0,Arizona D'Backs,8,5,April 8 2013,3
Baltimore Orioles,1,Boston Red Sox,4,1,April 8 2013,3
Milwaukee Brewers,0,Chicago Cubs,11,7,April 8 2013,4
New York Yankees,0,Cleveland Indians,17,11,April 8 2013,6
Minnesota Twins,1,Kansas City Royals,4,1,April 8 2013,3
Atlanta Braves,0,Miami Marlins,2,2,April 8 2013,0
New York Mets,0,Philadelphia Phillies,9,7,April 8 2013,2
Houston Astros,1,Seattle Mariners,3,0,April 8 2013,3
Colorado Rockies,1,San Francisco Giants,6,2,April 8 2013,4
Cincinnati Reds,0,St. Louis Cardinals,17,13,April 8 2013,4
Tampa Bay Rays,1,Texas Rangers,9,4,April 8 2013,5
Oakland Athletics,0,LA Angels of Anaheim,14,9,April 9 2013,5
Pittsburgh Pirates,0,Arizona D'Backs,11,6,April 9 2013,5
Milwaukee Brewers,1,Chicago Cubs,9,3,April 9 2013,6
New York Yankees,0,Cleveland Indians,15,14,April 9 2013,1
Toronto Blue Jays,1,Detroit Tigers,10,3,April 9 2013,7
Minnesota Twins,1,Kansas City Royals,11,4,April 9 2013,7
Atlanta Braves,0,Miami Marlins,5,3,April 9 2013,2
New York Mets,1,Philadelphia Phillies,11,3,April 9 2013,8
Los Angeles Dodgers,1,San Diego Padres,12,3,April 9 2013,9
Houston Astros,0,Seattle Mariners,25,16,April 9 2013,9
Colorado Rockies,1,San Francisco Giants,15,6,April 9 2013,9
Cincinnati Reds,1,St. Louis Cardinals,6,1,April 9 2013,5
Tampa Bay Rays,1,Texas Rangers,7,1,April 9 2013,6
Chicago White Sox,1,Washington Nationals,15,7,April 9 2013,8
Oakland Athletics,0,LA Angels of Anaheim,16,11,April 10 2013,5
Pittsburgh Pirates,1,Arizona D'Backs,12,2,April 10 2013,10
Baltimore Orioles,0,Boston Red Sox,13,8,April 10 2013,5
Toronto Blue Jays,0,Detroit Tigers,14,8,April 10 2013,6
Minnesota Twins,1,Kansas City Royals,3,0,April 10 2013,3
Atlanta Braves,0,Miami Marlins,8,8,April 10 2013,0
New York Mets,1,Philadelphia Phillies,10,3,April 10 2013,7
Los Angeles Dodgers,0,San Diego Padres,7,4,April 10 2013,3
Houston Astros,0,Seattle Mariners,11,8,April 10 2013,3
Colorado Rockies,1,San Francisco Giants,10,0,April 10 2013,10
Cincinnati Reds,1,St. Louis Cardinals,10,0,April 10 2013,10
Tampa Bay Rays,0,Texas Rangers,2,2,April 10 2013,0
Chicago White Sox,1,Washington Nationals,7,2,April 10 2013,5
Oakland Athletics,0,LA Angels of Anaheim,9,8,April 11 2013,1
Baltimore Orioles,0,Boston Red Sox,5,3,April 11 2013,2
San Francisco Giants,0,Chicago Cubs,13,7,April 11 2013,6
Toronto Blue Jays,1,Detroit Tigers,12,1,April 11 2013,11
Los Angeles Dodgers,0,San Diego Padres,5,3,April 11 2013,2
Texas Rangers,0,Seattle Mariners,7,4,April 11 2013,3
Chicago White Sox,1,Washington Nationals,11,4,April 11 2013,7
Houston Astros,0,LA Angels of Anaheim,5,5,April 12 2013,0
Los Angeles Dodgers,1,Arizona D'Backs,3,0,April 12 2013,3
San Francisco Giants,1,Chicago Cubs,7,3,April 12 2013,4
Chicago White Sox,1,Cleveland Indians,1,0,April 12 2013,1
Toronto Blue Jays,0,Kansas City Royals,12,8,April 12 2013,4
Philadelphia Phillies,0,Miami Marlins,4,3,April 12 2013,1
New York Mets,0,Minnesota Twins,21,16,April 12 2013,5
Baltimore Orioles,1,New York Yankees,7,2,April 12 2013,5
Detroit Tigers,1,Oakland Athletics,7,3,April 12 2013,4
Cincinnati Reds,1,Pittsburgh Pirates,11,5,April 12 2013,6
Colorado Rockies,0,San Diego Padres,12,7,April 12 2013,5
Texas Rangers,1,Seattle Mariners,4,1,April 12 2013,3
Milwaukee Brewers,1,St. Louis Cardinals,2,0,April 12 2013,2
Atlanta Braves,0,Washington Nationals,10,6,April 12 2013,4
Houston Astros,1,LA Angels of Anaheim,9,4,April 13 2013,5
Los Angeles Dodgers,0,Arizona D'Backs,12,7,April 13 2013,5
Tampa Bay Rays,1,Boston Red Sox,3,1,April 13 2013,2
San Francisco Giants,0,Chicago Cubs,5,3,April 13 2013,2
Chicago White Sox,1,Cleveland Indians,13,4,April 13 2013,9
Toronto Blue Jays,0,Kansas City Royals,5,3,April 13 2013,2
Philadelphia Phillies,1,Miami Marlins,3,1,April 13 2013,2
New York Mets,0,Minnesota Twins,6,4,April 13 2013,2
Baltimore Orioles,0,New York Yankees,8,5,April 13 2013,3
Detroit Tigers,0,Oakland Athletics,10,7,April 13 2013,3
Cincinnati Reds,1,Pittsburgh Pirates,4,1,April 13 2013,3
Colorado Rockies,0,San Diego Padres,14,9,April 13 2013,5
Texas Rangers,0,Seattle Mariners,4,3,April 13 2013,1
Milwaukee Brewers,1,St. Louis Cardinals,8,0,April 13 2013,8
Atlanta Braves,0,Washington Nationals,4,3,April 13 2013,1
Houston Astros,1,LA Angels of Anaheim,5,1,April 14 2013,4
Los Angeles Dodgers,1,Arizona D'Backs,1,0,April 14 2013,1
Tampa Bay Rays,1,Boston Red Sox,5,0,April 14 2013,5
San Francisco Giants,0,Chicago Cubs,17,10,April 14 2013,7
Chicago White Sox,0,Cleveland Indians,4,3,April 14 2013,1
Toronto Blue Jays,1,Kansas City Royals,5,2,April 14 2013,3
Philadelphia Phillies,0,Miami Marlins,3,2,April 14 2013,1
Baltimore Orioles,1,New York Yankees,3,0,April 14 2013,3
Detroit Tigers,0,Oakland Athletics,11,10,April 14 2013,1
Cincinnati Reds,1,Pittsburgh Pirates,17,7,April 14 2013,10
Colorado Rockies,0,San Diego Padres,3,2,April 14 2013,1
Texas Rangers,1,Seattle Mariners,7,3,April 14 2013,4
Milwaukee Brewers,0,St. Louis Cardinals,7,4,April 14 2013,3
Atlanta Braves,0,Washington Nationals,9,9,April 14 2013,0
Tampa Bay Rays,1,Boston Red Sox,5,2,April 15 2013,3
Philadelphia Phillies,1,Cincinnati Reds,6,2,April 15 2013,4
San Diego Padres,0,Los Angeles Dodgers,9,6,April 15 2013,3
Washington Nationals,0,Miami Marlins,13,10,April 15 2013,3
LA Angels of Anaheim,1,Minnesota Twins,10,2,April 15 2013,8
Houston Astros,1,Oakland Athletics,13,2,April 15 2013,11
St. Louis Cardinals,0,Pittsburgh Pirates,16,10,April 15 2013,6
Chicago White Sox,1,Toronto Blue Jays,7,3,April 15 2013,4
Kansas City Royals,1,Atlanta Braves,9,3,April 16 2013,6
Tampa Bay Rays,1,Baltimore Orioles,9,4,April 16 2013,5
Texas Rangers,0,Chicago Cubs,6,4,April 16 2013,2
Philadelphia Phillies,1,Cincinnati Reds,1,0,April 16 2013,1
Boston Red Sox,0,Cleveland Indians,9,7,April 16 2013,2
New York Mets,1,Colorado Rockies,12,4,April 16 2013,8
New York Mets,1,Colorado Rockies,17,8,April 16 2013,9
San Diego Padres,0,Los Angeles Dodgers,11,9,April 16 2013,2
Washington Nationals,1,Miami Marlins,10,2,April 16 2013,8
San Francisco Giants,1,Milwaukee Brewers,18,8,April 16 2013,10
LA Angels of Anaheim,1,Minnesota Twins,14,6,April 16 2013,8
Arizona D'Backs,1,New York Yankees,6,2,April 16 2013,4
Houston Astros,1,Oakland Athletics,7,3,April 16 2013,4
Detroit Tigers,0,Seattle Mariners,8,6,April 16 2013,2
Chicago White Sox,0,Toronto Blue Jays,7,4,April 16 2013,3
Kansas City Royals,0,Atlanta Braves,1,1,April 17 2013,0
Tampa Bay Rays,0,Baltimore Orioles,8,6,April 17 2013,2
Philadelphia Phillies,1,Cincinnati Reds,13,2,April 17 2013,11
Boston Red Sox,0,Cleveland Indians,9,6,April 17 2013,3
San Diego Padres,0,Los Angeles Dodgers,9,7,April 17 2013,2
Washington Nationals,0,Miami Marlins,7,6,April 17 2013,1
San Francisco Giants,1,Milwaukee Brewers,7,3,April 17 2013,4
Arizona D'Backs,1,New York Yankees,7,3,April 17 2013,4
Houston Astros,1,Oakland Athletics,12,5,April 17 2013,7
St. Louis Cardinals,1,Pittsburgh Pirates,5,0,April 17 2013,5
Detroit Tigers,0,Seattle Mariners,3,2,April 17 2013,1
Chicago White Sox,0,Toronto Blue Jays,7,7,April 17 2013,0
Tampa Bay Rays,1,Baltimore Orioles,16,6,April 18 2013,10
Texas Rangers,1,Chicago Cubs,8,2,April 18 2013,6
Miami Marlins,1,Cincinnati Reds,12,1,April 18 2013,11
Boston Red Sox,0,Cleveland Indians,9,6,April 18 2013,3
New York Mets,1,Colorado Rockies,14,3,April 18 2013,11
San Francisco Giants,1,Milwaukee Brewers,9,2,April 18 2013,7
Arizona D'Backs,0,New York Yankees,8,6,April 18 2013,2
St. Louis Cardinals,0,Philadelphia Phillies,7,4,April 18 2013,3
Atlanta Braves,0,Pittsburgh Pirates,10,6,April 18 2013,4
Detroit Tigers,1,Seattle Mariners,2,0,April 18 2013,2
Chicago White Sox,1,Toronto Blue Jays,4,1,April 18 2013,3
Detroit Tigers,1,LA Angels of Anaheim,9,1,April 19 2013,8
Miami Marlins,0,Cincinnati Reds,3,2,April 19 2013,1
Arizona D'Backs,1,Colorado Rockies,4,1,April 19 2013,3
Cleveland Indians,1,Houston Astros,5,2,April 19 2013,3
Chicago Cubs,1,Milwaukee Brewers,9,4,April 19 2013,5
Washington Nationals,1,New York Mets,8,1,April 19 2013,7
St. Louis Cardinals,1,Philadelphia Phillies,10,2,April 19 2013,8
Atlanta Braves,1,Pittsburgh Pirates,6,0,April 19 2013,6
San Diego Padres,1,San Francisco Giants,5,2,April 19 2013,3
Oakland Athletics,1,Tampa Bay Rays,11,3,April 19 2013,8
Seattle Mariners,1,Texas Rangers,7,0,April 19 2013,7
New York Yankees,0,Toronto Blue Jays,13,9,April 19 2013,4
Detroit Tigers,1,LA Angels of Anaheim,10,0,April 20 2013,10
Los Angeles Dodgers,1,Baltimore Orioles,12,5,April 20 2013,7
Los Angeles Dodgers,1,Baltimore Orioles,7,1,April 20 2013,6
Kansas City Royals,1,Boston Red Sox,7,3,April 20 2013,4
Minnesota Twins,0,Chicago White Sox,3,2,April 20 2013,1
Miami Marlins,1,Cincinnati Reds,5,2,April 20 2013,3
Arizona D'Backs,1,Colorado Rockies,7,3,April 20 2013,4
Cleveland Indians,0,Houston Astros,25,19,April 20 2013,6
Chicago Cubs,1,Milwaukee Brewers,6,1,April 20 2013,5
Washington Nationals,0,New York Mets,13,7,April 20 2013,6
St. Louis Cardinals,0,Philadelphia Phillies,5,5,April 20 2013,0
Atlanta Braves,1,Pittsburgh Pirates,4,1,April 20 2013,3
San Diego Padres,1,San Francisco Giants,2,0,April 20 2013,2
Oakland Athletics,1,Tampa Bay Rays,1,0,April 20 2013,1
Seattle Mariners,1,Texas Rangers,5,0,April 20 2013,5
New York Yankees,0,Toronto Blue Jays,8,5,April 20 2013,3
Detroit Tigers,1,LA Angels of Anaheim,7,3,April 21 2013,4
Los Angeles Dodgers,0,Baltimore Orioles,11,7,April 21 2013,4
Kansas City Royals,0,Boston Red Sox,6,4,April 21 2013,2
Kansas City Royals,0,Boston Red Sox,9,5,April 21 2013,4
Minnesota Twins,0,Chicago White Sox,8,5,April 21 2013,3
Miami Marlins,1,Cincinnati Reds,16,6,April 21 2013,10
Arizona D'Backs,0,Colorado Rockies,9,5,April 21 2013,4
Cleveland Indians,0,Houston Astros,9,5,April 21 2013,4
Chicago Cubs,1,Milwaukee Brewers,6,2,April 21 2013,4
Washington Nationals,1,New York Mets,2,0,April 21 2013,2
St. Louis Cardinals,1,Philadelphia Phillies,10,3,April 21 2013,7
Atlanta Braves,1,Pittsburgh Pirates,6,2,April 21 2013,4
San Diego Padres,1,San Francisco Giants,5,0,April 21 2013,5
Oakland Athletics,1,Tampa Bay Rays,9,1,April 21 2013,8
Seattle Mariners,1,Texas Rangers,14,3,April 21 2013,11
New York Yankees,1,Toronto Blue Jays,12,4,April 21 2013,8
Texas Rangers,0,LA Angels of Anaheim,13,7,April 22 2013,6
Toronto Blue Jays,1,Baltimore Orioles,3,1,April 22 2013,2
Oakland Athletics,1,Boston Red Sox,15,6,April 22 2013,9
Cleveland Indians,0,Chicago White Sox,5,3,April 22 2013,2
Chicago Cubs,1,Cincinnati Reds,9,4,April 22 2013,5
Seattle Mariners,0,Houston Astros,8,7,April 22 2013,1
Pittsburgh Pirates,1,Philadelphia Phillies,5,2,April 22 2013,3
Milwaukee Brewers,0,San Diego Padres,8,7,April 22 2013,1
Arizona D'Backs,1,San Francisco Giants,9,4,April 22 2013,5
New York Yankees,1,Tampa Bay Rays,6,1,April 22 2013,5
St. Louis Cardinals,0,Washington Nationals,5,3,April 22 2013,2
Texas Rangers,1,LA Angels of Anaheim,9,4,April 23 2013,5
Toronto Blue Jays,1,Baltimore Orioles,7,3,April 23 2013,4
Oakland Athletics,0,Boston Red Sox,13,13,April 23 2013,0
Chicago Cubs,0,Cincinnati Reds,6,4,April 23 2013,2
Atlanta Braves,0,Colorado Rockies,7,4,April 23 2013,3
Atlanta Braves,0,Colorado Rockies,12,10,April 23 2013,2
Seattle Mariners,1,Houston Astros,5,2,April 23 2013,3
Miami Marlins,1,Minnesota Twins,7,3,April 23 2013,4
Miami Marlins,0,Minnesota Twins,13,8,April 23 2013,5
Los Angeles Dodgers,0,New York Mets,9,7,April 23 2013,2
Pittsburgh Pirates,0,Philadelphia Phillies,2,2,April 23 2013,0
Milwaukee Brewers,0,San Diego Padres,9,6,April 23 2013,3
Arizona D'Backs,0,San Francisco Giants,10,6,April 23 2013,4
New York Yankees,0,Tampa Bay Rays,7,4,April 23 2013,3
St. Louis Cardinals,0,Washington Nationals,2,2,April 23 2013,0
Texas Rangers,0,LA Angels of Anaheim,14,11,April 24 2013,3
Toronto Blue Jays,0,Baltimore Orioles,11,6,April 24 2013,5
Oakland Athletics,1,Boston Red Sox,11,5,April 24 2013,6
Cleveland Indians,1,Chicago White Sox,5,2,April 24 2013,3
Chicago Cubs,1,Cincinnati Reds,1,0,April 24 2013,1
Atlanta Braves,1,Colorado Rockies,11,5,April 24 2013,6
Kansas City Royals,1,Detroit Tigers,12,5,April 24 2013,7
Seattle Mariners,1,Houston Astros,13,3,April 24 2013,10
Los Angeles Dodgers,1,New York Mets,10,3,April 24 2013,7
Pittsburgh Pirates,0,Philadelphia Phillies,8,5,April 24 2013,3
Milwaukee Brewers,1,San Diego Padres,3,1,April 24 2013,2
Arizona D'Backs,0,San Francisco Giants,5,3,April 24 2013,2
New York Yankees,1,Tampa Bay Rays,3,0,April 24 2013,3
St. Louis Cardinals,0,Washington Nationals,6,4,April 24 2013,2
Colorado Rockies,1,Arizona D'Backs,5,2,April 25 2013,3
Houston Astros,1,Boston Red Sox,9,2,April 25 2013,7
Tampa Bay Rays,1,Chicago White Sox,7,2,April 25 2013,5
Kansas City Royals,0,Detroit Tigers,11,8,April 25 2013,3
Chicago Cubs,0,Miami Marlins,7,4,April 25 2013,3
Texas Rangers,0,Minnesota Twins,3,2,April 25 2013,1
Toronto Blue Jays,1,New York Yankees,8,3,April 25 2013,5
Los Angeles Dodgers,0,New York Mets,5,3,April 25 2013,2
Baltimore Orioles,0,Oakland Athletics,12,10,April 25 2013,2
Pittsburgh Pirates,0,Philadelphia Phillies,10,6,April 25 2013,4
LA Angels of Anaheim,1,Seattle Mariners,6,0,April 25 2013,6
Cincinnati Reds,1,Washington Nationals,9,1,April 25 2013,8
Colorado Rockies,0,Arizona D'Backs,9,6,April 26 2013,3
Houston Astros,1,Boston Red Sox,10,3,April 26 2013,7
Tampa Bay Rays,1,Chicago White Sox,9,4,April 26 2013,5
Atlanta Braves,1,Detroit Tigers,10,0,April 26 2013,10
Milwaukee Brewers,1,Los Angeles Dodgers,12,5,April 26 2013,7
Chicago Cubs,0,Miami Marlins,6,4,April 26 2013,2
Texas Rangers,0,Minnesota Twins,7,4,April 26 2013,3
Toronto Blue Jays,1,New York Yankees,10,4,April 26 2013,6
Philadelphia Phillies,0,New York Mets,4,4,April 26 2013,0
Baltimore Orioles,0,Oakland Athletics,3,3,April 26 2013,0
San Francisco Giants,1,San Diego Padres,3,1,April 26 2013,2
LA Angels of Anaheim,0,Seattle Mariners,9,6,April 26 2013,3
Pittsburgh Pirates,1,St. Louis Cardinals,10,1,April 26 2013,9
Cincinnati Reds,1,Washington Nationals,1,0,April 26 2013,1
Colorado Rockies,1,Arizona D'Backs,5,2,April 27 2013,3
Houston Astros,1,Boston Red Sox,12,4,April 27 2013,8
Tampa Bay Rays,0,Chicago White Sox,14,10,April 27 2013,4
Atlanta Braves,1,Detroit Tigers,11,4,April 27 2013,7
Cleveland Indians,1,Kansas City Royals,5,2,April 27 2013,3
Milwaukee Brewers,0,Los Angeles Dodgers,10,6,April 27 2013,4
Chicago Cubs,0,Miami Marlins,5,3,April 27 2013,2
Texas Rangers,1,Minnesota Twins,9,2,April 27 2013,7
Toronto Blue Jays,1,New York Yankees,9,4,April 27 2013,5
Philadelphia Phillies,0,New York Mets,13,9,April 27 2013,4
Baltimore Orioles,0,Oakland Athletics,10,7,April 27 2013,3
San Francisco Giants,1,San Diego Padres,15,7,April 27 2013,8
LA Angels of Anaheim,1,Seattle Mariners,5,2,April 27 2013,3
Pittsburgh Pirates,0,St. Louis Cardinals,8,5,April 27 2013,3
Cincinnati Reds,1,Washington Nationals,9,3,April 27 2013,6
Colorado Rockies,1,Arizona D'Backs,6,2,April 28 2013,4
Houston Astros,1,Boston Red Sox,7,1,April 28 2013,6
Tampa Bay Rays,0,Chicago White Sox,11,8,April 28 2013,3
Atlanta Braves,1,Detroit Tigers,11,3,April 28 2013,8
Cleveland Indians,1,Kansas City Royals,9,0,April 28 2013,9
Cleveland Indians,0,Kansas City Royals,13,10,April 28 2013,3
Milwaukee Brewers,1,Los Angeles Dodgers,2,0,April 28 2013,2
Chicago Cubs,1,Miami Marlins,10,4,April 28 2013,6
Texas Rangers,1,Minnesota Twins,5,0,April 28 2013,5
Toronto Blue Jays,1,New York Yankees,5,2,April 28 2013,3
Philadelphia Phillies,0,New York Mets,6,5,April 28 2013,1
Baltimore Orioles,1,Oakland Athletics,17,8,April 28 2013,9
San Francisco Giants,1,San Diego Padres,10,4,April 28 2013,6
LA Angels of Anaheim,1,Seattle Mariners,3,1,April 28 2013,2
Pittsburgh Pirates,0,St. Louis Cardinals,9,9,April 28 2013,0
Cincinnati Reds,0,Washington Nationals,7,5,April 28 2013,2
San Francisco Giants,0,Arizona D'Backs,10,6,April 29 2013,4
Washington Nationals,1,Atlanta Braves,5,2,April 29 2013,3
San Diego Padres,1,Chicago Cubs,8,3,April 29 2013,5
Minnesota Twins,1,Detroit Tigers,7,3,April 29 2013,4
Cleveland Indians,0,Kansas City Royals,9,9,April 29 2013,0
Colorado Rockies,0,Los Angeles Dodgers,14,12,April 29 2013,2
New York Mets,1,Miami Marlins,7,3,April 29 2013,4
Pittsburgh Pirates,1,Milwaukee Brewers,14,4,April 29 2013,10
Houston Astros,0,New York Yankees,10,9,April 29 2013,1
LA Angels of Anaheim,1,Oakland Athletics,18,8,April 29 2013,10
Baltimore Orioles,1,Seattle Mariners,8,2,April 29 2013,6
Cincinnati Reds,0,St. Louis Cardinals,3,2,April 29 2013,1
San Francisco Giants,0,Arizona D'Backs,3,2,April 30 2013,1
Washington Nationals,1,Atlanta Braves,9,1,April 30 2013,8
San Diego Padres,0,Chicago Cubs,20,13,April 30 2013,7
Philadelphia Phillies,1,Cleveland Indians,16,2,April 30 2013,14
Minnesota Twins,1,Detroit Tigers,7,1,April 30 2013,6
Tampa Bay Rays,1,Kansas City Royals,10,2,April 30 2013,8
Colorado Rockies,1,Los Angeles Dodgers,8,2,April 30 2013,6
New York Mets,1,Miami Marlins,3,1,April 30 2013,2
Pittsburgh Pirates,1,Milwaukee Brewers,20,8,April 30 2013,12
Houston Astros,1,New York Yankees,11,4,April 30 2013,7
LA Angels of Anaheim,1,Oakland Athletics,16,6,April 30 2013,10
Baltimore Orioles,0,Seattle Mariners,9,7,April 30 2013,2
Cincinnati Reds,1,St. Louis Cardinals,3,1,April 30 2013,2
Chicago White Sox,1,Texas Rangers,16,6,April 30 2013,10
Boston Red Sox,1,Toronto Blue Jays,16,7,April 30 2013,9
San Francisco Giants,0,Arizona D'Backs,15,9,May 1 2013,6
Washington Nationals,0,Atlanta Braves,2,2,May 1 2013,0
San Diego Padres,1,Chicago Cubs,8,2,May 1 2013,6
Philadelphia Phillies,1,Cleveland Indians,6,0,May 1 2013,6
Minnesota Twins,0,Detroit Tigers,8,6,May 1 2013,2
Tampa Bay Rays,1,Kansas City Royals,17,8,May 1 2013,9
Colorado Rockies,0,Los Angeles Dodgers,10,7,May 1 2013,3
New York Mets,0,Miami Marlins,13,7,May 1 2013,6
Pittsburgh Pirates,0,Milwaukee Brewers,10,6,May 1 2013,4
Houston Astros,1,New York Yankees,9,4,May 1 2013,5
LA Angels of Anaheim,0,Oakland Athletics,9,5,May 1 2013,4
Baltimore Orioles,1,Seattle Mariners,11,3,May 1 2013,8
Cincinnati Reds,1,St. Louis Cardinals,6,2,May 1 2013,4
Chicago White Sox,0,Texas Rangers,7,5,May 1 2013,2
Boston Red Sox,0,Toronto Blue Jays,11,10,May 1 2013,1
Baltimore Orioles,0,LA Angels of Anaheim,6,5,May 2 2013,1
Washington Nationals,0,Atlanta Braves,4,3,May 2 2013,1
San Diego Padres,0,Chicago Cubs,6,4,May 2 2013,2
Detroit Tigers,0,Houston Astros,10,7,May 2 2013,3
St. Louis Cardinals,0,Milwaukee Brewers,11,6,May 2 2013,5
Miami Marlins,1,Philadelphia Phillies,9,2,May 2 2013,7
Chicago White Sox,0,Texas Rangers,4,3,May 2 2013,1
Boston Red Sox,0,Toronto Blue Jays,4,3,May 2 2013,1
Baltimore Orioles,1,LA Angels of Anaheim,4,0,May 3 2013,4
New York Mets,0,Atlanta Braves,12,7,May 3 2013,5
Cincinnati Reds,0,Chicago Cubs,11,6,May 3 2013,5
Minnesota Twins,1,Cleveland Indians,13,6,May 3 2013,7
Tampa Bay Rays,0,Colorado Rockies,11,7,May 3 2013,4
Detroit Tigers,0,Houston Astros,7,4,May 3 2013,3
St. Louis Cardinals,0,Milwaukee Brewers,7,6,May 3 2013,1
Oakland Athletics,0,New York Yankees,2,2,May 3 2013,0
Miami Marlins,1,Philadelphia Phillies,5,1,May 3 2013,4
Washington Nationals,1,Pittsburgh Pirates,4,1,May 3 2013,3
Arizona D'Backs,1,San Diego Padres,13,6,May 3 2013,7
Los Angeles Dodgers,1,San Francisco Giants,3,1,May 3 2013,2
Boston Red Sox,1,Texas Rangers,7,0,May 3 2013,7
Seattle Mariners,0,Toronto Blue Jays,4,4,May 3 2013,0
Baltimore Orioles,0,LA Angels of Anaheim,9,5,May 4 2013,4
Cincinnati Reds,0,Chicago Cubs,10,6,May 4 2013,4
Minnesota Twins,1,Cleveland Indians,10,3,May 4 2013,7
Tampa Bay Rays,1,Colorado Rockies,12,3,May 4 2013,9
Detroit Tigers,0,Houston Astros,19,17,May 4 2013,2
Chicago White Sox,1,Kansas City Royals,2,0,May 4 2013,2
St. Louis Cardinals,0,Milwaukee Brewers,13,7,May 4 2013,6
Oakland Athletics,1,New York Yankees,6,2,May 4 2013,4
Miami Marlins,0,Philadelphia Phillies,2,2,May 4 2013,0
Washington Nationals,0,Pittsburgh Pirates,9,5,May 4 2013,4
Arizona D'Backs,0,San Diego Padres,9,8,May 4 2013,1
Los Angeles Dodgers,1,San Francisco Giants,19,9,May 4 2013,10
Boston Red Sox,1,Texas Rangers,6,1,May 4 2013,5
Seattle Mariners,0,Toronto Blue Jays,9,8,May 4 2013,1
Baltimore Orioles,0,LA Angels of Anaheim,12,8,May 5 2013,4
New York Mets,1,Atlanta Braves,13,4,May 5 2013,9
Cincinnati Reds,0,Chicago Cubs,11,7,May 5 2013,4
Minnesota Twins,0,Cleveland Indians,6,4,May 5 2013,2
Tampa Bay Rays,0,Colorado Rockies,11,8,May 5 2013,3
Detroit Tigers,0,Houston Astros,9,9,May 5 2013,0
Chicago White Sox,1,Kansas City Royals,11,5,May 5 2013,6
St. Louis Cardinals,0,Milwaukee Brewers,11,10,May 5 2013,1
Oakland Athletics,0,New York Yankees,9,5,May 5 2013,4
Miami Marlins,0,Philadelphia Phillies,16,14,May 5 2013,2
Washington Nationals,0,Pittsburgh Pirates,8,6,May 5 2013,2
Arizona D'Backs,1,San Diego Padres,6,1,May 5 2013,5
Los Angeles Dodgers,1,San Francisco Giants,7,3,May 5 2013,4
Boston Red Sox,1,Texas Rangers,7,3,May 5 2013,4
Seattle Mariners,1,Toronto Blue Jays,12,2,May 5 2013,10
Minnesota Twins,1,Boston Red Sox,11,5,May 6 2013,6
Texas Rangers,1,Chicago Cubs,11,2,May 6 2013,9
Atlanta Braves,0,Cincinnati Reds,11,7,May 6 2013,4
Oakland Athletics,1,Cleveland Indians,10,3,May 6 2013,7
Chicago White Sox,0,Kansas City Royals,3,2,May 6 2013,1
Arizona D'Backs,0,Los Angeles Dodgers,11,9,May 6 2013,2
Miami Marlins,1,San Diego Padres,5,0,May 6 2013,5
Philadelphia Phillies,0,San Francisco Giants,8,6,May 6 2013,2
Toronto Blue Jays,0,Tampa Bay Rays,15,8,May 6 2013,7
Kansas City Royals,1,Baltimore Orioles,7,3,May 7 2013,4
Minnesota Twins,0,Boston Red Sox,7,6,May 7 2013,1
St. Louis Cardinals,1,Chicago Cubs,3,1,May 7 2013,2
Atlanta Braves,1,Cincinnati Reds,9,4,May 7 2013,5
Oakland Athletics,1,Cleveland Indians,1,0,May 7 2013,1
New York Yankees,1,Colorado Rockies,2,0,May 7 2013,2
LA Angels of Anaheim,1,Houston Astros,13,6,May 7 2013,7
Arizona D'Backs,0,Los Angeles Dodgers,8,5,May 7 2013,3
Texas Rangers,1,Milwaukee Brewers,9,3,May 7 2013,6
Chicago White Sox,1,New York Mets,1,0,May 7 2013,1
Seattle Mariners,1,Pittsburgh Pirates,5,1,May 7 2013,4
Miami Marlins,1,San Diego Padres,6,1,May 7 2013,5
Philadelphia Phillies,0,San Francisco Giants,8,6,May 7 2013,2
Toronto Blue Jays,0,Tampa Bay Rays,10,6,May 7 2013,4
Kansas City Royals,1,Baltimore Orioles,8,3,May 8 2013,5
Minnesota Twins,0,Boston Red Sox,23,15,May 8 2013,8
St. Louis Cardinals,0,Chicago Cubs,9,5,May 8 2013,4
Atlanta Braves,0,Cincinnati Reds,9,7,May 8 2013,2
Oakland Athletics,1,Cleveland Indians,7,3,May 8 2013,4
New York Yankees,0,Colorado Rockies,5,3,May 8 2013,2
LA Angels of Anaheim,1,Houston Astros,4,1,May 8 2013,3
Arizona D'Backs,0,Los Angeles Dodgers,5,3,May 8 2013,2
Texas Rangers,0,Milwaukee Brewers,5,4,May 8 2013,1
Chicago White Sox,0,New York Mets,9,6,May 8 2013,3
Seattle Mariners,0,Pittsburgh Pirates,3,2,May 8 2013,1
Miami Marlins,1,San Diego Padres,1,0,May 8 2013,1
Philadelphia Phillies,1,San Francisco Giants,7,3,May 8 2013,4
Toronto Blue Jays,1,Tampa Bay Rays,14,4,May 8 2013,10
Detroit Tigers,1,Washington Nationals,4,1,May 8 2013,3
Philadelphia Phillies,1,Arizona D'Backs,3,1,May 9 2013,2
Kansas City Royals,0,Baltimore Orioles,8,6,May 9 2013,2
Minnesota Twins,0,Boston Red Sox,8,5,May 9 2013,3
Oakland Athletics,1,Cleveland Indians,11,2,May 9 2013,9
New York Yankees,0,Colorado Rockies,4,3,May 9 2013,1
LA Angels of Anaheim,0,Houston Astros,11,6,May 9 2013,5
Pittsburgh Pirates,1,New York Mets,5,2,May 9 2013,3
Atlanta Braves,0,San Francisco Giants,9,6,May 9 2013,3
Toronto Blue Jays,1,Tampa Bay Rays,9,4,May 9 2013,5
Detroit Tigers,1,Washington Nationals,9,4,May 9 2013,5
Philadelphia Phillies,1,Arizona D'Backs,5,2,May 10 2013,3
Toronto Blue Jays,1,Boston Red Sox,5,0,May 10 2013,5
LA Angels of Anaheim,0,Chicago White Sox,12,7,May 10 2013,5
Milwaukee Brewers,1,Cincinnati Reds,7,3,May 10 2013,4
Cleveland Indians,1,Detroit Tigers,14,4,May 10 2013,10
Texas Rangers,0,Houston Astros,6,4,May 10 2013,2
New York Yankees,0,Kansas City Royals,17,11,May 10 2013,6
Miami Marlins,0,Los Angeles Dodgers,9,5,May 10 2013,4
Baltimore Orioles,0,Minnesota Twins,15,9,May 10 2013,6
Pittsburgh Pirates,0,New York Mets,10,7,May 10 2013,3
Oakland Athletics,1,Seattle Mariners,9,3,May 10 2013,6
Atlanta Braves,1,San Francisco Giants,10,2,May 10 2013,8
Colorado Rockies,1,St. Louis Cardinals,3,0,May 10 2013,3
San Diego Padres,1,Tampa Bay Rays,9,3,May 10 2013,6
Chicago Cubs,1,Washington Nationals,10,3,May 10 2013,7
Philadelphia Phillies,0,Arizona D'Backs,4,3,May 11 2013,1
Toronto Blue Jays,0,Boston Red Sox,5,3,May 11 2013,2
LA Angels of Anaheim,0,Chicago White Sox,5,3,May 11 2013,2
Milwaukee Brewers,1,Cincinnati Reds,20,7,May 11 2013,13
Cleveland Indians,0,Detroit Tigers,13,7,May 11 2013,6
Texas Rangers,0,Houston Astros,15,8,May 11 2013,7
New York Yankees,0,Kansas City Royals,5,3,May 11 2013,2
Miami Marlins,1,Los Angeles Dodgers,8,1,May 11 2013,7
Baltimore Orioles,1,Minnesota Twins,13,5,May 11 2013,8
Pittsburgh Pirates,0,New York Mets,13,11,May 11 2013,2
Oakland Athletics,0,Seattle Mariners,7,4,May 11 2013,3
Atlanta Braves,1,San Francisco Giants,11,1,May 11 2013,10
Colorado Rockies,1,St. Louis Cardinals,3,0,May 11 2013,3
San Diego Padres,1,Tampa Bay Rays,15,7,May 11 2013,8
Chicago Cubs,0,Washington Nationals,10,8,May 11 2013,2
Philadelphia Phillies,0,Arizona D'Backs,6,4,May 12 2013,2
Toronto Blue Jays,0,Boston Red Sox,16,12,May 12 2013,4
LA Angels of Anaheim,1,Chicago White Sox,3,0,May 12 2013,3
Milwaukee Brewers,1,Cincinnati Reds,6,1,May 12 2013,5
Cleveland Indians,0,Detroit Tigers,7,4,May 12 2013,3
Texas Rangers,0,Houston Astros,19,12,May 12 2013,7
New York Yankees,0,Kansas City Royals,6,4,May 12 2013,2
Miami Marlins,1,Los Angeles Dodgers,8,3,May 12 2013,5
Baltimore Orioles,0,Minnesota Twins,6,6,May 12 2013,0
Pittsburgh Pirates,0,New York Mets,5,3,May 12 2013,2
Oakland Athletics,1,Seattle Mariners,7,1,May 12 2013,6
Atlanta Braves,1,San Francisco Giants,6,1,May 12 2013,5
Colorado Rockies,0,St. Louis Cardinals,10,8,May 12 2013,2
San Diego Padres,1,Tampa Bay Rays,6,2,May 12 2013,4
Chicago Cubs,0,Washington Nationals,3,2,May 12 2013,1
Kansas City Royals,0,LA Angels of Anaheim,15,11,May 13 2013,4
Atlanta Braves,0,Arizona D'Backs,11,10,May 13 2013,1
Colorado Rockies,1,Chicago Cubs,10,1,May 13 2013,9
New York Yankees,1,Cleveland Indians,1,0,May 13 2013,1
New York Yankees,0,Cleveland Indians,7,7,May 13 2013,0
Houston Astros,1,Detroit Tigers,9,2,May 13 2013,7
Washington Nationals,0,Los Angeles Dodgers,8,6,May 13 2013,2
Chicago White Sox,1,Minnesota Twins,13,3,May 13 2013,10
Texas Rangers,1,Oakland Athletics,6,1,May 13 2013,5
Milwaukee Brewers,0,Pittsburgh Pirates,6,5,May 13 2013,1
New York Mets,1,St. Louis Cardinals,9,3,May 13 2013,6
Kansas City Royals,1,LA Angels of Anaheim,8,2,May 14 2013,6
Atlanta Braves,1,Arizona D'Backs,2,0,May 14 2013,2
San Diego Padres,0,Baltimore Orioles,5,3,May 14 2013,2
Colorado Rockies,0,Chicago Cubs,13,9,May 14 2013,4
Houston Astros,1,Detroit Tigers,8,2,May 14 2013,6
Washington Nationals,1,Los Angeles Dodgers,2,0,May 14 2013,2
Cincinnati Reds,0,Miami Marlins,8,6,May 14 2013,2
Chicago White Sox,0,Minnesota Twins,6,4,May 14 2013,2
Seattle Mariners,1,New York Yankees,7,3,May 14 2013,4
Texas Rangers,0,Oakland Athletics,11,6,May 14 2013,5
Cleveland Indians,1,Philadelphia Phillies,8,2,May 14 2013,6
Milwaukee Brewers,1,Pittsburgh Pirates,7,3,May 14 2013,4
New York Mets,1,St. Louis Cardinals,14,4,May 14 2013,10
Boston Red Sox,1,Tampa Bay Rays,8,3,May 14 2013,5
San Francisco Giants,1,Toronto Blue Jays,16,6,May 14 2013,10
Kansas City Royals,0,LA Angels of Anaheim,14,9,May 15 2013,5
Atlanta Braves,1,Arizona D'Backs,8,3,May 15 2013,5
San Diego Padres,0,Baltimore Orioles,12,8,May 15 2013,4
Colorado Rockies,1,Chicago Cubs,9,3,May 15 2013,6
Houston Astros,0,Detroit Tigers,12,7,May 15 2013,5
Washington Nationals,1,Los Angeles Dodgers,4,1,May 15 2013,3
Cincinnati Reds,0,Miami Marlins,4,4,May 15 2013,0
Chicago White Sox,0,Minnesota Twins,13,9,May 15 2013,4
Seattle Mariners,0,New York Yankees,14,12,May 15 2013,2
Texas Rangers,0,Oakland Athletics,8,6,May 15 2013,2
Cleveland Indians,0,Philadelphia Phillies,14,10,May 15 2013,4
Milwaukee Brewers,1,Pittsburgh Pirates,4,1,May 15 2013,3
New York Mets,1,St. Louis Cardinals,6,2,May 15 2013,4
Boston Red Sox,0,Tampa Bay Rays,11,9,May 15 2013,2
San Francisco Giants,1,Toronto Blue Jays,14,3,May 15 2013,11
Chicago White Sox,0,LA Angels of Anaheim,9,5,May 16 2013,4
San Francisco Giants,0,Colorado Rockies,14,8,May 16 2013,6
Cincinnati Reds,0,Miami Marlins,8,5,May 16 2013,3
Seattle Mariners,0,New York Yankees,5,3,May 16 2013,2
Milwaukee Brewers,1,Pittsburgh Pirates,8,1,May 16 2013,7
Washington Nationals,0,San Diego Padres,8,6,May 16 2013,2
New York Mets,0,St. Louis Cardinals,7,5,May 16 2013,2
Boston Red Sox,0,Tampa Bay Rays,7,4,May 16 2013,3
Detroit Tigers,1,Texas Rangers,14,4,May 16 2013,10
Chicago White Sox,0,LA Angels of Anaheim,3,3,May 17 2013,0
Los Angeles Dodgers,1,Atlanta Braves,13,5,May 17 2013,8
Tampa Bay Rays,0,Baltimore Orioles,22,12,May 17 2013,10
New York Mets,0,Chicago Cubs,5,3,May 17 2013,2
Seattle Mariners,1,Cleveland Indians,9,3,May 17 2013,6
San Francisco Giants,1,Colorado Rockies,19,9,May 17 2013,10
Arizona D'Backs,0,Miami Marlins,11,9,May 17 2013,2
Boston Red Sox,0,Minnesota Twins,5,3,May 17 2013,2
Toronto Blue Jays,1,New York Yankees,5,0,May 17 2013,5
Kansas City Royals,1,Oakland Athletics,3,1,May 17 2013,2
Cincinnati Reds,1,Philadelphia Phillies,8,3,May 17 2013,5
Houston Astros,1,Pittsburgh Pirates,9,4,May 17 2013,5
Washington Nationals,0,San Diego Padres,11,6,May 17 2013,5
Milwaukee Brewers,1,St. Louis Cardinals,13,6,May 17 2013,7
Detroit Tigers,0,Texas Rangers,3,2,May 17 2013,1
Chicago White Sox,1,LA Angels of Anaheim,21,9,May 18 2013,12
Los Angeles Dodgers,1,Atlanta Braves,4,1,May 18 2013,3
Tampa Bay Rays,0,Baltimore Orioles,16,10,May 18 2013,6
New York Mets,1,Chicago Cubs,10,2,May 18 2013,8
Seattle Mariners,1,Cleveland Indians,9,4,May 18 2013,5
San Francisco Giants,1,Colorado Rockies,12,2,May 18 2013,10
Arizona D'Backs,0,Miami Marlins,1,1,May 18 2013,0
Boston Red Sox,0,Minnesota Twins,17,12,May 18 2013,5
Toronto Blue Jays,1,New York Yankees,9,2,May 18 2013,7
Kansas City Royals,1,Oakland Athletics,3,1,May 18 2013,2
Cincinnati Reds,0,Philadelphia Phillies,10,10,May 18 2013,0
Houston Astros,0,Pittsburgh Pirates,6,4,May 18 2013,2
Washington Nationals,1,San Diego Padres,3,1,May 18 2013,2
Milwaukee Brewers,0,St. Louis Cardinals,10,6,May 18 2013,4
Detroit Tigers,1,Texas Rangers,9,2,May 18 2013,7
Chicago White Sox,1,LA Angels of Anaheim,8,2,May 19 2013,6
Los Angeles Dodgers,1,Atlanta Braves,7,2,May 19 2013,5
Tampa Bay Rays,0,Baltimore Orioles,4,3,May 19 2013,1
New York Mets,0,Chicago Cubs,7,4,May 19 2013,3
Seattle Mariners,1,Cleveland Indians,6,0,May 19 2013,6
San Francisco Giants,1,Colorado Rockies,5,0,May 19 2013,5
Arizona D'Backs,1,Miami Marlins,3,1,May 19 2013,2
Boston Red Sox,0,Minnesota Twins,6,5,May 19 2013,1
Kansas City Royals,1,Oakland Athletics,7,3,May 19 2013,4
Cincinnati Reds,1,Philadelphia Phillies,5,2,May 19 2013,3
Houston Astros,1,Pittsburgh Pirates,1,0,May 19 2013,1
Washington Nationals,1,San Diego Padres,17,4,May 19 2013,13
Milwaukee Brewers,1,St. Louis Cardinals,6,2,May 19 2013,4
Detroit Tigers,1,Texas Rangers,19,8,May 19 2013,11
Minnesota Twins,1,Atlanta Braves,6,1,May 20 2013,5
New York Yankees,0,Baltimore Orioles,10,6,May 20 2013,4
Boston Red Sox,1,Chicago White Sox,10,4,May 20 2013,6
Seattle Mariners,1,Cleveland Indians,18,8,May 20 2013,10
Arizona D'Backs,0,Colorado Rockies,6,5,May 20 2013,1
Kansas City Royals,1,Houston Astros,11,5,May 20 2013,6
Philadelphia Phillies,1,Miami Marlins,6,1,May 20 2013,5
Los Angeles Dodgers,0,Milwaukee Brewers,4,3,May 20 2013,1
Cincinnati Reds,0,New York Mets,7,4,May 20 2013,3
St. Louis Cardinals,1,San Diego Padres,6,2,May 20 2013,4
Washington Nationals,1,San Francisco Giants,8,0,May 20 2013,8
Oakland Athletics,0,Texas Rangers,11,9,May 20 2013,2
Tampa Bay Rays,1,Toronto Blue Jays,12,5,May 20 2013,7
Seattle Mariners,1,LA Angels of Anaheim,12,0,May 21 2013,12
Minnesota Twins,1,Atlanta Braves,9,4,May 21 2013,5
New York Yankees,1,Baltimore Orioles,5,2,May 21 2013,3
Boston Red Sox,1,Chicago White Sox,4,1,May 21 2013,3
Detroit Tigers,0,Cleveland Indians,6,5,May 21 2013,1
Arizona D'Backs,1,Colorado Rockies,9,4,May 21 2013,5
Kansas City Royals,0,Houston Astros,10,7,May 21 2013,3
Philadelphia Phillies,0,Miami Marlins,10,7,May 21 2013,3
Los Angeles Dodgers,1,Milwaukee Brewers,7,2,May 21 2013,5
Cincinnati Reds,0,New York Mets,4,4,May 21 2013,0
Chicago Cubs,1,Pittsburgh Pirates,9,4,May 21 2013,5
St. Louis Cardinals,0,San Diego Padres,12,10,May 21 2013,2
Washington Nationals,1,San Francisco Giants,6,2,May 21 2013,4
Oakland Athletics,0,Texas Rangers,1,1,May 21 2013,0
Tampa Bay Rays,0,Toronto Blue Jays,7,4,May 21 2013,3
Seattle Mariners,1,LA Angels of Anaheim,8,1,May 22 2013,7
Minnesota Twins,1,Atlanta Braves,11,3,May 22 2013,8
New York Yankees,1,Baltimore Orioles,9,3,May 22 2013,6
Boston Red Sox,0,Chicago White Sox,8,6,May 22 2013,2
Detroit Tigers,0,Cleveland Indians,18,11,May 22 2013,7
Arizona D'Backs,1,Colorado Rockies,5,1,May 22 2013,4
Kansas City Royals,1,Houston Astros,4,1,May 22 2013,3
Philadelphia Phillies,0,Miami Marlins,3,3,May 22 2013,0
Los Angeles Dodgers,0,Milwaukee Brewers,11,9,May 22 2013,2
Cincinnati Reds,0,New York Mets,11,7,May 22 2013,4
Chicago Cubs,1,Pittsburgh Pirates,1,0,May 22 2013,1
St. Louis Cardinals,0,San Diego Padres,8,5,May 22 2013,3
Washington Nationals,0,San Francisco Giants,3,2,May 22 2013,1
Oakland Athletics,1,Texas Rangers,4,1,May 22 2013,3
Tampa Bay Rays,1,Toronto Blue Jays,7,3,May 22 2013,4
Cleveland Indians,0,Boston Red Sox,15,12,May 23 2013,3
Minnesota Twins,1,Detroit Tigers,13,6,May 23 2013,7
LA Angels of Anaheim,0,Kansas City Royals,9,5,May 23 2013,4
Chicago Cubs,1,Pittsburgh Pirates,6,2,May 23 2013,4
Baltimore Orioles,1,Toronto Blue Jays,18,6,May 23 2013,12
San Diego Padres,1,Arizona D'Backs,7,2,May 24 2013,5
Cleveland Indians,1,Boston Red Sox,9,1,May 24 2013,8
Miami Marlins,1,Chicago White Sox,7,3,May 24 2013,4
Chicago Cubs,1,Cincinnati Reds,11,4,May 24 2013,7
Minnesota Twins,1,Detroit Tigers,6,0,May 24 2013,6
Oakland Athletics,0,Houston Astros,11,6,May 24 2013,5
LA Angels of Anaheim,0,Kansas City Royals,7,5,May 24 2013,2
St. Louis Cardinals,0,Los Angeles Dodgers,7,7,May 24 2013,0
Pittsburgh Pirates,1,Milwaukee Brewers,3,1,May 24 2013,2
Atlanta Braves,0,New York Mets,12,7,May 24 2013,5
Texas Rangers,0,Seattle Mariners,14,9,May 24 2013,5
Colorado Rockies,0,San Francisco Giants,5,5,May 24 2013,0
New York Yankees,0,Tampa Bay Rays,13,9,May 24 2013,4
Baltimore Orioles,0,Toronto Blue Jays,16,10,May 24 2013,6
Philadelphia Phillies,1,Washington Nationals,7,2,May 24 2013,5
San Diego Padres,0,Arizona D'Backs,14,10,May 25 2013,4
Cleveland Indians,1,Boston Red Sox,11,4,May 25 2013,7
Miami Marlins,1,Chicago White Sox,3,1,May 25 2013,2
Chicago Cubs,1,Cincinnati Reds,7,2,May 25 2013,5
Minnesota Twins,0,Detroit Tigers,5,3,May 25 2013,2
Oakland Athletics,0,Houston Astros,16,11,May 25 2013,5
LA Angels of Anaheim,0,Kansas City Royals,7,7,May 25 2013,0
St. Louis Cardinals,1,Los Angeles Dodgers,8,3,May 25 2013,5
Pittsburgh Pirates,0,Milwaukee Brewers,7,5,May 25 2013,2
Atlanta Braves,0,New York Mets,6,6,May 25 2013,0
Texas Rangers,0,Seattle Mariners,7,5,May 25 2013,2
Colorado Rockies,1,San Francisco Giants,11,5,May 25 2013,6
New York Yankees,0,Tampa Bay Rays,7,4,May 25 2013,3
Baltimore Orioles,0,Toronto Blue Jays,11,6,May 25 2013,5
Philadelphia Phillies,0,Washington Nationals,8,5,May 25 2013,3
San Diego Padres,1,Arizona D'Backs,11,5,May 26 2013,6
Cleveland Indians,1,Boston Red Sox,11,5,May 26 2013,6
Miami Marlins,1,Chicago White Sox,8,3,May 26 2013,5
Chicago Cubs,0,Cincinnati Reds,9,5,May 26 2013,4
Minnesota Twins,1,Detroit Tigers,7,1,May 26 2013,6
Oakland Athletics,0,Houston Astros,8,6,May 26 2013,2
LA Angels of Anaheim,0,Kansas City Royals,7,5,May 26 2013,2
St. Louis Cardinals,0,Los Angeles Dodgers,8,5,May 26 2013,3
Pittsburgh Pirates,0,Milwaukee Brewers,9,5,May 26 2013,4
Atlanta Braves,1,New York Mets,6,2,May 26 2013,4
Texas Rangers,1,Seattle Mariners,7,3,May 26 2013,4
Colorado Rockies,1,San Francisco Giants,10,3,May 26 2013,7
New York Yankees,1,Tampa Bay Rays,11,3,May 26 2013,8
Baltimore Orioles,1,Toronto Blue Jays,11,5,May 26 2013,6
Philadelphia Phillies,1,Washington Nationals,7,1,May 26 2013,6
Texas Rangers,1,Arizona D'Backs,8,3,May 27 2013,5
Texas Rangers,1,Arizona D'Backs,9,4,May 27 2013,5
Philadelphia Phillies,1,Boston Red Sox,12,3,May 27 2013,9
Chicago Cubs,0,Chicago White Sox,7,7,May 27 2013,0
Cleveland Indians,1,Cincinnati Reds,6,2,May 27 2013,4
Pittsburgh Pirates,1,Detroit Tigers,11,5,May 27 2013,6
Colorado Rockies,1,Houston Astros,5,2,May 27 2013,3
St. Louis Cardinals,0,Kansas City Royals,9,6,May 27 2013,3
LA Angels of Anaheim,1,Los Angeles Dodgers,15,7,May 27 2013,8
Minnesota Twins,0,Milwaukee Brewers,9,6,May 27 2013,3
New York Yankees,1,New York Mets,3,1,May 27 2013,2
San Francisco Giants,1,Oakland Athletics,5,1,May 27 2013,4
San Diego Padres,1,Seattle Mariners,9,0,May 27 2013,9
Miami Marlins,1,Tampa Bay Rays,16,6,May 27 2013,10
Atlanta Braves,1,Toronto Blue Jays,12,3,May 27 2013,9
Baltimore Orioles,0,Washington Nationals,8,6,May 27 2013,2
Philadelphia Phillies,0,Boston Red Sox,4,3,May 28 2013,1
Cleveland Indians,1,Cincinnati Reds,10,2,May 28 2013,8
Pittsburgh Pirates,0,Detroit Tigers,1,1,May 28 2013,0
Colorado Rockies,0,Houston Astros,3,2,May 28 2013,1
St. Louis Cardinals,0,Kansas City Royals,5,4,May 28 2013,1
LA Angels of Anaheim,1,Los Angeles Dodgers,3,0,May 28 2013,3
Minnesota Twins,0,Milwaukee Brewers,11,6,May 28 2013,5
New York Yankees,1,New York Mets,3,1,May 28 2013,2
San Francisco Giants,1,Oakland Athletics,9,3,May 28 2013,6
San Diego Padres,0,Seattle Mariners,7,6,May 28 2013,1
Miami Marlins,1,Tampa Bay Rays,13,6,May 28 2013,7
Atlanta Braves,0,Toronto Blue Jays,13,7,May 28 2013,6
Baltimore Orioles,1,Washington Nationals,12,3,May 28 2013,9
Los Angeles Dodgers,1,LA Angels of Anaheim,7,3,May 29 2013,4
Toronto Blue Jays,0,Atlanta Braves,3,3,May 29 2013,0
Washington Nationals,1,Baltimore Orioles,15,6,May 29 2013,9
Chicago White Sox,1,Chicago Cubs,12,3,May 29 2013,9
Cincinnati Reds,1,Cleveland Indians,7,2,May 29 2013,5
Houston Astros,0,Colorado Rockies,9,6,May 29 2013,3
Tampa Bay Rays,0,Miami Marlins,4,3,May 29 2013,1
Milwaukee Brewers,1,Minnesota Twins,5,1,May 29 2013,4
New York Mets,0,New York Yankees,13,9,May 29 2013,4
Boston Red Sox,1,Philadelphia Phillies,7,3,May 29 2013,4
Detroit Tigers,1,Pittsburgh Pirates,8,3,May 29 2013,5
Seattle Mariners,1,San Diego Padres,5,2,May 29 2013,3
Oakland Athletics,0,San Francisco Giants,15,9,May 29 2013,6
Kansas City Royals,1,St. Louis Cardinals,8,3,May 29 2013,5
Los Angeles Dodgers,1,LA Angels of Anaheim,5,2,May 30 2013,3
Toronto Blue Jays,1,Atlanta Braves,14,3,May 30 2013,11
Washington Nationals,1,Baltimore Orioles,2,0,May 30 2013,2
Chicago White Sox,1,Chicago Cubs,11,3,May 30 2013,8
Cincinnati Reds,1,Cleveland Indians,8,1,May 30 2013,7
Houston Astros,0,Colorado Rockies,12,7,May 30 2013,5
Tampa Bay Rays,0,Miami Marlins,7,5,May 30 2013,2
Milwaukee Brewers,1,Minnesota Twins,14,6,May 30 2013,8
New York Mets,0,New York Yankees,4,3,May 30 2013,1
Boston Red Sox,0,Philadelphia Phillies,11,9,May 30 2013,2
Detroit Tigers,1,Pittsburgh Pirates,1,0,May 30 2013,1
Seattle Mariners,0,San Diego Padres,8,7,May 30 2013,1
Oakland Athletics,1,San Francisco Giants,7,2,May 30 2013,5
Kansas City Royals,0,St. Louis Cardinals,6,4,May 30 2013,2
Arizona D'Backs,1,Texas Rangers,14,5,May 30 2013,9
Houston Astros,0,LA Angels of Anaheim,9,6,May 31 2013,3
Washington Nationals,0,Atlanta Braves,5,3,May 31 2013,2
Detroit Tigers,1,Baltimore Orioles,12,5,May 31 2013,7
Arizona D'Backs,1,Chicago Cubs,9,2,May 31 2013,7
Tampa Bay Rays,0,Cleveland Indians,11,9,May 31 2013,2
Los Angeles Dodgers,0,Colorado Rockies,12,7,May 31 2013,5
New York Mets,1,Miami Marlins,6,1,May 31 2013,5
Seattle Mariners,0,Minnesota Twins,3,3,May 31 2013,0
Boston Red Sox,1,New York Yankees,5,1,May 31 2013,4
Chicago White Sox,1,Oakland Athletics,3,0,May 31 2013,3
Milwaukee Brewers,0,Philadelphia Phillies,13,8,May 31 2013,5
Cincinnati Reds,0,Pittsburgh Pirates,6,6,May 31 2013,0
Toronto Blue Jays,1,San Diego Padres,7,3,May 31 2013,4
Kansas City Royals,1,Texas Rangers,9,2,May 31 2013,7
Houston Astros,0,LA Angels of Anaheim,2,2,June 1 2013,0
Washington Nationals,1,Atlanta Braves,3,1,June 1 2013,2
Detroit Tigers,0,Baltimore Orioles,13,10,June 1 2013,3
Arizona D'Backs,0,Chicago Cubs,16,12,June 1 2013,4
Tampa Bay Rays,1,Cleveland Indians,5,0,June 1 2013,5
Los Angeles Dodgers,1,Colorado Rockies,13,6,June 1 2013,7
New York Mets,1,Miami Marlins,9,1,June 1 2013,8
Seattle Mariners,1,Minnesota Twins,9,4,June 1 2013,5
Boston Red Sox,0,New York Yankees,12,11,June 1 2013,1
Chicago White Sox,1,Oakland Athletics,7,3,June 1 2013,4
Milwaukee Brewers,0,Philadelphia Phillies,7,4,June 1 2013,3
Cincinnati Reds,0,Pittsburgh Pirates,2,2,June 1 2013,0
Toronto Blue Jays,1,San Diego Padres,7,3,June 1 2013,4
San Francisco Giants,1,St. Louis Cardinals,8,0,June 1 2013,8
San Francisco Giants,1,St. Louis Cardinals,8,1,June 1 2013,7
Kansas City Royals,0,Texas Rangers,5,4,June 1 2013,1
Houston Astros,0,LA Angels of Anaheim,9,5,June 2 2013,4
Washington Nationals,1,Atlanta Braves,9,3,June 2 2013,6
Detroit Tigers,1,Baltimore Orioles,6,2,June 2 2013,4
Arizona D'Backs,0,Chicago Cubs,12,8,June 2 2013,4
Tampa Bay Rays,0,Cleveland Indians,14,11,June 2 2013,3
Los Angeles Dodgers,1,Colorado Rockies,9,2,June 2 2013,7
New York Mets,1,Miami Marlins,17,6,June 2 2013,11
Seattle Mariners,1,Minnesota Twins,10,0,June 2 2013,10
Boston Red Sox,0,New York Yankees,3,3,June 2 2013,0
Chicago White Sox,1,Oakland Athletics,2,0,June 2 2013,2
Milwaukee Brewers,1,Philadelphia Phillies,12,5,June 2 2013,7
Cincinnati Reds,1,Pittsburgh Pirates,9,4,June 2 2013,5
Toronto Blue Jays,0,San Diego Padres,11,7,June 2 2013,4
San Francisco Giants,0,St. Louis Cardinals,6,4,June 2 2013,2
Kansas City Royals,1,Texas Rangers,4,1,June 2 2013,3
Houston Astros,0,LA Angels of Anaheim,3,2,June 3 2013,1
Pittsburgh Pirates,1,Atlanta Braves,9,2,June 3 2013,7
Colorado Rockies,1,Cincinnati Reds,3,0,June 3 2013,3
San Diego Padres,1,Los Angeles Dodgers,3,1,June 3 2013,2
Oakland Athletics,0,Milwaukee Brewers,12,10,June 3 2013,2
Cleveland Indians,1,New York Yankees,11,4,June 3 2013,7
Miami Marlins,1,Philadelphia Phillies,9,2,June 3 2013,7
Chicago White Sox,1,Seattle Mariners,6,2,June 3 2013,4
Arizona D'Backs,1,St. Louis Cardinals,8,1,June 3 2013,7
Chicago Cubs,1,LA Angels of Anaheim,7,3,June 4 2013,4
Pittsburgh Pirates,1,Atlanta Braves,9,4,June 4 2013,5
Texas Rangers,1,Boston Red Sox,22,5,June 4 2013,17
Colorado Rockies,0,Cincinnati Reds,9,5,June 4 2013,4
Tampa Bay Rays,1,Detroit Tigers,11,1,June 4 2013,10
Baltimore Orioles,0,Houston Astros,5,4,June 4 2013,1
Minnesota Twins,0,Kansas City Royals,3,3,June 4 2013,0
San Diego Padres,1,Los Angeles Dodgers,16,7,June 4 2013,9
Oakland Athletics,1,Milwaukee Brewers,7,3,June 4 2013,4
Cleveland Indians,1,New York Yankees,7,3,June 4 2013,4
Miami Marlins,1,Philadelphia Phillies,10,3,June 4 2013,7
Chicago White Sox,1,Seattle Mariners,11,4,June 4 2013,7
Toronto Blue Jays,1,San Francisco Giants,3,1,June 4 2013,2
Arizona D'Backs,0,St. Louis Cardinals,13,7,June 4 2013,6
New York Mets,1,Washington Nationals,5,2,June 4 2013,3
Chicago Cubs,0,LA Angels of Anaheim,14,8,June 5 2013,6
Pittsburgh Pirates,1,Atlanta Braves,5,0,June 5 2013,5
Texas Rangers,0,Boston Red Sox,5,3,June 5 2013,2
Colorado Rockies,0,Cincinnati Reds,16,12,June 5 2013,4
Tampa Bay Rays,0,Detroit Tigers,3,3,June 5 2013,0
Baltimore Orioles,1,Houston Astros,18,7,June 5 2013,11
Minnesota Twins,1,Kansas City Royals,5,1,June 5 2013,4
San Diego Padres,0,Los Angeles Dodgers,8,6,June 5 2013,2
Oakland Athletics,0,Milwaukee Brewers,7,6,June 5 2013,1
Cleveland Indians,1,New York Yankees,10,4,June 5 2013,6
Miami Marlins,1,Philadelphia Phillies,7,1,June 5 2013,6
Chicago White Sox,0,Seattle Mariners,12,7,June 5 2013,5
Toronto Blue Jays,0,San Francisco Giants,4,4,June 5 2013,0
Arizona D'Backs,0,St. Louis Cardinals,13,10,June 5 2013,3
New York Mets,0,Washington Nationals,11,10,June 5 2013,1
Texas Rangers,1,Boston Red Sox,9,3,June 6 2013,6
Oakland Athletics,0,Chicago White Sox,9,5,June 6 2013,4
San Diego Padres,0,Colorado Rockies,11,6,June 6 2013,5
Tampa Bay Rays,1,Detroit Tigers,7,2,June 6 2013,5
Baltimore Orioles,0,Houston Astros,4,3,June 6 2013,1
Minnesota Twins,1,Kansas City Royals,10,3,June 6 2013,7
Atlanta Braves,1,Los Angeles Dodgers,5,0,June 6 2013,5
Philadelphia Phillies,0,Milwaukee Brewers,6,5,June 6 2013,1
New York Yankees,0,Seattle Mariners,7,6,June 6 2013,1
Arizona D'Backs,1,St. Louis Cardinals,20,8,June 6 2013,12
San Francisco Giants,1,Arizona D'Backs,4,1,June 7 2013,3
Oakland Athletics,0,Chicago White Sox,7,4,June 7 2013,3
Pittsburgh Pirates,0,Chicago Cubs,2,2,June 7 2013,0
St. Louis Cardinals,0,Cincinnati Reds,11,9,June 7 2013,2
San Diego Padres,1,Colorado Rockies,19,9,June 7 2013,10
Cleveland Indians,1,Detroit Tigers,12,5,June 7 2013,7
Houston Astros,1,Kansas City Royals,6,2,June 7 2013,4
Atlanta Braves,1,Los Angeles Dodgers,3,1,June 7 2013,2
Philadelphia Phillies,1,Milwaukee Brewers,9,4,June 7 2013,5
New York Yankees,1,Seattle Mariners,5,1,June 7 2013,4
Baltimore Orioles,1,Tampa Bay Rays,3,1,June 7 2013,2
Texas Rangers,1,Toronto Blue Jays,7,1,June 7 2013,6
San Francisco Giants,0,Arizona D'Backs,15,10,June 8 2013,5
LA Angels of Anaheim,0,Boston Red Sox,14,9,June 8 2013,5
LA Angels of Anaheim,1,Boston Red Sox,9,2,June 8 2013,7
Oakland Athletics,1,Chicago White Sox,5,1,June 8 2013,4
Pittsburgh Pirates,0,Chicago Cubs,8,6,June 8 2013,2
St. Louis Cardinals,1,Cincinnati Reds,6,2,June 8 2013,4
San Diego Padres,0,Colorado Rockies,6,4,June 8 2013,2
Cleveland Indians,1,Detroit Tigers,10,4,June 8 2013,6
Houston Astros,1,Kansas City Royals,9,2,June 8 2013,7
Atlanta Braves,0,Los Angeles Dodgers,3,2,June 8 2013,1
Philadelphia Phillies,1,Milwaukee Brewers,7,3,June 8 2013,4
Miami Marlins,0,New York Mets,3,2,June 8 2013,1
New York Yankees,0,Seattle Mariners,4,3,June 8 2013,1
Baltimore Orioles,1,Tampa Bay Rays,8,0,June 8 2013,8
Texas Rangers,1,Toronto Blue Jays,7,3,June 8 2013,4
Minnesota Twins,0,Washington Nationals,7,4,June 8 2013,3
San Francisco Giants,0,Arizona D'Backs,8,6,June 9 2013,2
LA Angels of Anaheim,1,Boston Red Sox,15,5,June 9 2013,10
Oakland Athletics,1,Chicago White Sox,6,2,June 9 2013,4
Pittsburgh Pirates,1,Chicago Cubs,5,1,June 9 2013,4
St. Louis Cardinals,0,Cincinnati Reds,15,11,June 9 2013,4
San Diego Padres,1,Colorado Rockies,15,7,June 9 2013,8
Cleveland Indians,1,Detroit Tigers,5,1,June 9 2013,4
Houston Astros,1,Kansas City Royals,2,0,June 9 2013,2
Atlanta Braves,0,Los Angeles Dodgers,9,8,June 9 2013,1
Philadelphia Phillies,1,Milwaukee Brewers,10,1,June 9 2013,9
Miami Marlins,0,New York Mets,12,8,June 9 2013,4
New York Yankees,0,Seattle Mariners,3,2,June 9 2013,1
Baltimore Orioles,0,Tampa Bay Rays,17,10,June 9 2013,7
Texas Rangers,0,Toronto Blue Jays,10,6,June 9 2013,4
Minnesota Twins,1,Washington Nationals,7,0,June 9 2013,7
Minnesota Twins,1,Washington Nationals,9,4,June 9 2013,5
LA Angels of Anaheim,1,Baltimore Orioles,7,3,June 10 2013,4
Toronto Blue Jays,1,Chicago White Sox,16,6,June 10 2013,10
Cincinnati Reds,0,Chicago Cubs,8,6,June 10 2013,2
Detroit Tigers,1,Kansas City Royals,5,2,June 10 2013,3
Arizona D'Backs,0,Los Angeles Dodgers,9,5,June 10 2013,4
Milwaukee Brewers,0,Miami Marlins,7,6,June 10 2013,1
Atlanta Braves,1,San Diego Padres,13,6,June 10 2013,7
Houston Astros,1,Seattle Mariners,5,2,June 10 2013,3
Boston Red Sox,0,Tampa Bay Rays,18,10,June 10 2013,8
Cleveland Indians,1,Texas Rangers,9,3,June 10 2013,6
LA Angels of Anaheim,1,Baltimore Orioles,5,2,June 11 2013,3
Toronto Blue Jays,0,Chicago White Sox,12,7,June 11 2013,5
Cincinnati Reds,0,Chicago Cubs,14,12,June 11 2013,2
Washington Nationals,1,Colorado Rockies,11,3,June 11 2013,8
Detroit Tigers,0,Kansas City Royals,5,3,June 11 2013,2
Arizona D'Backs,1,Los Angeles Dodgers,8,3,June 11 2013,5
Milwaukee Brewers,1,Miami Marlins,9,4,June 11 2013,5
Philadelphia Phillies,1,Minnesota Twins,5,2,June 11 2013,3
St. Louis Cardinals,0,New York Mets,11,9,June 11 2013,2
New York Yankees,1,Oakland Athletics,10,4,June 11 2013,6
San Francisco Giants,1,Pittsburgh Pirates,10,2,June 11 2013,8
Atlanta Braves,1,San Diego Padres,5,2,June 11 2013,3
Houston Astros,1,Seattle Mariners,4,0,June 11 2013,4
Boston Red Sox,1,Tampa Bay Rays,11,3,June 11 2013,8
Cleveland Indians,0,Texas Rangers,7,5,June 11 2013,2
LA Angels of Anaheim,0,Baltimore Orioles,14,9,June 12 2013,5
Cincinnati Reds,0,Chicago Cubs,3,2,June 12 2013,1
Washington Nationals,0,Colorado Rockies,6,5,June 12 2013,1
Detroit Tigers,1,Kansas City Royals,5,2,June 12 2013,3
Arizona D'Backs,0,Los Angeles Dodgers,14,8,June 12 2013,6
Milwaukee Brewers,0,Miami Marlins,11,10,June 12 2013,1
Philadelphia Phillies,1,Minnesota Twins,7,3,June 12 2013,4
St. Louis Cardinals,1,New York Mets,6,1,June 12 2013,5
New York Yankees,1,Oakland Athletics,7,2,June 12 2013,5
San Francisco Giants,1,Pittsburgh Pirates,20,8,June 12 2013,12
Atlanta Braves,1,San Diego Padres,8,3,June 12 2013,5
Houston Astros,0,Seattle Mariners,7,6,June 12 2013,1
Boston Red Sox,0,Tampa Bay Rays,3,2,June 12 2013,1
Cleveland Indians,0,Texas Rangers,7,5,June 12 2013,2
Boston Red Sox,1,Baltimore Orioles,9,4,June 13 2013,5
Cincinnati Reds,1,Chicago Cubs,11,5,June 13 2013,6
Washington Nationals,0,Colorado Rockies,9,5,June 13 2013,4
Philadelphia Phillies,0,Minnesota Twins,5,3,June 13 2013,2
St. Louis Cardinals,0,New York Mets,3,2,June 13 2013,1
New York Yankees,1,Oakland Athletics,5,2,June 13 2013,3
San Francisco Giants,0,Pittsburgh Pirates,10,10,June 13 2013,0
Kansas City Royals,0,Tampa Bay Rays,11,10,June 13 2013,1
Toronto Blue Jays,0,Texas Rangers,4,3,June 13 2013,1
New York Yankees,1,LA Angels of Anaheim,7,2,June 14 2013,5
San Francisco Giants,0,Atlanta Braves,6,6,June 14 2013,0
Boston Red Sox,1,Baltimore Orioles,2,0,June 14 2013,2
Milwaukee Brewers,1,Cincinnati Reds,7,3,June 14 2013,4
Washington Nationals,1,Cleveland Indians,3,1,June 14 2013,2
Philadelphia Phillies,0,Colorado Rockies,15,8,June 14 2013,7
Chicago White Sox,1,Houston Astros,3,1,June 14 2013,2
St. Louis Cardinals,1,Miami Marlins,9,4,June 14 2013,5
Detroit Tigers,0,Minnesota Twins,4,4,June 14 2013,0
Chicago Cubs,0,New York Mets,9,6,June 14 2013,3
Seattle Mariners,0,Oakland Athletics,5,3,June 14 2013,2
Los Angeles Dodgers,1,Pittsburgh Pirates,3,0,June 14 2013,3
Arizona D'Backs,1,San Diego Padres,3,1,June 14 2013,2
Kansas City Royals,0,Tampa Bay Rays,9,7,June 14 2013,2
Toronto Blue Jays,0,Texas Rangers,8,8,June 14 2013,0
New York Yankees,1,LA Angels of Anaheim,8,2,June 15 2013,6
San Francisco Giants,1,Atlanta Braves,11,5,June 15 2013,6
Boston Red Sox,0,Baltimore Orioles,9,5,June 15 2013,4
Milwaukee Brewers,0,Cincinnati Reds,6,6,June 15 2013,0
Washington Nationals,0,Cleveland Indians,13,7,June 15 2013,6
Philadelphia Phillies,1,Colorado Rockies,15,5,June 15 2013,10
Chicago White Sox,1,Houston Astros,7,3,June 15 2013,4
St. Louis Cardinals,0,Miami Marlins,20,13,June 15 2013,7
Detroit Tigers,1,Minnesota Twins,9,3,June 15 2013,6
Chicago Cubs,0,New York Mets,7,5,June 15 2013,2
Seattle Mariners,0,Oakland Athletics,4,4,June 15 2013,0
Los Angeles Dodgers,0,Pittsburgh Pirates,8,5,June 15 2013,3
Arizona D'Backs,1,San Diego Padres,10,4,June 15 2013,6
Kansas City Royals,1,Tampa Bay Rays,8,3,June 15 2013,5
Toronto Blue Jays,0,Texas Rangers,7,6,June 15 2013,1
New York Yankees,0,LA Angels of Anaheim,11,6,June 16 2013,5
San Francisco Giants,1,Atlanta Braves,3,0,June 16 2013,3
Boston Red Sox,1,Baltimore Orioles,9,3,June 16 2013,6
Milwaukee Brewers,1,Cincinnati Reds,6,1,June 16 2013,5
Washington Nationals,1,Cleveland Indians,2,0,June 16 2013,2
Philadelphia Phillies,1,Colorado Rockies,7,2,June 16 2013,5
Chicago White Sox,1,Houston Astros,9,4,June 16 2013,5
St. Louis Cardinals,1,Miami Marlins,9,2,June 16 2013,7
Detroit Tigers,0,Minnesota Twins,7,5,June 16 2013,2
Chicago Cubs,1,New York Mets,7,3,June 16 2013,4
Seattle Mariners,1,Oakland Athletics,12,2,June 16 2013,10
Los Angeles Dodgers,1,Pittsburgh Pirates,9,3,June 16 2013,6
Arizona D'Backs,1,San Diego Padres,5,1,June 16 2013,4
Kansas City Royals,0,Tampa Bay Rays,8,5,June 16 2013,3
Toronto Blue Jays,0,Texas Rangers,9,7,June 16 2013,2
Seattle Mariners,1,LA Angels of Anaheim,14,3,June 17 2013,11
Miami Marlins,0,Arizona D'Backs,5,3,June 17 2013,2
New York Mets,1,Atlanta Braves,3,1,June 17 2013,2
Pittsburgh Pirates,1,Cincinnati Reds,5,1,June 17 2013,4
Kansas City Royals,0,Cleveland Indians,3,2,June 17 2013,1
Baltimore Orioles,1,Detroit Tigers,6,1,June 17 2013,5
Chicago White Sox,0,Houston Astros,6,4,June 17 2013,2
Washington Nationals,1,Philadelphia Phillies,9,4,June 17 2013,5
San Diego Padres,0,San Francisco Giants,8,5,June 17 2013,3
Chicago Cubs,1,St. Louis Cardinals,7,2,June 17 2013,5
Oakland Athletics,1,Texas Rangers,15,7,June 17 2013,8
Colorado Rockies,1,Toronto Blue Jays,2,0,June 17 2013,2
Seattle Mariners,0,LA Angels of Anaheim,5,3,June 18 2013,2
Miami Marlins,1,Arizona D'Backs,5,2,June 18 2013,3
New York Mets,0,Atlanta Braves,7,4,June 18 2013,3
New York Mets,0,Atlanta Braves,7,6,June 18 2013,1
Tampa Bay Rays,1,Boston Red Sox,6,1,June 18 2013,5
Tampa Bay Rays,1,Boston Red Sox,4,1,June 18 2013,3
Pittsburgh Pirates,0,Cincinnati Reds,4,4,June 18 2013,0
Kansas City Royals,1,Cleveland Indians,7,3,June 18 2013,4
Baltimore Orioles,0,Detroit Tigers,7,5,June 18 2013,2
Milwaukee Brewers,1,Houston Astros,11,1,June 18 2013,10
Chicago White Sox,1,Minnesota Twins,12,5,June 18 2013,7
Washington Nationals,1,Philadelphia Phillies,6,2,June 18 2013,4
San Diego Padres,1,San Francisco Giants,9,4,June 18 2013,5
Chicago Cubs,0,St. Louis Cardinals,6,4,June 18 2013,2
Oakland Athletics,0,Texas Rangers,8,6,June 18 2013,2
Colorado Rockies,1,Toronto Blue Jays,11,3,June 18 2013,8
Seattle Mariners,1,LA Angels of Anaheim,1,0,June 19 2013,1
Miami Marlins,1,Arizona D'Backs,4,1,June 19 2013,3
New York Mets,1,Atlanta Braves,8,3,June 19 2013,5
Tampa Bay Rays,0,Boston Red Sox,8,6,June 19 2013,2
Pittsburgh Pirates,1,Cincinnati Reds,3,1,June 19 2013,2
Kansas City Royals,1,Cleveland Indians,9,3,June 19 2013,6
Baltimore Orioles,0,Detroit Tigers,16,13,June 19 2013,3
Milwaukee Brewers,0,Houston Astros,4,3,June 19 2013,1
Chicago White Sox,1,Minnesota Twins,11,4,June 19 2013,7
Los Angeles Dodgers,1,New York Yankees,10,4,June 19 2013,6
Los Angeles Dodgers,0,New York Yankees,6,6,June 19 2013,0
Washington Nationals,0,Philadelphia Phillies,8,6,June 19 2013,2
San Diego Padres,1,San Francisco Giants,6,2,June 19 2013,4
Chicago Cubs,1,St. Louis Cardinals,5,1,June 19 2013,4
Oakland Athletics,1,Texas Rangers,13,4,June 19 2013,9
Colorado Rockies,1,Toronto Blue Jays,7,2,June 19 2013,5
Seattle Mariners,1,LA Angels of Anaheim,19,9,June 20 2013,10
New York Mets,0,Atlanta Braves,7,4,June 20 2013,3
Pittsburgh Pirates,0,Cincinnati Reds,8,5,June 20 2013,3
Boston Red Sox,1,Detroit Tigers,7,3,June 20 2013,4
Milwaukee Brewers,1,Houston Astros,11,4,June 20 2013,7
Chicago White Sox,1,Minnesota Twins,12,4,June 20 2013,8
Tampa Bay Rays,0,New York Yankees,11,8,June 20 2013,3
Los Angeles Dodgers,1,San Diego Padres,9,3,June 20 2013,6
Miami Marlins,0,San Francisco Giants,3,2,June 20 2013,1
Chicago Cubs,1,St. Louis Cardinals,7,1,June 20 2013,6
Oakland Athletics,1,Texas Rangers,7,3,June 20 2013,4
Colorado Rockies,1,Washington Nationals,6,1,June 20 2013,5
Pittsburgh Pirates,0,LA Angels of Anaheim,7,5,June 21 2013,2
Cincinnati Reds,1,Arizona D'Backs,16,5,June 21 2013,11
Houston Astros,1,Chicago Cubs,4,1,June 21 2013,3
Minnesota Twins,1,Cleveland Indians,6,1,June 21 2013,5
Boston Red Sox,0,Detroit Tigers,16,10,June 21 2013,6
Chicago White Sox,0,Kansas City Royals,10,9,June 21 2013,1
Atlanta Braves,1,Milwaukee Brewers,2,0,June 21 2013,2
Tampa Bay Rays,1,New York Yankees,8,2,June 21 2013,6
New York Mets,0,Philadelphia Phillies,7,4,June 21 2013,3
Los Angeles Dodgers,1,San Diego Padres,7,2,June 21 2013,5
Oakland Athletics,0,Seattle Mariners,9,6,June 21 2013,3
Miami Marlins,0,San Francisco Giants,9,6,June 21 2013,3
Texas Rangers,0,St. Louis Cardinals,10,6,June 21 2013,4
Baltimore Orioles,1,Toronto Blue Jays,13,6,June 21 2013,7
Colorado Rockies,1,Washington Nationals,3,1,June 21 2013,2
Pittsburgh Pirates,0,LA Angels of Anaheim,7,6,June 22 2013,1
Cincinnati Reds,1,Arizona D'Backs,7,3,June 22 2013,4
Houston Astros,0,Chicago Cubs,7,4,June 22 2013,3
Minnesota Twins,1,Cleveland Indians,15,7,June 22 2013,8
Boston Red Sox,1,Detroit Tigers,13,3,June 22 2013,10
Chicago White Sox,0,Kansas City Royals,5,3,June 22 2013,2
Atlanta Braves,1,Milwaukee Brewers,2,0,June 22 2013,2
Tampa Bay Rays,1,New York Yankees,12,5,June 22 2013,7
New York Mets,1,Philadelphia Phillies,15,7,June 22 2013,8
Los Angeles Dodgers,0,San Diego Padres,7,6,June 22 2013,1
Oakland Athletics,1,Seattle Mariners,12,5,June 22 2013,7
Miami Marlins,1,San Francisco Giants,3,1,June 22 2013,2
Texas Rangers,0,St. Louis Cardinals,6,4,June 22 2013,2
Baltimore Orioles,1,Toronto Blue Jays,6,2,June 22 2013,4
Colorado Rockies,0,Washington Nationals,8,7,June 22 2013,1
Pittsburgh Pirates,0,LA Angels of Anaheim,19,10,June 23 2013,9
Cincinnati Reds,0,Arizona D'Backs,6,4,June 23 2013,2
Houston Astros,1,Chicago Cubs,20,6,June 23 2013,14
Minnesota Twins,0,Cleveland Indians,8,5,June 23 2013,3
Boston Red Sox,1,Detroit Tigers,12,5,June 23 2013,7
Chicago White Sox,1,Kansas City Royals,13,6,June 23 2013,7
Atlanta Braves,0,Milwaukee Brewers,11,7,June 23 2013,4
Tampa Bay Rays,0,New York Yankees,4,3,June 23 2013,1
New York Mets,0,Philadelphia Phillies,8,8,June 23 2013,0
Los Angeles Dodgers,0,San Diego Padres,4,3,June 23 2013,1
Oakland Athletics,1,Seattle Mariners,9,3,June 23 2013,6
Miami Marlins,0,San Francisco Giants,9,7,June 23 2013,2
Texas Rangers,0,St. Louis Cardinals,3,2,June 23 2013,1
Baltimore Orioles,1,Toronto Blue Jays,18,5,June 23 2013,13
Colorado Rockies,0,Washington Nationals,13,7,June 23 2013,6
Cleveland Indians,0,Baltimore Orioles,7,5,June 24 2013,2
San Francisco Giants,1,Los Angeles Dodgers,4,1,June 24 2013,3
Philadelphia Phillies,1,San Diego Padres,7,3,June 24 2013,4
Toronto Blue Jays,1,Tampa Bay Rays,5,1,June 24 2013,4
Cleveland Indians,1,Baltimore Orioles,9,3,June 25 2013,6
Colorado Rockies,1,Boston Red Sox,15,4,June 25 2013,11
New York Mets,1,Chicago White Sox,9,4,June 25 2013,5
LA Angels of Anaheim,0,Detroit Tigers,22,14,June 25 2013,8
St. Louis Cardinals,0,Houston Astros,18,13,June 25 2013,5
Atlanta Braves,0,Kansas City Royals,7,4,June 25 2013,3
San Francisco Giants,1,Los Angeles Dodgers,11,5,June 25 2013,6
Minnesota Twins,1,Miami Marlins,6,2,June 25 2013,4
Chicago Cubs,1,Milwaukee Brewers,12,3,June 25 2013,9
Texas Rangers,1,New York Yankees,7,3,June 25 2013,4
Cincinnati Reds,1,Oakland Athletics,10,3,June 25 2013,7
Philadelphia Phillies,0,San Diego Padres,8,6,June 25 2013,2
Pittsburgh Pirates,0,Seattle Mariners,13,9,June 25 2013,4
Toronto Blue Jays,1,Tampa Bay Rays,6,1,June 25 2013,5
Arizona D'Backs,1,Washington Nationals,12,5,June 25 2013,7
Cleveland Indians,0,Baltimore Orioles,7,4,June 26 2013,3
Colorado Rockies,1,Boston Red Sox,8,3,June 26 2013,5
New York Mets,0,Chicago White Sox,3,3,June 26 2013,0
LA Angels of Anaheim,0,Detroit Tigers,11,7,June 26 2013,4
St. Louis Cardinals,1,Houston Astros,7,3,June 26 2013,4
Atlanta Braves,1,Kansas City Royals,7,3,June 26 2013,4
San Francisco Giants,1,Los Angeles Dodgers,6,2,June 26 2013,4
Minnesota Twins,1,Miami Marlins,8,3,June 26 2013,5
Chicago Cubs,0,Milwaukee Brewers,9,5,June 26 2013,4
Texas Rangers,0,New York Yankees,13,8,June 26 2013,5
Cincinnati Reds,1,Oakland Athletics,5,0,June 26 2013,5
Philadelphia Phillies,0,San Diego Padres,12,7,June 26 2013,5
Pittsburgh Pirates,0,Seattle Mariners,6,4,June 26 2013,2
Toronto Blue Jays,0,Tampa Bay Rays,3,3,June 26 2013,0
Arizona D'Backs,1,Washington Nationals,5,2,June 26 2013,3
Cleveland Indians,1,Baltimore Orioles,10,3,June 27 2013,7
Toronto Blue Jays,1,Boston Red Sox,11,4,June 27 2013,7
New York Mets,0,Colorado Rockies,5,3,June 27 2013,2
LA Angels of Anaheim,0,Detroit Tigers,4,3,June 27 2013,1
Philadelphia Phillies,1,Los Angeles Dodgers,10,4,June 27 2013,6
Chicago Cubs,0,Milwaukee Brewers,9,7,June 27 2013,2
Kansas City Royals,1,Minnesota Twins,4,1,June 27 2013,3
Texas Rangers,0,New York Yankees,2,2,June 27 2013,0
Arizona D'Backs,0,Washington Nationals,5,3,June 27 2013,2
Arizona D'Backs,1,Atlanta Braves,3,0,June 28 2013,3
New York Yankees,1,Baltimore Orioles,7,3,June 28 2013,4
Toronto Blue Jays,1,Boston Red Sox,12,5,June 28 2013,7
Cleveland Indians,0,Chicago White Sox,29,19,June 28 2013,10
Cleveland Indians,0,Chicago White Sox,17,9,June 28 2013,8
San Francisco Giants,1,Colorado Rockies,5,1,June 28 2013,4
LA Angels of Anaheim,0,Houston Astros,6,4,June 28 2013,2
Philadelphia Phillies,0,Los Angeles Dodgers,17,16,June 28 2013,1
San Diego Padres,0,Miami Marlins,11,9,June 28 2013,2
Kansas City Royals,0,Minnesota Twins,12,9,June 28 2013,3
Washington Nationals,0,New York Mets,10,6,June 28 2013,4
St. Louis Cardinals,1,Oakland Athletics,7,1,June 28 2013,6
Milwaukee Brewers,1,Pittsburgh Pirates,13,3,June 28 2013,10
Chicago Cubs,1,Seattle Mariners,9,4,June 28 2013,5
Detroit Tigers,0,Tampa Bay Rays,9,6,June 28 2013,3
Cincinnati Reds,1,Texas Rangers,4,0,June 28 2013,4
Arizona D'Backs,1,Atlanta Braves,16,5,June 29 2013,11
New York Yankees,1,Baltimore Orioles,14,3,June 29 2013,11
Toronto Blue Jays,0,Boston Red Sox,8,6,June 29 2013,2
Cleveland Indians,0,Chicago White Sox,7,4,June 29 2013,3
San Francisco Giants,1,Colorado Rockies,3,1,June 29 2013,2
LA Angels of Anaheim,0,Houston Astros,9,7,June 29 2013,2
Philadelphia Phillies,1,Los Angeles Dodgers,7,3,June 29 2013,4
San Diego Padres,1,Miami Marlins,8,1,June 29 2013,7
Kansas City Royals,1,Minnesota Twins,8,2,June 29 2013,6
Washington Nationals,1,New York Mets,6,1,June 29 2013,5
St. Louis Cardinals,0,Oakland Athletics,8,7,June 29 2013,1
Milwaukee Brewers,1,Pittsburgh Pirates,3,1,June 29 2013,2
Chicago Cubs,0,Seattle Mariners,8,5,June 29 2013,3
Detroit Tigers,1,Tampa Bay Rays,7,3,June 29 2013,4
Cincinnati Reds,0,Texas Rangers,10,6,June 29 2013,4
Arizona D'Backs,1,Atlanta Braves,8,2,June 30 2013,6
New York Yankees,1,Baltimore Orioles,6,2,June 30 2013,4
Toronto Blue Jays,1,Boston Red Sox,9,4,June 30 2013,5
Cleveland Indians,0,Chicago White Sox,4,4,June 30 2013,0
San Francisco Giants,0,Colorado Rockies,7,5,June 30 2013,2
LA Angels of Anaheim,0,Houston Astros,4,3,June 30 2013,1
Philadelphia Phillies,1,Los Angeles Dodgers,7,1,June 30 2013,6
San Diego Padres,1,Miami Marlins,8,2,June 30 2013,6
Kansas City Royals,0,Minnesota Twins,17,9,June 30 2013,8
Washington Nationals,0,New York Mets,15,13,June 30 2013,2
St. Louis Cardinals,1,Oakland Athletics,12,5,June 30 2013,7
Milwaukee Brewers,1,Pittsburgh Pirates,3,1,June 30 2013,2
Chicago Cubs,0,Seattle Mariners,13,7,June 30 2013,6
Detroit Tigers,1,Tampa Bay Rays,4,1,June 30 2013,3
Cincinnati Reds,1,Texas Rangers,5,2,June 30 2013,3
San Francisco Giants,1,Cincinnati Reds,9,1,July 1 2013,8
Tampa Bay Rays,0,Houston Astros,12,12,July 1 2013,0
San Diego Padres,1,Miami Marlins,4,0,July 1 2013,4
New York Yankees,0,Minnesota Twins,14,10,July 1 2013,4
Arizona D'Backs,1,New York Mets,9,4,July 1 2013,5
Detroit Tigers,1,Toronto Blue Jays,11,3,July 1 2013,8
Milwaukee Brewers,1,Washington Nationals,15,5,July 1 2013,10
St. Louis Cardinals,1,LA Angels of Anaheim,6,1,July 2 2013,5
Miami Marlins,1,Atlanta Braves,14,3,July 2 2013,11
San Diego Padres,1,Boston Red Sox,5,1,July 2 2013,4
Baltimore Orioles,1,Chicago White Sox,7,2,July 2 2013,5
San Francisco Giants,1,Cincinnati Reds,3,0,July 2 2013,3
Los Angeles Dodgers,0,Colorado Rockies,8,8,July 2 2013,0
Tampa Bay Rays,0,Houston Astros,8,8,July 2 2013,0
Cleveland Indians,0,Kansas City Royals,11,6,July 2 2013,5
New York Yankees,0,Minnesota Twins,10,7,July 2 2013,3
Arizona D'Backs,1,New York Mets,10,1,July 2 2013,9
Chicago Cubs,1,Oakland Athletics,15,7,July 2 2013,8
Philadelphia Phillies,0,Pittsburgh Pirates,4,3,July 2 2013,1
Seattle Mariners,0,Texas Rangers,11,9,July 2 2013,2
Detroit Tigers,0,Toronto Blue Jays,13,7,July 2 2013,6
Milwaukee Brewers,0,Washington Nationals,4,4,July 2 2013,0
St. Louis Cardinals,0,LA Angels of Anaheim,14,12,July 3 2013,2
Miami Marlins,0,Atlanta Braves,9,6,July 3 2013,3
San Diego Padres,1,Boston Red Sox,3,1,July 3 2013,2
Baltimore Orioles,0,Chicago White Sox,6,4,July 3 2013,2
San Francisco Giants,1,Cincinnati Reds,5,2,July 3 2013,3
Los Angeles Dodgers,0,Colorado Rockies,18,10,July 3 2013,8
Tampa Bay Rays,1,Houston Astros,5,1,July 3 2013,4
Cleveland Indians,1,Kansas City Royals,11,5,July 3 2013,6
New York Yankees,0,Minnesota Twins,5,3,July 3 2013,2
Arizona D'Backs,0,New York Mets,8,5,July 3 2013,3
Chicago Cubs,0,Oakland Athletics,4,3,July 3 2013,1
Philadelphia Phillies,1,Pittsburgh Pirates,11,5,July 3 2013,6
Seattle Mariners,0,Texas Rangers,6,4,July 3 2013,2
Detroit Tigers,0,Toronto Blue Jays,8,6,July 3 2013,2
Milwaukee Brewers,0,Washington Nationals,5,4,July 3 2013,1
St. Louis Cardinals,1,LA Angels of Anaheim,11,5,July 4 2013,6
Miami Marlins,0,Atlanta Braves,7,4,July 4 2013,3
San Diego Padres,1,Boston Red Sox,10,2,July 4 2013,8
Baltimore Orioles,1,Chicago White Sox,5,2,July 4 2013,3
Los Angeles Dodgers,1,Colorado Rockies,14,5,July 4 2013,9
Tampa Bay Rays,0,Houston Astros,12,7,July 4 2013,5
Cleveland Indians,1,Kansas City Royals,17,7,July 4 2013,10
New York Yankees,0,Minnesota Twins,14,9,July 4 2013,5
Arizona D'Backs,0,New York Mets,9,5,July 4 2013,4
Chicago Cubs,1,Oakland Athletics,1,0,July 4 2013,1
Philadelphia Phillies,0,Pittsburgh Pirates,10,6,July 4 2013,4
Seattle Mariners,1,Texas Rangers,9,4,July 4 2013,5
Detroit Tigers,0,Toronto Blue Jays,12,11,July 4 2013,1
Milwaukee Brewers,1,Washington Nationals,13,5,July 4 2013,8
Boston Red Sox,0,LA Angels of Anaheim,8,6,July 5 2013,2
Colorado Rockies,1,Arizona D'Backs,5,0,July 5 2013,5
Pittsburgh Pirates,0,Chicago Cubs,8,6,July 5 2013,2
Seattle Mariners,0,Cincinnati Reds,6,4,July 5 2013,2
Detroit Tigers,0,Cleveland Indians,7,7,July 5 2013,0
Oakland Athletics,0,Kansas City Royals,9,6,July 5 2013,3
New York Mets,0,Milwaukee Brewers,17,12,July 5 2013,5
Baltimore Orioles,1,New York Yankees,5,2,July 5 2013,3
Atlanta Braves,1,Philadelphia Phillies,9,4,July 5 2013,5
Los Angeles Dodgers,0,San Francisco Giants,12,10,July 5 2013,2
Miami Marlins,1,St. Louis Cardinals,5,1,July 5 2013,4
Chicago White Sox,1,Tampa Bay Rays,11,3,July 5 2013,8
Houston Astros,1,Texas Rangers,15,5,July 5 2013,10
Minnesota Twins,1,Toronto Blue Jays,4,0,July 5 2013,4
San Diego Padres,1,Washington Nationals,13,5,July 5 2013,8
Boston Red Sox,1,LA Angels of Anaheim,16,7,July 6 2013,9
Colorado Rockies,1,Arizona D'Backs,12,1,July 6 2013,11
Pittsburgh Pirates,1,Chicago Cubs,5,1,July 6 2013,4
Seattle Mariners,1,Cincinnati Reds,17,4,July 6 2013,13
Detroit Tigers,0,Cleveland Indians,13,9,July 6 2013,4
Oakland Athletics,1,Kansas City Royals,7,3,July 6 2013,4
New York Mets,1,Milwaukee Brewers,13,6,July 6 2013,7
Baltimore Orioles,1,New York Yankees,9,4,July 6 2013,5
Atlanta Braves,0,Philadelphia Phillies,17,13,July 6 2013,4
Los Angeles Dodgers,1,San Francisco Giants,6,2,July 6 2013,4
Miami Marlins,1,St. Louis Cardinals,9,4,July 6 2013,5
Chicago White Sox,1,Tampa Bay Rays,3,0,July 6 2013,3
Houston Astros,0,Texas Rangers,14,9,July 6 2013,5
Minnesota Twins,0,Toronto Blue Jays,6,6,July 6 2013,0
San Diego Padres,1,Washington Nationals,9,4,July 6 2013,5
Boston Red Sox,1,LA Angels of Anaheim,3,0,July 7 2013,3
Colorado Rockies,1,Arizona D'Backs,7,1,July 7 2013,6
Pittsburgh Pirates,1,Chicago Cubs,7,3,July 7 2013,4
Seattle Mariners,0,Cincinnati Reds,4,3,July 7 2013,1
Detroit Tigers,1,Cleveland Indians,15,6,July 7 2013,9
Oakland Athletics,0,Kansas City Royals,14,10,July 7 2013,4
New York Mets,0,Milwaukee Brewers,3,2,July 7 2013,1
Baltimore Orioles,0,New York Yankees,3,2,July 7 2013,1
Atlanta Braves,1,Philadelphia Phillies,10,3,July 7 2013,7
Los Angeles Dodgers,0,San Francisco Giants,5,4,July 7 2013,1
Miami Marlins,1,St. Louis Cardinals,5,2,July 7 2013,3
Chicago White Sox,1,Tampa Bay Rays,4,1,July 7 2013,3
Houston Astros,1,Texas Rangers,9,4,July 7 2013,5
Minnesota Twins,1,Toronto Blue Jays,16,5,July 7 2013,11
San Diego Padres,1,Washington Nationals,18,7,July 7 2013,11
Los Angeles Dodgers,0,Arizona D'Backs,7,6,July 8 2013,1
Texas Rangers,0,Baltimore Orioles,13,8,July 8 2013,5
Chicago Cubs,0,Chicago White Sox,10,8,July 8 2013,2
Detroit Tigers,0,Cleveland Indians,6,4,July 8 2013,2
Atlanta Braves,0,Miami Marlins,8,7,July 8 2013,1
Cincinnati Reds,1,Milwaukee Brewers,7,3,July 8 2013,4
Kansas City Royals,0,New York Yankees,6,5,July 8 2013,1
Washington Nationals,1,Philadelphia Phillies,5,2,July 8 2013,3
Oakland Athletics,0,Pittsburgh Pirates,3,2,July 8 2013,1
Colorado Rockies,0,San Diego Padres,6,4,July 8 2013,2
Boston Red Sox,1,Seattle Mariners,15,4,July 8 2013,11
New York Mets,0,San Francisco Giants,7,4,July 8 2013,3
Minnesota Twins,1,Tampa Bay Rays,11,4,July 8 2013,7
Los Angeles Dodgers,0,Arizona D'Backs,7,6,July 9 2013,1
Texas Rangers,0,Baltimore Orioles,12,8,July 9 2013,4
LA Angels of Anaheim,1,Chicago Cubs,9,2,July 9 2013,7
Toronto Blue Jays,1,Cleveland Indians,3,0,July 9 2013,3
Chicago White Sox,0,Detroit Tigers,15,11,July 9 2013,4
Atlanta Braves,0,Miami Marlins,10,6,July 9 2013,4
Cincinnati Reds,1,Milwaukee Brewers,2,0,July 9 2013,2
Kansas City Royals,0,New York Yankees,4,3,July 9 2013,1
Washington Nationals,1,Philadelphia Phillies,6,2,July 9 2013,4
Oakland Athletics,0,Pittsburgh Pirates,3,2,July 9 2013,1
Colorado Rockies,1,San Diego Padres,3,1,July 9 2013,2
Boston Red Sox,0,Seattle Mariners,19,11,July 9 2013,8
New York Mets,0,San Francisco Giants,16,10,July 9 2013,6
Houston Astros,1,St. Louis Cardinals,14,5,July 9 2013,9
Minnesota Twins,1,Tampa Bay Rays,5,1,July 9 2013,4
Los Angeles Dodgers,0,Arizona D'Backs,12,7,July 10 2013,5
Texas Rangers,1,Baltimore Orioles,7,1,July 10 2013,6
LA Angels of Anaheim,0,Chicago Cubs,15,13,July 10 2013,2
Toronto Blue Jays,0,Cleveland Indians,9,5,July 10 2013,4
Chicago White Sox,1,Detroit Tigers,13,5,July 10 2013,8
Atlanta Braves,1,Miami Marlins,8,2,July 10 2013,6
Cincinnati Reds,0,Milwaukee Brewers,8,6,July 10 2013,2
Kansas City Royals,1,New York Yankees,9,1,July 10 2013,8
Washington Nationals,0,Philadelphia Phillies,6,5,July 10 2013,1
Oakland Athletics,1,Pittsburgh Pirates,5,0,July 10 2013,5
Colorado Rockies,0,San Diego Padres,9,5,July 10 2013,4
Boston Red Sox,0,Seattle Mariners,15,11,July 10 2013,4
New York Mets,0,San Francisco Giants,9,7,July 10 2013,2
Houston Astros,1,St. Louis Cardinals,9,4,July 10 2013,5
Minnesota Twins,1,Tampa Bay Rays,7,3,July 10 2013,4
Milwaukee Brewers,1,Arizona D'Backs,8,3,July 11 2013,5
Cincinnati Reds,1,Atlanta Braves,11,5,July 11 2013,6
Texas Rangers,1,Baltimore Orioles,4,1,July 11 2013,3
St. Louis Cardinals,1,Chicago Cubs,3,0,July 11 2013,3
Toronto Blue Jays,1,Cleveland Indians,6,2,July 11 2013,4
Chicago White Sox,0,Detroit Tigers,9,6,July 11 2013,3
Colorado Rockies,1,Los Angeles Dodgers,7,1,July 11 2013,6
Kansas City Royals,1,New York Yankees,12,4,July 11 2013,8
Washington Nationals,1,Philadelphia Phillies,4,1,July 11 2013,3
San Francisco Giants,0,San Diego Padres,6,4,July 11 2013,2
Boston Red Sox,0,Seattle Mariners,15,8,July 11 2013,7
Minnesota Twins,1,Tampa Bay Rays,7,3,July 11 2013,4
Milwaukee Brewers,1,Arizona D'Backs,3,1,July 12 2013,2
Cincinnati Reds,0,Atlanta Braves,6,4,July 12 2013,2
Toronto Blue Jays,1,Baltimore Orioles,13,5,July 12 2013,8
St. Louis Cardinals,0,Chicago Cubs,5,3,July 12 2013,2
Kansas City Royals,1,Cleveland Indians,3,0,July 12 2013,3
Texas Rangers,1,Detroit Tigers,9,2,July 12 2013,7
Colorado Rockies,0,Los Angeles Dodgers,3,3,July 12 2013,0
Washington Nationals,1,Miami Marlins,11,3,July 12 2013,8
Minnesota Twins,1,New York Yankees,2,0,July 12 2013,2
Boston Red Sox,0,Oakland Athletics,6,4,July 12 2013,2
New York Mets,1,Pittsburgh Pirates,5,2,July 12 2013,3
San Francisco Giants,0,San Diego Padres,11,10,July 12 2013,1
LA Angels of Anaheim,1,Seattle Mariners,11,3,July 12 2013,8
Houston Astros,0,Tampa Bay Rays,3,2,July 12 2013,1
Milwaukee Brewers,1,Arizona D'Backs,9,4,July 13 2013,5
Cincinnati Reds,1,Atlanta Braves,7,2,July 13 2013,5
Toronto Blue Jays,0,Baltimore Orioles,10,7,July 13 2013,3
St. Louis Cardinals,1,Chicago Cubs,10,4,July 13 2013,6
Kansas City Royals,1,Cleveland Indians,8,3,July 13 2013,5
Texas Rangers,0,Detroit Tigers,8,7,July 13 2013,1
Colorado Rockies,1,Los Angeles Dodgers,1,0,July 13 2013,1
Washington Nationals,1,Miami Marlins,3,1,July 13 2013,2
Minnesota Twins,0,New York Yankees,5,4,July 13 2013,1
Boston Red Sox,1,Oakland Athletics,3,0,July 13 2013,3
Chicago White Sox,0,Philadelphia Phillies,9,5,July 13 2013,4
Chicago White Sox,1,Philadelphia Phillies,3,1,July 13 2013,2
New York Mets,1,Pittsburgh Pirates,6,2,July 13 2013,4
San Francisco Giants,0,San Diego Padres,9,9,July 13 2013,0
LA Angels of Anaheim,1,Seattle Mariners,6,0,July 13 2013,6
Houston Astros,1,Tampa Bay Rays,7,3,July 13 2013,4
Milwaukee Brewers,0,Arizona D'Backs,6,5,July 14 2013,1
Cincinnati Reds,0,Atlanta Braves,12,8,July 14 2013,4
Toronto Blue Jays,1,Baltimore Orioles,11,4,July 14 2013,7
St. Louis Cardinals,0,Chicago Cubs,16,10,July 14 2013,6
Kansas City Royals,1,Cleveland Indians,10,4,July 14 2013,6
Texas Rangers,1,Detroit Tigers,5,0,July 14 2013,5
Colorado Rockies,0,Los Angeles Dodgers,4,3,July 14 2013,1
Washington Nationals,0,Miami Marlins,7,5,July 14 2013,2
Minnesota Twins,0,New York Yankees,14,10,July 14 2013,4
Boston Red Sox,1,Oakland Athletics,5,2,July 14 2013,3
Chicago White Sox,1,Philadelphia Phillies,7,3,July 14 2013,4
New York Mets,0,Pittsburgh Pirates,6,4,July 14 2013,2
San Francisco Giants,1,San Diego Padres,11,1,July 14 2013,10
LA Angels of Anaheim,1,Seattle Mariners,7,3,July 14 2013,4
Houston Astros,1,Tampa Bay Rays,5,0,July 14 2013,5
Oakland Athletics,1,LA Angels of Anaheim,5,1,July 19 2013,4
New York Yankees,1,Boston Red Sox,6,2,July 19 2013,4
Atlanta Braves,0,Chicago White Sox,10,6,July 19 2013,4
Pittsburgh Pirates,1,Cincinnati Reds,8,3,July 19 2013,5
Chicago Cubs,0,Colorado Rockies,4,3,July 19 2013,1
Seattle Mariners,0,Houston Astros,17,10,July 19 2013,7
Detroit Tigers,1,Kansas City Royals,1,0,July 19 2013,1
Miami Marlins,1,Milwaukee Brewers,2,0,July 19 2013,2
Cleveland Indians,1,Minnesota Twins,5,2,July 19 2013,3
Philadelphia Phillies,0,New York Mets,21,13,July 19 2013,8
Arizona D'Backs,1,San Francisco Giants,2,0,July 19 2013,2
San Diego Padres,1,St. Louis Cardinals,15,6,July 19 2013,9
Baltimore Orioles,0,Texas Rangers,4,3,July 19 2013,1
Tampa Bay Rays,0,Toronto Blue Jays,13,8,July 19 2013,5
Los Angeles Dodgers,0,Washington Nationals,5,3,July 19 2013,2
Oakland Athletics,1,LA Angels of Anaheim,2,0,July 20 2013,2
New York Yankees,0,Boston Red Sox,7,5,July 20 2013,2
Atlanta Braves,1,Chicago White Sox,16,6,July 20 2013,10
Pittsburgh Pirates,1,Cincinnati Reds,9,4,July 20 2013,5
Chicago Cubs,1,Colorado Rockies,12,3,July 20 2013,9
Seattle Mariners,0,Houston Astros,6,4,July 20 2013,2
Detroit Tigers,1,Kansas City Royals,11,5,July 20 2013,6
Miami Marlins,1,Milwaukee Brewers,6,0,July 20 2013,6
Cleveland Indians,1,Minnesota Twins,5,2,July 20 2013,3
Philadelphia Phillies,1,New York Mets,9,4,July 20 2013,5
Arizona D'Backs,1,San Francisco Giants,7,3,July 20 2013,4
San Diego Padres,0,St. Louis Cardinals,8,5,July 20 2013,3
Baltimore Orioles,0,Texas Rangers,11,7,July 20 2013,4
Tampa Bay Rays,0,Toronto Blue Jays,7,4,July 20 2013,3
Los Angeles Dodgers,0,Washington Nationals,4,3,July 20 2013,1
Oakland Athletics,0,LA Angels of Anaheim,6,6,July 21 2013,0
New York Yankees,1,Boston Red Sox,15,7,July 21 2013,8
Atlanta Braves,1,Chicago White Sox,4,1,July 21 2013,3
Pittsburgh Pirates,0,Cincinnati Reds,5,3,July 21 2013,2
Chicago Cubs,1,Colorado Rockies,7,3,July 21 2013,4
Seattle Mariners,0,Houston Astros,17,12,July 21 2013,5
Detroit Tigers,0,Kansas City Royals,5,4,July 21 2013,1
Miami Marlins,1,Milwaukee Brewers,1,0,July 21 2013,1
Cleveland Indians,0,Minnesota Twins,8,7,July 21 2013,1
Philadelphia Phillies,1,New York Mets,5,0,July 21 2013,5
Arizona D'Backs,0,San Francisco Giants,4,3,July 21 2013,1
San Diego Padres,1,St. Louis Cardinals,5,2,July 21 2013,3
Baltimore Orioles,0,Texas Rangers,6,4,July 21 2013,2
Tampa Bay Rays,0,Toronto Blue Jays,7,4,July 21 2013,3
Los Angeles Dodgers,0,Washington Nationals,11,9,July 21 2013,2
Minnesota Twins,0,LA Angels of Anaheim,7,4,July 22 2013,3
Chicago Cubs,0,Arizona D'Backs,6,4,July 22 2013,2
Tampa Bay Rays,0,Boston Red Sox,3,3,July 22 2013,0
Detroit Tigers,0,Chicago White Sox,10,7,July 22 2013,3
Miami Marlins,0,Colorado Rockies,4,3,July 22 2013,1
Oakland Athletics,0,Houston Astros,7,4,July 22 2013,3
Baltimore Orioles,0,Kansas City Royals,11,9,July 22 2013,2
San Diego Padres,0,Milwaukee Brewers,8,5,July 22 2013,3
Atlanta Braves,0,New York Mets,3,2,July 22 2013,1
Cleveland Indians,1,Seattle Mariners,3,1,July 22 2013,2
Cincinnati Reds,0,San Francisco Giants,11,11,July 22 2013,0
New York Yankees,1,Texas Rangers,3,0,July 22 2013,3
Los Angeles Dodgers,0,Toronto Blue Jays,19,14,July 22 2013,5
Pittsburgh Pirates,0,Washington Nationals,11,6,July 22 2013,5
Minnesota Twins,0,LA Angels of Anaheim,13,10,July 23 2013,3
Chicago Cubs,1,Arizona D'Backs,14,4,July 23 2013,10
Tampa Bay Rays,1,Boston Red Sox,8,2,July 23 2013,6
Detroit Tigers,0,Chicago White Sox,8,6,July 23 2013,2
Miami Marlins,0,Colorado Rockies,6,4,July 23 2013,2
Oakland Athletics,1,Houston Astros,9,4,July 23 2013,5
Baltimore Orioles,1,Kansas City Royals,5,2,July 23 2013,3
San Diego Padres,0,Milwaukee Brewers,8,6,July 23 2013,2
Atlanta Braves,1,New York Mets,5,1,July 23 2013,4
Cleveland Indians,1,Seattle Mariners,7,3,July 23 2013,4
Cincinnati Reds,0,San Francisco Giants,12,9,July 23 2013,3
Cincinnati Reds,1,San Francisco Giants,8,3,July 23 2013,5
Philadelphia Phillies,1,St. Louis Cardinals,5,1,July 23 2013,4
New York Yankees,0,Texas Rangers,9,5,July 23 2013,4
Los Angeles Dodgers,0,Toronto Blue Jays,19,10,July 23 2013,9
Pittsburgh Pirates,0,Washington Nationals,6,5,July 23 2013,1
Minnesota Twins,1,LA Angels of Anaheim,1,0,July 24 2013,1
Chicago Cubs,0,Arizona D'Backs,13,7,July 24 2013,6
Tampa Bay Rays,0,Boston Red Sox,6,5,July 24 2013,1
Detroit Tigers,0,Chicago White Sox,8,6,July 24 2013,2
Miami Marlins,1,Colorado Rockies,3,1,July 24 2013,2
Oakland Athletics,0,Houston Astros,7,4,July 24 2013,3
Baltimore Orioles,1,Kansas City Royals,7,3,July 24 2013,4
San Diego Padres,1,Milwaukee Brewers,4,1,July 24 2013,3
Atlanta Braves,0,New York Mets,10,8,July 24 2013,2
Cleveland Indians,0,Seattle Mariners,11,10,July 24 2013,1
Cincinnati Reds,0,San Francisco Giants,11,8,July 24 2013,3
Philadelphia Phillies,1,St. Louis Cardinals,14,3,July 24 2013,11
New York Yankees,1,Texas Rangers,4,1,July 24 2013,3
Los Angeles Dodgers,0,Toronto Blue Jays,11,8,July 24 2013,3
Pittsburgh Pirates,0,Washington Nationals,6,4,July 24 2013,2
Chicago Cubs,1,Arizona D'Backs,4,1,July 25 2013,3
Detroit Tigers,1,Chicago White Sox,11,4,July 25 2013,7
Miami Marlins,0,Colorado Rockies,8,5,July 25 2013,3
Baltimore Orioles,1,Kansas City Royals,8,1,July 25 2013,7
Cincinnati Reds,0,Los Angeles Dodgers,7,5,July 25 2013,2
San Diego Padres,0,Milwaukee Brewers,18,10,July 25 2013,8
Atlanta Braves,1,New York Mets,11,4,July 25 2013,7
LA Angels of Anaheim,0,Oakland Athletics,11,8,July 25 2013,3
Minnesota Twins,1,Seattle Mariners,10,2,July 25 2013,8
Philadelphia Phillies,1,St. Louis Cardinals,4,1,July 25 2013,3
New York Yankees,0,Texas Rangers,2,2,July 25 2013,0
Houston Astros,1,Toronto Blue Jays,4,0,July 25 2013,4
Pittsburgh Pirates,1,Washington Nationals,16,7,July 25 2013,9
San Diego Padres,1,Arizona D'Backs,10,0,July 26 2013,10
St. Louis Cardinals,1,Atlanta Braves,5,1,July 26 2013,4
Boston Red Sox,1,Baltimore Orioles,6,0,July 26 2013,6
Kansas City Royals,0,Chicago White Sox,6,5,July 26 2013,1
Texas Rangers,1,Cleveland Indians,19,8,July 26 2013,11
Milwaukee Brewers,1,Colorado Rockies,11,3,July 26 2013,8
Philadelphia Phillies,1,Detroit Tigers,3,1,July 26 2013,2
Cincinnati Reds,1,Los Angeles Dodgers,3,1,July 26 2013,2
Pittsburgh Pirates,1,Miami Marlins,2,0,July 26 2013,2
Tampa Bay Rays,0,New York Yankees,16,10,July 26 2013,6
LA Angels of Anaheim,1,Oakland Athletics,10,4,July 26 2013,6
Minnesota Twins,0,Seattle Mariners,5,3,July 26 2013,2
Chicago Cubs,0,San Francisco Giants,5,3,July 26 2013,2
Houston Astros,1,Toronto Blue Jays,18,6,July 26 2013,12
New York Mets,0,Washington Nationals,11,11,July 26 2013,0
New York Mets,1,Washington Nationals,3,1,July 26 2013,2
San Diego Padres,0,Arizona D'Backs,15,12,July 27 2013,3
St. Louis Cardinals,1,Atlanta Braves,2,0,July 27 2013,2
Boston Red Sox,0,Baltimore Orioles,10,7,July 27 2013,3
Kansas City Royals,0,Chicago White Sox,1,1,July 27 2013,0
Texas Rangers,1,Cleveland Indians,1,0,July 27 2013,1
Milwaukee Brewers,0,Colorado Rockies,12,7,July 27 2013,5
Philadelphia Phillies,1,Detroit Tigers,10,0,July 27 2013,10
Cincinnati Reds,1,Los Angeles Dodgers,5,1,July 27 2013,4
Pittsburgh Pirates,0,Miami Marlins,11,7,July 27 2013,4
Tampa Bay Rays,0,New York Yankees,1,1,July 27 2013,0
LA Angels of Anaheim,1,Oakland Athletics,4,1,July 27 2013,3
Minnesota Twins,0,Seattle Mariners,4,4,July 27 2013,0
Chicago Cubs,0,San Francisco Giants,1,1,July 27 2013,0
Houston Astros,0,Toronto Blue Jays,14,8,July 27 2013,6
New York Mets,1,Washington Nationals,5,1,July 27 2013,4
San Diego Padres,0,Arizona D'Backs,1,1,July 28 2013,0
St. Louis Cardinals,1,Atlanta Braves,7,2,July 28 2013,5
Boston Red Sox,0,Baltimore Orioles,5,5,July 28 2013,0
Kansas City Royals,0,Chicago White Sox,6,4,July 28 2013,2
Texas Rangers,1,Cleveland Indians,6,0,July 28 2013,6
Milwaukee Brewers,1,Colorado Rockies,11,5,July 28 2013,6
Philadelphia Phillies,1,Detroit Tigers,16,4,July 28 2013,12
Cincinnati Reds,1,Los Angeles Dodgers,1,0,July 28 2013,1
Pittsburgh Pirates,1,Miami Marlins,5,2,July 28 2013,3
Tampa Bay Rays,1,New York Yankees,11,5,July 28 2013,6
LA Angels of Anaheim,1,Oakland Athletics,16,6,July 28 2013,10
Minnesota Twins,1,Seattle Mariners,10,4,July 28 2013,6
Chicago Cubs,0,San Francisco Giants,3,2,July 28 2013,1
Houston Astros,1,Toronto Blue Jays,3,1,July 28 2013,2
New York Mets,1,Washington Nationals,15,1,July 28 2013,14
Colorado Rockies,1,Atlanta Braves,17,8,July 29 2013,9
Tampa Bay Rays,0,Boston Red Sox,3,2,July 29 2013,1
Milwaukee Brewers,0,Chicago Cubs,5,5,July 29 2013,0
Chicago White Sox,1,Cleveland Indians,5,2,July 29 2013,3
New York Mets,0,Miami Marlins,11,6,July 29 2013,5
Toronto Blue Jays,1,Oakland Athletics,13,4,July 29 2013,9
St. Louis Cardinals,1,Pittsburgh Pirates,11,2,July 29 2013,9
Cincinnati Reds,1,San Diego Padres,3,1,July 29 2013,2
LA Angels of Anaheim,1,Texas Rangers,7,3,July 29 2013,4
Colorado Rockies,1,Atlanta Braves,14,3,July 30 2013,11
Houston Astros,1,Baltimore Orioles,7,3,July 30 2013,4
Seattle Mariners,1,Boston Red Sox,10,2,July 30 2013,8
Milwaukee Brewers,0,Chicago Cubs,11,6,July 30 2013,5
Milwaukee Brewers,0,Chicago Cubs,5,3,July 30 2013,2
Chicago White Sox,1,Cleveland Indians,11,4,July 30 2013,7
Washington Nationals,1,Detroit Tigers,6,1,July 30 2013,5
New York Yankees,1,Los Angeles Dodgers,5,2,July 30 2013,3
New York Mets,0,Miami Marlins,6,4,July 30 2013,2
Kansas City Royals,0,Minnesota Twins,9,7,July 30 2013,2
Toronto Blue Jays,0,Oakland Athletics,5,5,July 30 2013,0
San Francisco Giants,1,Philadelphia Phillies,10,3,July 30 2013,7
St. Louis Cardinals,1,Pittsburgh Pirates,3,1,July 30 2013,2
St. Louis Cardinals,1,Pittsburgh Pirates,6,0,July 30 2013,6
Cincinnati Reds,1,San Diego Padres,6,2,July 30 2013,4
Arizona D'Backs,1,Tampa Bay Rays,7,2,July 30 2013,5
LA Angels of Anaheim,1,Texas Rangers,25,11,July 30 2013,14
Colorado Rockies,1,Atlanta Braves,9,0,July 31 2013,9
Houston Astros,0,Baltimore Orioles,11,11,July 31 2013,0
Seattle Mariners,1,Boston Red Sox,9,4,July 31 2013,5
Milwaukee Brewers,1,Chicago Cubs,7,1,July 31 2013,6
Chicago White Sox,1,Cleveland Indians,11,5,July 31 2013,6
Washington Nationals,1,Detroit Tigers,12,1,July 31 2013,11
New York Yankees,0,Los Angeles Dodgers,3,3,July 31 2013,0
New York Mets,1,Miami Marlins,5,2,July 31 2013,3
Kansas City Royals,0,Minnesota Twins,7,4,July 31 2013,3
Toronto Blue Jays,0,Oakland Athletics,7,5,July 31 2013,2
San Francisco Giants,0,Philadelphia Phillies,11,9,July 31 2013,2
St. Louis Cardinals,1,Pittsburgh Pirates,9,4,July 31 2013,5
Cincinnati Reds,0,San Diego Padres,5,4,July 31 2013,1
Arizona D'Backs,0,Tampa Bay Rays,7,7,July 31 2013,0
LA Angels of Anaheim,1,Texas Rangers,3,1,July 31 2013,2
Toronto Blue Jays,1,LA Angels of Anaheim,10,2,August 1 2013,8
Colorado Rockies,1,Atlanta Braves,13,2,August 1 2013,11
Houston Astros,1,Baltimore Orioles,9,3,August 1 2013,6
Seattle Mariners,1,Boston Red Sox,15,7,August 1 2013,8
Los Angeles Dodgers,0,Chicago Cubs,10,6,August 1 2013,4
Chicago White Sox,1,Cleveland Indians,7,1,August 1 2013,6
New York Mets,1,Miami Marlins,3,0,August 1 2013,3
Kansas City Royals,0,Minnesota Twins,9,7,August 1 2013,2
San Francisco Giants,0,Philadelphia Phillies,3,2,August 1 2013,1
St. Louis Cardinals,0,Pittsburgh Pirates,13,13,August 1 2013,0
Arizona D'Backs,1,Texas Rangers,8,1,August 1 2013,7
Toronto Blue Jays,1,LA Angels of Anaheim,12,5,August 2 2013,7
Seattle Mariners,1,Baltimore Orioles,19,8,August 2 2013,11
Arizona D'Backs,0,Boston Red Sox,13,7,August 2 2013,6
Los Angeles Dodgers,0,Chicago Cubs,8,6,August 2 2013,2
St. Louis Cardinals,0,Cincinnati Reds,16,13,August 2 2013,3
Chicago White Sox,1,Detroit Tigers,3,1,August 2 2013,2
Cleveland Indians,1,Miami Marlins,10,0,August 2 2013,10
Washington Nationals,0,Milwaukee Brewers,5,4,August 2 2013,1
Houston Astros,1,Minnesota Twins,7,3,August 2 2013,4
Kansas City Royals,1,New York Mets,6,2,August 2 2013,4
Texas Rangers,0,Oakland Athletics,11,8,August 2 2013,3
Atlanta Braves,0,Philadelphia Phillies,10,6,August 2 2013,4
Colorado Rockies,0,Pittsburgh Pirates,6,4,August 2 2013,2
New York Yankees,1,San Diego Padres,9,2,August 2 2013,7
San Francisco Giants,0,Tampa Bay Rays,5,4,August 2 2013,1
Toronto Blue Jays,1,LA Angels of Anaheim,10,3,August 3 2013,7
Seattle Mariners,0,Baltimore Orioles,12,8,August 3 2013,4
Arizona D'Backs,1,Boston Red Sox,7,2,August 3 2013,5
Los Angeles Dodgers,0,Chicago Cubs,3,3,August 3 2013,0
St. Louis Cardinals,1,Cincinnati Reds,11,3,August 3 2013,8
Chicago White Sox,1,Detroit Tigers,3,0,August 3 2013,3
Cleveland Indians,0,Miami Marlins,7,4,August 3 2013,3
Washington Nationals,0,Milwaukee Brewers,3,3,August 3 2013,0
Houston Astros,1,Minnesota Twins,10,4,August 3 2013,6
Kansas City Royals,0,New York Mets,7,4,August 3 2013,3
Texas Rangers,1,Oakland Athletics,6,2,August 3 2013,4
Atlanta Braves,0,Philadelphia Phillies,9,5,August 3 2013,4
Colorado Rockies,1,Pittsburgh Pirates,7,2,August 3 2013,5
New York Yankees,0,San Diego Padres,3,3,August 3 2013,0
San Francisco Giants,1,Tampa Bay Rays,3,1,August 3 2013,2
Toronto Blue Jays,0,LA Angels of Anaheim,11,6,August 4 2013,5
Seattle Mariners,0,Baltimore Orioles,5,3,August 4 2013,2
Arizona D'Backs,1,Boston Red Sox,4,0,August 4 2013,4
Los Angeles Dodgers,0,Chicago Cubs,1,1,August 4 2013,0
St. Louis Cardinals,0,Cincinnati Reds,17,15,August 4 2013,2
Chicago White Sox,1,Detroit Tigers,5,2,August 4 2013,3
Cleveland Indians,0,Miami Marlins,2,2,August 4 2013,0
Washington Nationals,1,Milwaukee Brewers,13,5,August 4 2013,8
Houston Astros,1,Minnesota Twins,5,2,August 4 2013,3
Kansas City Royals,0,New York Mets,8,6,August 4 2013,2
Texas Rangers,0,Oakland Athletics,4,4,August 4 2013,0
Atlanta Braves,0,Philadelphia Phillies,5,4,August 4 2013,1
Colorado Rockies,1,Pittsburgh Pirates,6,1,August 4 2013,5
New York Yankees,1,San Diego Padres,9,3,August 4 2013,6
San Francisco Giants,1,Tampa Bay Rays,7,3,August 4 2013,4
Texas Rangers,0,LA Angels of Anaheim,7,5,August 5 2013,2
New York Yankees,1,Chicago White Sox,9,1,August 5 2013,8
Detroit Tigers,0,Cleveland Indians,6,4,August 5 2013,2
Boston Red Sox,1,Houston Astros,2,0,August 5 2013,2
Minnesota Twins,1,Kansas City Royals,13,0,August 5 2013,13
Toronto Blue Jays,0,Seattle Mariners,4,3,August 5 2013,1
Milwaukee Brewers,1,San Francisco Giants,6,2,August 5 2013,4
Los Angeles Dodgers,0,St. Louis Cardinals,5,3,August 5 2013,2
Atlanta Braves,0,Washington Nationals,5,3,August 5 2013,2
Texas Rangers,0,LA Angels of Anaheim,11,8,August 6 2013,3
Tampa Bay Rays,1,Arizona D'Backs,7,1,August 6 2013,6
New York Yankees,1,Chicago White Sox,5,2,August 6 2013,3
Oakland Athletics,1,Cincinnati Reds,4,1,August 6 2013,3
Detroit Tigers,0,Cleveland Indians,6,5,August 6 2013,1
Boston Red Sox,0,Houston Astros,25,15,August 6 2013,10
Minnesota Twins,0,Kansas City Royals,7,7,August 6 2013,0
Colorado Rockies,1,New York Mets,5,2,August 6 2013,3
Chicago Cubs,1,Philadelphia Phillies,17,8,August 6 2013,9
Miami Marlins,1,Pittsburgh Pirates,7,3,August 6 2013,4
Baltimore Orioles,0,San Diego Padres,5,4,August 6 2013,1
Toronto Blue Jays,0,Seattle Mariners,9,7,August 6 2013,2
Milwaukee Brewers,0,San Francisco Giants,4,3,August 6 2013,1
Los Angeles Dodgers,1,St. Louis Cardinals,6,1,August 6 2013,5
Atlanta Braves,0,Washington Nationals,3,2,August 6 2013,1
Texas Rangers,0,LA Angels of Anaheim,13,10,August 7 2013,3
Tampa Bay Rays,1,Arizona D'Backs,17,8,August 7 2013,9
New York Yankees,1,Chicago White Sox,11,5,August 7 2013,6
Oakland Athletics,1,Cincinnati Reds,11,5,August 7 2013,6
Detroit Tigers,0,Cleveland Indians,11,6,August 7 2013,5
Boston Red Sox,0,Houston Astros,12,7,August 7 2013,5
Minnesota Twins,1,Kansas City Royals,7,2,August 7 2013,5
Colorado Rockies,1,New York Mets,5,0,August 7 2013,5
Chicago Cubs,0,Philadelphia Phillies,7,5,August 7 2013,2
Miami Marlins,1,Pittsburgh Pirates,6,2,August 7 2013,4
Baltimore Orioles,0,San Diego Padres,13,10,August 7 2013,3
Toronto Blue Jays,1,Seattle Mariners,16,7,August 7 2013,9
Milwaukee Brewers,0,San Francisco Giants,7,6,August 7 2013,1
Los Angeles Dodgers,0,St. Louis Cardinals,17,13,August 7 2013,4
Atlanta Braves,0,Washington Nationals,9,6,August 7 2013,3
Detroit Tigers,0,Cleveland Indians,13,10,August 8 2013,3
Boston Red Sox,1,Kansas City Royals,6,1,August 8 2013,5
Colorado Rockies,1,New York Mets,3,1,August 8 2013,2
Chicago Cubs,1,Philadelphia Phillies,13,1,August 8 2013,12
Miami Marlins,1,Pittsburgh Pirates,9,4,August 8 2013,5
Milwaukee Brewers,1,San Francisco Giants,5,1,August 8 2013,4
Los Angeles Dodgers,0,St. Louis Cardinals,6,5,August 8 2013,1
New York Mets,1,Arizona D'Backs,9,4,August 9 2013,5
Miami Marlins,1,Atlanta Braves,5,0,August 9 2013,5
Minnesota Twins,0,Chicago White Sox,12,7,August 9 2013,5
Minnesota Twins,0,Chicago White Sox,5,3,August 9 2013,2
San Diego Padres,1,Cincinnati Reds,9,2,August 9 2013,7
LA Angels of Anaheim,0,Cleveland Indians,7,5,August 9 2013,2
Pittsburgh Pirates,1,Colorado Rockies,11,1,August 9 2013,10
Texas Rangers,0,Houston Astros,14,9,August 9 2013,5
Boston Red Sox,1,Kansas City Royals,15,6,August 9 2013,9
Tampa Bay Rays,1,Los Angeles Dodgers,13,6,August 9 2013,7
Detroit Tigers,1,New York Yankees,7,3,August 9 2013,4
Milwaukee Brewers,0,Seattle Mariners,15,10,August 9 2013,5
Baltimore Orioles,0,San Francisco Giants,7,5,August 9 2013,2
Chicago Cubs,0,St. Louis Cardinals,3,3,August 9 2013,0
Oakland Athletics,0,Toronto Blue Jays,20,14,August 9 2013,6
Philadelphia Phillies,1,Washington Nationals,11,2,August 9 2013,9
New York Mets,0,Arizona D'Backs,5,4,August 10 2013,1
Miami Marlins,0,Atlanta Braves,1,1,August 10 2013,0
Minnesota Twins,1,Chicago White Sox,9,4,August 10 2013,5
San Diego Padres,0,Cincinnati Reds,4,3,August 10 2013,1
LA Angels of Anaheim,0,Cleveland Indians,9,7,August 10 2013,2
Pittsburgh Pirates,1,Colorado Rockies,10,4,August 10 2013,6
Texas Rangers,0,Houston Astros,9,5,August 10 2013,4
Boston Red Sox,0,Kansas City Royals,8,5,August 10 2013,3
Tampa Bay Rays,1,Los Angeles Dodgers,5,0,August 10 2013,5
Detroit Tigers,0,New York Yankees,12,9,August 10 2013,3
Milwaukee Brewers,0,Seattle Mariners,10,10,August 10 2013,0
Baltimore Orioles,1,San Francisco Giants,5,2,August 10 2013,3
Chicago Cubs,0,St. Louis Cardinals,11,6,August 10 2013,5
Oakland Athletics,1,Toronto Blue Jays,9,4,August 10 2013,5
Philadelphia Phillies,1,Washington Nationals,13,5,August 10 2013,8
New York Mets,0,Arizona D'Backs,14,9,August 11 2013,5
Miami Marlins,1,Atlanta Braves,13,4,August 11 2013,9
Minnesota Twins,0,Chicago White Sox,7,5,August 11 2013,2
San Diego Padres,1,Cincinnati Reds,5,2,August 11 2013,3
LA Angels of Anaheim,1,Cleveland Indians,11,5,August 11 2013,6
Pittsburgh Pirates,1,Colorado Rockies,5,2,August 11 2013,3
Texas Rangers,0,Houston Astros,7,6,August 11 2013,1
Boston Red Sox,1,Kansas City Royals,7,3,August 11 2013,4
Tampa Bay Rays,1,Los Angeles Dodgers,10,2,August 11 2013,8
Detroit Tigers,1,New York Yankees,9,4,August 11 2013,5
Milwaukee Brewers,1,Seattle Mariners,2,0,August 11 2013,2
Baltimore Orioles,0,San Francisco Giants,12,10,August 11 2013,2
Chicago Cubs,1,St. Louis Cardinals,12,4,August 11 2013,8
Oakland Athletics,0,Toronto Blue Jays,10,6,August 11 2013,4
Philadelphia Phillies,1,Washington Nationals,6,0,August 11 2013,6
Baltimore Orioles,1,Arizona D'Backs,13,6,August 12 2013,7
Philadelphia Phillies,0,Atlanta Braves,6,5,August 12 2013,1
Detroit Tigers,1,Chicago White Sox,8,2,August 12 2013,6
Cincinnati Reds,0,Chicago Cubs,2,2,August 12 2013,0
San Diego Padres,1,Colorado Rockies,16,2,August 12 2013,14
Texas Rangers,0,Houston Astros,3,2,August 12 2013,1
Miami Marlins,1,Kansas City Royals,8,2,August 12 2013,6
New York Mets,1,Los Angeles Dodgers,6,2,August 12 2013,4
Cleveland Indians,1,Minnesota Twins,3,0,August 12 2013,3
LA Angels of Anaheim,1,New York Yankees,3,1,August 12 2013,2
Oakland Athletics,0,Toronto Blue Jays,6,5,August 12 2013,1
Baltimore Orioles,1,Arizona D'Backs,7,3,August 13 2013,4
Philadelphia Phillies,1,Atlanta Braves,4,1,August 13 2013,3
Detroit Tigers,1,Chicago White Sox,7,3,August 13 2013,4
Cincinnati Reds,0,Chicago Cubs,10,6,August 13 2013,4
San Diego Padres,0,Colorado Rockies,12,7,August 13 2013,5
Miami Marlins,0,Kansas City Royals,1,1,August 13 2013,0
New York Mets,1,Los Angeles Dodgers,6,2,August 13 2013,4
Cleveland Indians,0,Minnesota Twins,7,5,August 13 2013,2
LA Angels of Anaheim,1,New York Yankees,21,7,August 13 2013,14
Houston Astros,0,Oakland Athletics,9,5,August 13 2013,4
Pittsburgh Pirates,1,St. Louis Cardinals,7,3,August 13 2013,4
Seattle Mariners,0,Tampa Bay Rays,9,5,August 13 2013,4
Milwaukee Brewers,0,Texas Rangers,6,5,August 13 2013,1
Boston Red Sox,0,Toronto Blue Jays,6,4,August 13 2013,2
San Francisco Giants,1,Washington Nationals,6,2,August 13 2013,4
Baltimore Orioles,1,Arizona D'Backs,9,4,August 14 2013,5
Philadelphia Phillies,1,Atlanta Braves,9,3,August 14 2013,6
Detroit Tigers,0,Chicago White Sox,10,6,August 14 2013,4
Cincinnati Reds,0,Chicago Cubs,5,5,August 14 2013,0
San Diego Padres,1,Colorado Rockies,6,2,August 14 2013,4
Miami Marlins,0,Kansas City Royals,7,5,August 14 2013,2
New York Mets,1,Los Angeles Dodgers,9,4,August 14 2013,5
Cleveland Indians,0,Minnesota Twins,17,9,August 14 2013,8
LA Angels of Anaheim,1,New York Yankees,14,3,August 14 2013,11
Houston Astros,0,Oakland Athletics,3,2,August 14 2013,1
Pittsburgh Pirates,0,St. Louis Cardinals,6,5,August 14 2013,1
Seattle Mariners,1,Tampa Bay Rays,9,4,August 14 2013,5
Milwaukee Brewers,1,Texas Rangers,9,4,August 14 2013,5
Boston Red Sox,1,Toronto Blue Jays,7,3,August 14 2013,4
San Francisco Giants,1,Washington Nationals,11,5,August 14 2013,6
Kansas City Royals,1,Detroit Tigers,5,1,August 15 2013,4
Cincinnati Reds,0,Milwaukee Brewers,3,2,August 15 2013,1
Chicago White Sox,1,Minnesota Twins,7,3,August 15 2013,4
LA Angels of Anaheim,0,New York Yankees,12,8,August 15 2013,4
Houston Astros,1,Oakland Athletics,5,0,August 15 2013,5
New York Mets,0,San Diego Padres,5,4,August 15 2013,1
Pittsburgh Pirates,1,St. Louis Cardinals,11,5,August 15 2013,6
Seattle Mariners,1,Tampa Bay Rays,8,1,August 15 2013,7
Boston Red Sox,1,Toronto Blue Jays,3,1,August 15 2013,2
San Francisco Giants,0,Washington Nationals,7,4,August 15 2013,3
Houston Astros,0,LA Angels of Anaheim,10,8,August 16 2013,2
Washington Nationals,1,Atlanta Braves,5,2,August 16 2013,3
Colorado Rockies,0,Baltimore Orioles,9,6,August 16 2013,3
New York Yankees,0,Boston Red Sox,13,10,August 16 2013,3
St. Louis Cardinals,1,Chicago Cubs,7,0,August 16 2013,7
Kansas City Royals,0,Detroit Tigers,3,2,August 16 2013,1
Kansas City Royals,0,Detroit Tigers,3,3,August 16 2013,0
San Francisco Giants,0,Miami Marlins,24,14,August 16 2013,10
Cincinnati Reds,1,Milwaukee Brewers,13,6,August 16 2013,7
Chicago White Sox,0,Minnesota Twins,7,5,August 16 2013,2
Cleveland Indians,1,Oakland Athletics,5,2,August 16 2013,3
Los Angeles Dodgers,0,Philadelphia Phillies,4,4,August 16 2013,0
Arizona D'Backs,1,Pittsburgh Pirates,8,2,August 16 2013,6
New York Mets,0,San Diego Padres,7,5,August 16 2013,2
Toronto Blue Jays,1,Tampa Bay Rays,9,4,August 16 2013,5
Seattle Mariners,0,Texas Rangers,4,3,August 16 2013,1
Houston Astros,1,LA Angels of Anaheim,11,5,August 17 2013,6
Washington Nationals,0,Atlanta Braves,15,8,August 17 2013,7
Colorado Rockies,1,Baltimore Orioles,12,4,August 17 2013,8
New York Yankees,1,Boston Red Sox,7,1,August 17 2013,6
St. Louis Cardinals,0,Chicago Cubs,4,4,August 17 2013,0
Kansas City Royals,1,Detroit Tigers,11,5,August 17 2013,6
San Francisco Giants,0,Miami Marlins,10,6,August 17 2013,4
Cincinnati Reds,1,Milwaukee Brewers,2,0,August 17 2013,2
Chicago White Sox,0,Minnesota Twins,13,8,August 17 2013,5
Cleveland Indians,0,Oakland Athletics,8,7,August 17 2013,1
Los Angeles Dodgers,0,Philadelphia Phillies,5,5,August 17 2013,0
Arizona D'Backs,0,Pittsburgh Pirates,20,15,August 17 2013,5
New York Mets,1,San Diego Padres,10,2,August 17 2013,8
Toronto Blue Jays,0,Tampa Bay Rays,8,6,August 17 2013,2
Seattle Mariners,1,Texas Rangers,18,3,August 17 2013,15
Houston Astros,0,LA Angels of Anaheim,12,7,August 18 2013,5
Washington Nationals,1,Atlanta Braves,3,1,August 18 2013,2
Colorado Rockies,1,Baltimore Orioles,9,2,August 18 2013,7
New York Yankees,0,Boston Red Sox,15,9,August 18 2013,6
St. Louis Cardinals,0,Chicago Cubs,7,6,August 18 2013,1
Kansas City Royals,1,Detroit Tigers,9,3,August 18 2013,6
San Francisco Giants,1,Miami Marlins,11,5,August 18 2013,6
Cincinnati Reds,0,Milwaukee Brewers,10,9,August 18 2013,1
Chicago White Sox,0,Minnesota Twins,7,5,August 18 2013,2
Cleveland Indians,1,Oakland Athletics,10,3,August 18 2013,7
Los Angeles Dodgers,1,Philadelphia Phillies,5,2,August 18 2013,3
Arizona D'Backs,0,Pittsburgh Pirates,6,4,August 18 2013,2
New York Mets,1,San Diego Padres,7,3,August 18 2013,4
Toronto Blue Jays,1,Tampa Bay Rays,3,1,August 18 2013,2
Seattle Mariners,0,Texas Rangers,7,4,August 18 2013,3
Cleveland Indians,0,LA Angels of Anaheim,7,5,August 19 2013,2
Tampa Bay Rays,0,Baltimore Orioles,7,4,August 19 2013,3
Washington Nationals,1,Chicago Cubs,12,1,August 19 2013,11
Arizona D'Backs,1,Cincinnati Reds,8,3,August 19 2013,5
Los Angeles Dodgers,1,Miami Marlins,8,2,August 19 2013,6
St. Louis Cardinals,0,Milwaukee Brewers,13,8,August 19 2013,5
New York Mets,0,Minnesota Twins,7,6,August 19 2013,1
Seattle Mariners,1,Oakland Athletics,3,1,August 19 2013,2
Colorado Rockies,1,Philadelphia Phillies,9,4,August 19 2013,5
Pittsburgh Pirates,0,San Diego Padres,4,3,August 19 2013,1
Boston Red Sox,0,San Francisco Giants,7,7,August 19 2013,0
Houston Astros,1,Texas Rangers,21,5,August 19 2013,16
Cleveland Indians,0,LA Angels of Anaheim,5,4,August 20 2013,1
Tampa Bay Rays,0,Baltimore Orioles,11,7,August 20 2013,4
Washington Nationals,0,Chicago Cubs,6,4,August 20 2013,2
Arizona D'Backs,0,Cincinnati Reds,7,5,August 20 2013,2
Minnesota Twins,0,Detroit Tigers,9,6,August 20 2013,3
Chicago White Sox,0,Kansas City Royals,2,2,August 20 2013,0
Los Angeles Dodgers,0,Miami Marlins,10,6,August 20 2013,4
St. Louis Cardinals,1,Milwaukee Brewers,9,3,August 20 2013,6
Toronto Blue Jays,1,New York Yankees,12,4,August 20 2013,8
Toronto Blue Jays,1,New York Yankees,5,2,August 20 2013,3
Atlanta Braves,1,New York Mets,8,3,August 20 2013,5
Seattle Mariners,0,Oakland Athletics,11,7,August 20 2013,4
Colorado Rockies,0,Philadelphia Phillies,8,5,August 20 2013,3
Pittsburgh Pirates,0,San Diego Padres,9,8,August 20 2013,1
Boston Red Sox,1,San Francisco Giants,5,2,August 20 2013,3
Houston Astros,1,Texas Rangers,6,2,August 20 2013,4
Cleveland Indians,0,LA Angels of Anaheim,4,3,August 21 2013,1
Tampa Bay Rays,1,Baltimore Orioles,6,2,August 21 2013,4
Washington Nationals,0,Chicago Cubs,17,11,August 21 2013,6
Arizona D'Backs,1,Cincinnati Reds,17,7,August 21 2013,10
Minnesota Twins,1,Detroit Tigers,8,1,August 21 2013,7
Chicago White Sox,0,Kansas City Royals,7,5,August 21 2013,2
Los Angeles Dodgers,0,Miami Marlins,5,4,August 21 2013,1
St. Louis Cardinals,0,Milwaukee Brewers,14,8,August 21 2013,6
Toronto Blue Jays,1,New York Yankees,6,2,August 21 2013,4
Atlanta Braves,0,New York Mets,5,4,August 21 2013,1
Seattle Mariners,0,Oakland Athletics,8,5,August 21 2013,3
Colorado Rockies,1,Philadelphia Phillies,7,3,August 21 2013,4
Pittsburgh Pirates,1,San Diego Padres,3,1,August 21 2013,2
Boston Red Sox,0,San Francisco Giants,13,12,August 21 2013,1
Houston Astros,1,Texas Rangers,9,4,August 21 2013,5
Washington Nationals,0,Chicago Cubs,9,5,August 22 2013,4
Arizona D'Backs,1,Cincinnati Reds,3,1,August 22 2013,2
Minnesota Twins,0,Detroit Tigers,13,7,August 22 2013,6
Chicago White Sox,0,Kansas City Royals,7,4,August 22 2013,3
Los Angeles Dodgers,0,Miami Marlins,6,6,August 22 2013,0
Toronto Blue Jays,1,New York Yankees,8,3,August 22 2013,5
Colorado Rockies,1,Philadelphia Phillies,9,4,August 22 2013,5
Pittsburgh Pirates,0,San Francisco Giants,15,10,August 22 2013,5
Atlanta Braves,1,St. Louis Cardinals,8,2,August 22 2013,6
Oakland Athletics,1,Baltimore Orioles,16,7,August 23 2013,9
Texas Rangers,0,Chicago White Sox,16,11,August 23 2013,5
Milwaukee Brewers,0,Cincinnati Reds,10,6,August 23 2013,4
Minnesota Twins,0,Cleveland Indians,6,5,August 23 2013,1
Toronto Blue Jays,1,Houston Astros,16,4,August 23 2013,12
Washington Nationals,0,Kansas City Royals,21,11,August 23 2013,10
Boston Red Sox,1,Los Angeles Dodgers,2,0,August 23 2013,2
Colorado Rockies,0,Miami Marlins,5,3,August 23 2013,2
Detroit Tigers,0,New York Mets,7,6,August 23 2013,1
Arizona D'Backs,1,Philadelphia Phillies,7,3,August 23 2013,4
Chicago Cubs,1,San Diego Padres,14,6,August 23 2013,8
LA Angels of Anaheim,0,Seattle Mariners,2,2,August 23 2013,0
Pittsburgh Pirates,0,San Francisco Giants,4,3,August 23 2013,1
Atlanta Braves,1,St. Louis Cardinals,4,1,August 23 2013,3
New York Yankees,1,Tampa Bay Rays,9,2,August 23 2013,7
Oakland Athletics,0,Baltimore Orioles,3,2,August 24 2013,1
Texas Rangers,1,Chicago White Sox,5,2,August 24 2013,3
Milwaukee Brewers,1,Cincinnati Reds,9,3,August 24 2013,6
Minnesota Twins,1,Cleveland Indians,9,2,August 24 2013,7
Toronto Blue Jays,1,Houston Astros,13,5,August 24 2013,8
Washington Nationals,0,Kansas City Royals,9,7,August 24 2013,2
Boston Red Sox,0,Los Angeles Dodgers,6,4,August 24 2013,2
Colorado Rockies,1,Miami Marlins,3,0,August 24 2013,3
Detroit Tigers,0,New York Mets,3,3,August 24 2013,0
Arizona D'Backs,0,Philadelphia Phillies,19,12,August 24 2013,7
Chicago Cubs,0,San Diego Padres,5,3,August 24 2013,2
LA Angels of Anaheim,0,Seattle Mariners,6,5,August 24 2013,1
Pittsburgh Pirates,1,San Francisco Giants,9,3,August 24 2013,6
Atlanta Braves,1,St. Louis Cardinals,8,2,August 24 2013,6
New York Yankees,1,Tampa Bay Rays,6,2,August 24 2013,4
Oakland Athletics,1,Baltimore Orioles,13,3,August 25 2013,10
Texas Rangers,1,Chicago White Sox,7,2,August 25 2013,5
Milwaukee Brewers,0,Cincinnati Reds,4,3,August 25 2013,1
Minnesota Twins,1,Cleveland Indians,4,1,August 25 2013,3
Toronto Blue Jays,0,Houston Astros,3,2,August 25 2013,1
Washington Nationals,1,Kansas City Royals,10,4,August 25 2013,6
Boston Red Sox,0,Los Angeles Dodgers,9,8,August 25 2013,1
Colorado Rockies,0,Miami Marlins,7,4,August 25 2013,3
Detroit Tigers,0,New York Mets,14,11,August 25 2013,3
Arizona D'Backs,1,Philadelphia Phillies,14,5,August 25 2013,9
Chicago Cubs,1,San Diego Padres,5,2,August 25 2013,3
LA Angels of Anaheim,0,Seattle Mariners,8,7,August 25 2013,1
Pittsburgh Pirates,1,San Francisco Giants,4,0,August 25 2013,4
Atlanta Braves,0,St. Louis Cardinals,7,5,August 25 2013,2
New York Yankees,0,Tampa Bay Rays,5,3,August 25 2013,2
San Diego Padres,1,Arizona D'Backs,7,1,August 26 2013,6
Houston Astros,0,Chicago White Sox,18,10,August 26 2013,8
San Francisco Giants,1,Colorado Rockies,7,1,August 26 2013,6
Oakland Athletics,0,Detroit Tigers,14,8,August 26 2013,6
Tampa Bay Rays,1,Kansas City Royals,12,1,August 26 2013,11
Chicago Cubs,1,Los Angeles Dodgers,8,2,August 26 2013,6
Philadelphia Phillies,0,New York Mets,3,2,August 26 2013,1
Texas Rangers,0,Seattle Mariners,11,8,August 26 2013,3
Cincinnati Reds,1,St. Louis Cardinals,14,6,August 26 2013,8
New York Yankees,1,Toronto Blue Jays,7,2,August 26 2013,5
San Diego Padres,1,Arizona D'Backs,19,9,August 27 2013,10
Cleveland Indians,1,Atlanta Braves,2,0,August 27 2013,2
Baltimore Orioles,1,Boston Red Sox,15,2,August 27 2013,13
Houston Astros,1,Chicago White Sox,7,3,August 27 2013,4
San Francisco Giants,0,Colorado Rockies,8,5,August 27 2013,3
Oakland Athletics,0,Detroit Tigers,9,6,August 27 2013,3
Chicago Cubs,0,Los Angeles Dodgers,5,3,August 27 2013,2
Kansas City Royals,0,Minnesota Twins,7,6,August 27 2013,1
Philadelphia Phillies,1,New York Mets,5,0,August 27 2013,5
Milwaukee Brewers,0,Pittsburgh Pirates,13,7,August 27 2013,6
Texas Rangers,0,Seattle Mariners,7,4,August 27 2013,3
Cincinnati Reds,1,St. Louis Cardinals,7,1,August 27 2013,6
LA Angels of Anaheim,0,Tampa Bay Rays,11,6,August 27 2013,5
New York Yankees,0,Toronto Blue Jays,8,7,August 27 2013,1
Miami Marlins,1,Washington Nationals,3,1,August 27 2013,2
San Diego Padres,0,Arizona D'Backs,6,5,August 28 2013,1
Cleveland Indians,1,Atlanta Braves,5,2,August 28 2013,3
Baltimore Orioles,1,Boston Red Sox,7,3,August 28 2013,4
Houston Astros,1,Chicago White Sox,7,1,August 28 2013,6
San Francisco Giants,1,Colorado Rockies,9,4,August 28 2013,5
Oakland Athletics,0,Detroit Tigers,18,14,August 28 2013,4
Chicago Cubs,1,Los Angeles Dodgers,4,0,August 28 2013,4
Kansas City Royals,0,Minnesota Twins,9,8,August 28 2013,1
Philadelphia Phillies,0,New York Mets,8,6,August 28 2013,2
Milwaukee Brewers,1,Pittsburgh Pirates,8,1,August 28 2013,7
Texas Rangers,0,Seattle Mariners,16,12,August 28 2013,4
Cincinnati Reds,0,St. Louis Cardinals,10,10,August 28 2013,0
LA Angels of Anaheim,1,Tampa Bay Rays,5,1,August 28 2013,4
New York Yankees,1,Toronto Blue Jays,9,2,August 28 2013,7
Miami Marlins,1,Washington Nationals,7,3,August 28 2013,4
Cleveland Indians,1,Atlanta Braves,4,1,August 29 2013,3
Baltimore Orioles,0,Boston Red Sox,5,3,August 29 2013,2
Oakland Athletics,1,Detroit Tigers,13,6,August 29 2013,7
Seattle Mariners,0,Houston Astros,5,3,August 29 2013,2
Kansas City Royals,0,Minnesota Twins,4,3,August 29 2013,1
Philadelphia Phillies,1,New York Mets,14,3,August 29 2013,11
Milwaukee Brewers,0,Pittsburgh Pirates,4,4,August 29 2013,0
LA Angels of Anaheim,0,Tampa Bay Rays,2,2,August 29 2013,0
Miami Marlins,1,Washington Nationals,9,0,August 29 2013,9
San Francisco Giants,0,Arizona D'Backs,1,1,August 30 2013,0
Miami Marlins,1,Atlanta Braves,3,1,August 30 2013,2
Chicago White Sox,1,Boston Red Sox,7,3,August 30 2013,4
Philadelphia Phillies,0,Chicago Cubs,11,6,August 30 2013,5
Cincinnati Reds,1,Colorado Rockies,15,6,August 30 2013,9
Cleveland Indians,1,Detroit Tigers,9,2,August 30 2013,7
Seattle Mariners,0,Houston Astros,8,7,August 30 2013,1
San Diego Padres,1,Los Angeles Dodgers,11,2,August 30 2013,9
LA Angels of Anaheim,0,Milwaukee Brewers,5,5,August 30 2013,0
Baltimore Orioles,1,New York Yankees,13,5,August 30 2013,8
Tampa Bay Rays,1,Oakland Athletics,7,3,August 30 2013,4
St. Louis Cardinals,1,Pittsburgh Pirates,5,0,August 30 2013,5
Minnesota Twins,0,Texas Rangers,5,3,August 30 2013,2
Kansas City Royals,1,Toronto Blue Jays,5,2,August 30 2013,3
New York Mets,0,Washington Nationals,5,3,August 30 2013,2
San Francisco Giants,1,Arizona D'Backs,7,3,August 31 2013,4
Miami Marlins,1,Atlanta Braves,9,4,August 31 2013,5
Chicago White Sox,1,Boston Red Sox,9,2,August 31 2013,7
Philadelphia Phillies,1,Chicago Cubs,7,3,August 31 2013,4
Cincinnati Reds,0,Colorado Rockies,11,8,August 31 2013,3
Cleveland Indians,1,Detroit Tigers,15,5,August 31 2013,10
Seattle Mariners,0,Houston Astros,4,3,August 31 2013,1
San Diego Padres,1,Los Angeles Dodgers,3,1,August 31 2013,2
LA Angels of Anaheim,0,Milwaukee Brewers,11,6,August 31 2013,5
Baltimore Orioles,1,New York Yankees,2,0,August 31 2013,2
Tampa Bay Rays,1,Oakland Athletics,3,1,August 31 2013,2
St. Louis Cardinals,1,Pittsburgh Pirates,8,1,August 31 2013,7
Minnesota Twins,1,Texas Rangers,3,1,August 31 2013,2
Kansas City Royals,1,Toronto Blue Jays,6,2,August 31 2013,4
New York Mets,0,Washington Nationals,14,11,August 31 2013,3
San Francisco Giants,0,Arizona D'Backs,10,8,September 1 2013,2
Miami Marlins,0,Atlanta Braves,7,7,September 1 2013,0
Chicago White Sox,1,Boston Red Sox,13,6,September 1 2013,7
Philadelphia Phillies,1,Chicago Cubs,8,1,September 1 2013,7
Cincinnati Reds,1,Colorado Rockies,11,4,September 1 2013,7
Cleveland Indians,0,Detroit Tigers,4,4,September 1 2013,0
Seattle Mariners,1,Houston Astros,2,0,September 1 2013,2
San Diego Padres,1,Los Angeles Dodgers,3,1,September 1 2013,2
LA Angels of Anaheim,0,Milwaukee Brewers,8,5,September 1 2013,3
Baltimore Orioles,0,New York Yankees,10,7,September 1 2013,3
Tampa Bay Rays,1,Oakland Athletics,6,1,September 1 2013,5
St. Louis Cardinals,0,Pittsburgh Pirates,9,7,September 1 2013,2
Minnesota Twins,0,Texas Rangers,6,4,September 1 2013,2
Kansas City Royals,0,Toronto Blue Jays,5,5,September 1 2013,0
New York Mets,1,Washington Nationals,11,5,September 1 2013,6
Tampa Bay Rays,1,LA Angels of Anaheim,13,2,September 2 2013,11
Toronto Blue Jays,0,Arizona D'Backs,5,4,September 2 2013,1
New York Mets,1,Atlanta Braves,18,5,September 2 2013,13
Detroit Tigers,0,Boston Red Sox,3,3,September 2 2013,0
Miami Marlins,0,Chicago Cubs,7,4,September 2 2013,3
St. Louis Cardinals,1,Cincinnati Reds,9,2,September 2 2013,7
Baltimore Orioles,0,Cleveland Indians,9,7,September 2 2013,2
Los Angeles Dodgers,0,Colorado Rockies,18,10,September 2 2013,8
Minnesota Twins,0,Houston Astros,16,10,September 2 2013,6
Seattle Mariners,1,Kansas City Royals,4,1,September 2 2013,3
Pittsburgh Pirates,0,Milwaukee Brewers,7,5,September 2 2013,2
Chicago White Sox,1,New York Yankees,10,1,September 2 2013,9
Texas Rangers,1,Oakland Athletics,6,2,September 2 2013,4
Washington Nationals,1,Philadelphia Phillies,5,2,September 2 2013,3
San Francisco Giants,1,San Diego Padres,5,1,September 2 2013,4
Tampa Bay Rays,0,LA Angels of Anaheim,8,7,September 3 2013,1
Toronto Blue Jays,0,Arizona D'Backs,14,10,September 3 2013,4
New York Mets,1,Atlanta Braves,4,1,September 3 2013,3
Detroit Tigers,1,Boston Red Sox,3,1,September 3 2013,2
Miami Marlins,0,Chicago Cubs,8,6,September 3 2013,2
St. Louis Cardinals,1,Cincinnati Reds,1,0,September 3 2013,1
Baltimore Orioles,1,Cleveland Indians,7,3,September 3 2013,4
Los Angeles Dodgers,0,Colorado Rockies,11,7,September 3 2013,4
Minnesota Twins,0,Houston Astros,15,9,September 3 2013,6
Seattle Mariners,1,Kansas City Royals,7,3,September 3 2013,4
Pittsburgh Pirates,0,Milwaukee Brewers,7,4,September 3 2013,3
Chicago White Sox,1,New York Yankees,10,4,September 3 2013,6
Texas Rangers,0,Oakland Athletics,6,5,September 3 2013,1
Washington Nationals,0,Philadelphia Phillies,15,9,September 3 2013,6
San Francisco Giants,1,San Diego Padres,5,2,September 3 2013,3
Tampa Bay Rays,0,LA Angels of Anaheim,4,3,September 4 2013,1
Toronto Blue Jays,1,Arizona D'Backs,7,3,September 4 2013,4
New York Mets,0,Atlanta Braves,7,5,September 4 2013,2
Detroit Tigers,1,Boston Red Sox,24,4,September 4 2013,20
Miami Marlins,1,Chicago Cubs,16,7,September 4 2013,9
St. Louis Cardinals,0,Cincinnati Reds,9,5,September 4 2013,4
Baltimore Orioles,1,Cleveland Indians,10,4,September 4 2013,6
Los Angeles Dodgers,1,Colorado Rockies,12,5,September 4 2013,7
Minnesota Twins,1,Houston Astros,11,5,September 4 2013,6
Seattle Mariners,0,Kansas City Royals,10,6,September 4 2013,4
Pittsburgh Pirates,1,Milwaukee Brewers,12,3,September 4 2013,9
Chicago White Sox,1,New York Yankees,11,5,September 4 2013,6
Texas Rangers,1,Oakland Athletics,15,4,September 4 2013,11
Washington Nationals,0,Philadelphia Phillies,5,3,September 4 2013,2
San Francisco Giants,0,San Diego Padres,18,13,September 4 2013,5
Tampa Bay Rays,1,LA Angels of Anaheim,8,2,September 5 2013,6
Chicago White Sox,1,Baltimore Orioles,4,1,September 5 2013,3
St. Louis Cardinals,1,Cincinnati Reds,8,2,September 5 2013,6
Seattle Mariners,1,Kansas City Royals,13,6,September 5 2013,7
Boston Red Sox,0,New York Yankees,17,9,September 5 2013,8
Houston Astros,0,Oakland Athletics,5,3,September 5 2013,2
Arizona D'Backs,0,San Francisco Giants,6,4,September 5 2013,2
Texas Rangers,1,LA Angels of Anaheim,11,5,September 6 2013,6
Chicago White Sox,1,Baltimore Orioles,4,0,September 6 2013,4
Milwaukee Brewers,1,Chicago Cubs,13,5,September 6 2013,8
Los Angeles Dodgers,1,Cincinnati Reds,5,2,September 6 2013,3
New York Mets,1,Cleveland Indians,9,1,September 6 2013,8
Detroit Tigers,0,Kansas City Royals,18,16,September 6 2013,2
Washington Nationals,1,Miami Marlins,7,0,September 6 2013,7
Toronto Blue Jays,0,Minnesota Twins,11,6,September 6 2013,5
Boston Red Sox,0,New York Yankees,20,12,September 6 2013,8
Houston Astros,1,Oakland Athletics,12,5,September 6 2013,7
Atlanta Braves,1,Philadelphia Phillies,3,1,September 6 2013,2
Colorado Rockies,1,San Diego Padres,7,3,September 6 2013,4
Tampa Bay Rays,1,Seattle Mariners,10,4,September 6 2013,6
Arizona D'Backs,1,San Francisco Giants,3,0,September 6 2013,3
Pittsburgh Pirates,1,St. Louis Cardinals,20,8,September 6 2013,12
Texas Rangers,1,LA Angels of Anaheim,11,3,September 7 2013,8
Chicago White Sox,1,Baltimore Orioles,7,3,September 7 2013,4
Milwaukee Brewers,0,Chicago Cubs,8,5,September 7 2013,3
Los Angeles Dodgers,1,Cincinnati Reds,7,3,September 7 2013,4
New York Mets,1,Cleveland Indians,13,4,September 7 2013,9
Detroit Tigers,1,Kansas City Royals,7,3,September 7 2013,4
Washington Nationals,0,Miami Marlins,11,9,September 7 2013,2
Toronto Blue Jays,0,Minnesota Twins,13,11,September 7 2013,2
Boston Red Sox,0,New York Yankees,22,13,September 7 2013,9
Houston Astros,1,Oakland Athletics,3,1,September 7 2013,2
Atlanta Braves,1,Philadelphia Phillies,11,5,September 7 2013,6
Colorado Rockies,1,San Diego Padres,3,1,September 7 2013,2
Tampa Bay Rays,1,Seattle Mariners,8,2,September 7 2013,6
Arizona D'Backs,0,San Francisco Giants,3,2,September 7 2013,1
Pittsburgh Pirates,1,St. Louis Cardinals,5,0,September 7 2013,5
Texas Rangers,0,LA Angels of Anaheim,7,4,September 8 2013,3
Chicago White Sox,0,Baltimore Orioles,6,4,September 8 2013,2
Milwaukee Brewers,0,Chicago Cubs,4,3,September 8 2013,1
Los Angeles Dodgers,1,Cincinnati Reds,5,2,September 8 2013,3
New York Mets,0,Cleveland Indians,3,2,September 8 2013,1
Detroit Tigers,1,Kansas City Royals,7,2,September 8 2013,5
Washington Nationals,0,Miami Marlins,10,6,September 8 2013,4
Toronto Blue Jays,0,Minnesota Twins,2,2,September 8 2013,0
Boston Red Sox,1,New York Yankees,7,3,September 8 2013,4
Houston Astros,1,Oakland Athletics,9,2,September 8 2013,7
Atlanta Braves,1,Philadelphia Phillies,5,2,September 8 2013,3
Colorado Rockies,1,San Diego Padres,7,2,September 8 2013,5
Tampa Bay Rays,0,Seattle Mariners,5,4,September 8 2013,1
Arizona D'Backs,1,San Francisco Giants,5,2,September 8 2013,3
Pittsburgh Pirates,1,St. Louis Cardinals,11,2,September 8 2013,9
New York Yankees,1,Baltimore Orioles,6,2,September 9 2013,4
Detroit Tigers,1,Chicago White Sox,6,1,September 9 2013,5
Chicago Cubs,0,Cincinnati Reds,2,2,September 9 2013,0
Kansas City Royals,1,Cleveland Indians,7,3,September 9 2013,4
Arizona D'Backs,1,Los Angeles Dodgers,9,1,September 9 2013,8
Atlanta Braves,0,Miami Marlins,7,5,September 9 2013,2
LA Angels of Anaheim,1,Minnesota Twins,9,3,September 9 2013,6
Washington Nationals,0,New York Mets,9,9,September 9 2013,0
Houston Astros,0,Seattle Mariners,10,6,September 9 2013,4
Colorado Rockies,1,San Francisco Giants,5,2,September 9 2013,3
Pittsburgh Pirates,0,Texas Rangers,1,1,September 9 2013,0
New York Yankees,0,Baltimore Orioles,12,7,September 10 2013,5
Detroit Tigers,0,Chicago White Sox,10,9,September 10 2013,1
Chicago Cubs,0,Cincinnati Reds,10,9,September 10 2013,1
Kansas City Royals,0,Cleveland Indians,9,6,September 10 2013,3
Arizona D'Backs,1,Los Angeles Dodgers,8,3,September 10 2013,5
Atlanta Braves,0,Miami Marlins,7,4,September 10 2013,3
Oakland Athletics,1,Minnesota Twins,7,3,September 10 2013,4
Washington Nationals,0,New York Mets,9,6,September 10 2013,3
San Diego Padres,0,Philadelphia Phillies,10,8,September 10 2013,2
Houston Astros,0,Seattle Mariners,15,13,September 10 2013,2
Colorado Rockies,0,San Francisco Giants,17,9,September 10 2013,8
Milwaukee Brewers,1,St. Louis Cardinals,6,2,September 10 2013,4
Boston Red Sox,0,Tampa Bay Rays,2,2,September 10 2013,0
Pittsburgh Pirates,0,Texas Rangers,9,5,September 10 2013,4
LA Angels of Anaheim,0,Toronto Blue Jays,18,12,September 10 2013,6
New York Yankees,0,Baltimore Orioles,9,5,September 11 2013,4
Detroit Tigers,0,Chicago White Sox,1,1,September 11 2013,0
Chicago Cubs,1,Cincinnati Reds,6,0,September 11 2013,6
Kansas City Royals,0,Cleveland Indians,8,6,September 11 2013,2
Arizona D'Backs,0,Los Angeles Dodgers,5,4,September 11 2013,1
Atlanta Braves,1,Miami Marlins,7,2,September 11 2013,5
Oakland Athletics,0,Minnesota Twins,21,18,September 11 2013,3
Washington Nationals,0,New York Mets,3,3,September 11 2013,0
San Diego Padres,1,Philadelphia Phillies,6,2,September 11 2013,4
Houston Astros,0,Seattle Mariners,7,6,September 11 2013,1
Colorado Rockies,1,San Francisco Giants,7,3,September 11 2013,4
Milwaukee Brewers,1,St. Louis Cardinals,6,1,September 11 2013,5
Boston Red Sox,0,Tampa Bay Rays,10,7,September 11 2013,3
Pittsburgh Pirates,0,Texas Rangers,12,7,September 11 2013,5
LA Angels of Anaheim,0,Toronto Blue Jays,9,5,September 11 2013,4
New York Yankees,0,Baltimore Orioles,11,6,September 12 2013,5
Cleveland Indians,0,Chicago White Sox,17,14,September 12 2013,3
San Francisco Giants,1,Los Angeles Dodgers,5,2,September 12 2013,3
Atlanta Braves,0,Miami Marlins,7,6,September 12 2013,1
Oakland Athletics,0,Minnesota Twins,10,8,September 12 2013,2
Washington Nationals,0,New York Mets,9,7,September 12 2013,2
San Diego Padres,1,Philadelphia Phillies,15,5,September 12 2013,10
Chicago Cubs,1,Pittsburgh Pirates,4,1,September 12 2013,3
Milwaukee Brewers,0,St. Louis Cardinals,8,5,September 12 2013,3
Boston Red Sox,1,Tampa Bay Rays,7,3,September 12 2013,4
LA Angels of Anaheim,0,Toronto Blue Jays,7,4,September 12 2013,3
Colorado Rockies,0,Arizona D'Backs,12,7,September 13 2013,5
San Diego Padres,0,Atlanta Braves,7,4,September 13 2013,3
New York Yankees,1,Boston Red Sox,12,4,September 13 2013,8
Cleveland Indians,0,Chicago White Sox,4,3,September 13 2013,1
Kansas City Royals,1,Detroit Tigers,9,3,September 13 2013,6
LA Angels of Anaheim,1,Houston Astros,16,7,September 13 2013,9
San Francisco Giants,0,Los Angeles Dodgers,6,4,September 13 2013,2
Cincinnati Reds,1,Milwaukee Brewers,6,1,September 13 2013,5
Tampa Bay Rays,0,Minnesota Twins,3,3,September 13 2013,0
Miami Marlins,1,New York Mets,7,3,September 13 2013,4
Chicago Cubs,0,Pittsburgh Pirates,9,5,September 13 2013,4
Seattle Mariners,1,St. Louis Cardinals,3,1,September 13 2013,2
Oakland Athletics,0,Texas Rangers,17,9,September 13 2013,8
Baltimore Orioles,0,Toronto Blue Jays,8,5,September 13 2013,3
Philadelphia Phillies,1,Washington Nationals,7,1,September 13 2013,6
Colorado Rockies,1,Arizona D'Backs,11,2,September 14 2013,9
San Diego Padres,1,Atlanta Braves,3,1,September 14 2013,2
New York Yankees,1,Boston Red Sox,6,1,September 14 2013,5
Cleveland Indians,0,Chicago White Sox,9,8,September 14 2013,1
Kansas City Royals,0,Detroit Tigers,1,1,September 14 2013,0
LA Angels of Anaheim,0,Houston Astros,8,6,September 14 2013,2
San Francisco Giants,0,Los Angeles Dodgers,22,19,September 14 2013,3
Cincinnati Reds,0,Milwaukee Brewers,10,7,September 14 2013,3
Tampa Bay Rays,0,Minnesota Twins,7,7,September 14 2013,0
Miami Marlins,0,New York Mets,3,3,September 14 2013,0
Miami Marlins,1,New York Mets,4,1,September 14 2013,3
Chicago Cubs,1,Pittsburgh Pirates,3,1,September 14 2013,2
Seattle Mariners,0,St. Louis Cardinals,5,4,September 14 2013,1
Oakland Athletics,0,Texas Rangers,1,1,September 14 2013,0
Baltimore Orioles,1,Toronto Blue Jays,7,3,September 14 2013,4
Philadelphia Phillies,0,Washington Nationals,9,5,September 14 2013,4
Colorado Rockies,1,Arizona D'Backs,10,2,September 15 2013,8
San Diego Padres,0,Atlanta Braves,4,4,September 15 2013,0
New York Yankees,1,Boston Red Sox,11,2,September 15 2013,9
Cleveland Indians,0,Chicago White Sox,8,7,September 15 2013,1
Kansas City Royals,1,Detroit Tigers,5,2,September 15 2013,3
LA Angels of Anaheim,0,Houston Astros,3,2,September 15 2013,1
San Francisco Giants,0,Los Angeles Dodgers,7,4,September 15 2013,3
Cincinnati Reds,1,Milwaukee Brewers,11,5,September 15 2013,6
Tampa Bay Rays,1,Minnesota Twins,10,4,September 15 2013,6
Miami Marlins,1,New York Mets,1,0,September 15 2013,1
Chicago Cubs,1,Pittsburgh Pirates,5,2,September 15 2013,3
Seattle Mariners,1,St. Louis Cardinals,14,2,September 15 2013,12
Oakland Athletics,0,Texas Rangers,6,5,September 15 2013,1
Baltimore Orioles,0,Toronto Blue Jays,4,3,September 15 2013,1
Philadelphia Phillies,1,Washington Nationals,13,2,September 15 2013,11
Los Angeles Dodgers,1,Arizona D'Backs,3,1,September 16 2013,2
Minnesota Twins,1,Chicago White Sox,13,1,September 16 2013,12
St. Louis Cardinals,1,Colorado Rockies,8,2,September 16 2013,6
Seattle Mariners,1,Detroit Tigers,6,2,September 16 2013,4
Cincinnati Reds,0,Houston Astros,7,6,September 16 2013,1
Cleveland Indians,1,Kansas City Royals,8,1,September 16 2013,7
Chicago Cubs,1,Milwaukee Brewers,7,1,September 16 2013,6
LA Angels of Anaheim,0,Oakland Athletics,13,12,September 16 2013,1
Miami Marlins,1,Philadelphia Phillies,14,2,September 16 2013,12
San Diego Padres,0,Pittsburgh Pirates,2,2,September 16 2013,0
Texas Rangers,1,Tampa Bay Rays,8,2,September 16 2013,6
Los Angeles Dodgers,0,Arizona D'Backs,12,9,September 17 2013,3
Baltimore Orioles,0,Boston Red Sox,5,3,September 17 2013,2
Minnesota Twins,1,Chicago White Sox,7,3,September 17 2013,4
St. Louis Cardinals,0,Colorado Rockies,15,11,September 17 2013,4
Seattle Mariners,1,Detroit Tigers,8,2,September 17 2013,6
Cincinnati Reds,0,Houston Astros,10,10,September 17 2013,0
Cleveland Indians,0,Kansas City Royals,8,5,September 17 2013,3
Chicago Cubs,1,Milwaukee Brewers,7,3,September 17 2013,4
San Francisco Giants,0,New York Mets,13,8,September 17 2013,5
LA Angels of Anaheim,1,Oakland Athletics,3,1,September 17 2013,2
Miami Marlins,1,Philadelphia Phillies,10,4,September 17 2013,6
San Diego Padres,0,Pittsburgh Pirates,7,5,September 17 2013,2
Texas Rangers,0,Tampa Bay Rays,8,7,September 17 2013,1
New York Yankees,1,Toronto Blue Jays,2,0,September 17 2013,2
Atlanta Braves,1,Washington Nationals,11,5,September 17 2013,6
Atlanta Braves,1,Washington Nationals,4,0,September 17 2013,4
Los Angeles Dodgers,1,Arizona D'Backs,13,4,September 18 2013,9
Baltimore Orioles,0,Boston Red Sox,8,5,September 18 2013,3
Minnesota Twins,0,Chicago White Sox,7,4,September 18 2013,3
St. Louis Cardinals,0,Colorado Rockies,7,4,September 18 2013,3
Seattle Mariners,0,Detroit Tigers,8,8,September 18 2013,0
Cincinnati Reds,0,Houston Astros,11,6,September 18 2013,5
Cleveland Indians,1,Kansas City Royals,9,2,September 18 2013,7
Chicago Cubs,1,Milwaukee Brewers,7,0,September 18 2013,7
San Francisco Giants,1,New York Mets,9,4,September 18 2013,5
LA Angels of Anaheim,0,Oakland Athletics,9,5,September 18 2013,4
Miami Marlins,0,Philadelphia Phillies,7,4,September 18 2013,3
San Diego Padres,0,Pittsburgh Pirates,5,3,September 18 2013,2
Texas Rangers,1,Tampa Bay Rays,7,3,September 18 2013,4
New York Yankees,0,Toronto Blue Jays,7,4,September 18 2013,3
Atlanta Braves,0,Washington Nationals,7,5,September 18 2013,2
Los Angeles Dodgers,0,Arizona D'Backs,13,7,September 19 2013,6
Baltimore Orioles,1,Boston Red Sox,4,1,September 19 2013,3
Houston Astros,1,Cleveland Indians,3,1,September 19 2013,2
St. Louis Cardinals,1,Colorado Rockies,13,6,September 19 2013,7
Seattle Mariners,1,Detroit Tigers,9,4,September 19 2013,5
Chicago Cubs,0,Milwaukee Brewers,6,5,September 19 2013,1
San Francisco Giants,0,New York Mets,3,2,September 19 2013,1
Minnesota Twins,1,Oakland Athletics,14,6,September 19 2013,8
San Diego Padres,1,Pittsburgh Pirates,11,1,September 19 2013,10
Texas Rangers,0,Tampa Bay Rays,10,8,September 19 2013,2
New York Yankees,1,Toronto Blue Jays,8,2,September 19 2013,6
Miami Marlins,1,Washington Nationals,5,2,September 19 2013,3
Seattle Mariners,1,LA Angels of Anaheim,5,2,September 20 2013,3
Toronto Blue Jays,1,Boston Red Sox,9,3,September 20 2013,6
Atlanta Braves,0,Chicago Cubs,14,9,September 20 2013,5
Houston Astros,1,Cleveland Indians,3,1,September 20 2013,2
Arizona D'Backs,1,Colorado Rockies,13,4,September 20 2013,9
Chicago White Sox,1,Detroit Tigers,17,5,September 20 2013,12
Texas Rangers,1,Kansas City Royals,3,1,September 20 2013,2
St. Louis Cardinals,0,Milwaukee Brewers,13,7,September 20 2013,6
San Francisco Giants,1,New York Yankees,6,1,September 20 2013,5
Minnesota Twins,1,Oakland Athletics,11,0,September 20 2013,11
New York Mets,0,Philadelphia Phillies,10,6,September 20 2013,4
Cincinnati Reds,0,Pittsburgh Pirates,11,6,September 20 2013,5
Los Angeles Dodgers,1,San Diego Padres,2,0,September 20 2013,2
Baltimore Orioles,1,Tampa Bay Rays,9,4,September 20 2013,5
Miami Marlins,1,Washington Nationals,8,0,September 20 2013,8
Seattle Mariners,1,LA Angels of Anaheim,11,5,September 21 2013,6
Toronto Blue Jays,0,Boston Red Sox,6,4,September 21 2013,2
Atlanta Braves,1,Chicago Cubs,4,1,September 21 2013,3
Houston Astros,1,Cleveland Indians,5,1,September 21 2013,4
Arizona D'Backs,0,Colorado Rockies,9,7,September 21 2013,2
Chicago White Sox,1,Detroit Tigers,13,6,September 21 2013,7
Texas Rangers,0,Kansas City Royals,4,3,September 21 2013,1
St. Louis Cardinals,0,Milwaukee Brewers,9,7,September 21 2013,2
San Francisco Giants,1,New York Yankees,6,0,September 21 2013,6
Minnesota Twins,1,Oakland Athletics,10,1,September 21 2013,9
New York Mets,0,Philadelphia Phillies,9,5,September 21 2013,4
Cincinnati Reds,1,Pittsburgh Pirates,6,2,September 21 2013,4
Los Angeles Dodgers,0,San Diego Padres,4,4,September 21 2013,0
Baltimore Orioles,1,Tampa Bay Rays,6,1,September 21 2013,5
Seattle Mariners,0,LA Angels of Anaheim,5,3,September 22 2013,2
Toronto Blue Jays,1,Boston Red Sox,7,2,September 22 2013,5
Atlanta Braves,0,Chicago Cubs,7,5,September 22 2013,2
Houston Astros,1,Cleveland Indians,11,2,September 22 2013,9
Arizona D'Backs,0,Colorado Rockies,22,13,September 22 2013,9
Chicago White Sox,0,Detroit Tigers,9,6,September 22 2013,3
Texas Rangers,1,Kansas City Royals,4,0,September 22 2013,4
St. Louis Cardinals,1,Milwaukee Brewers,10,4,September 22 2013,6
San Francisco Giants,0,New York Yankees,3,2,September 22 2013,1
Minnesota Twins,1,Oakland Athletics,18,7,September 22 2013,11
New York Mets,0,Philadelphia Phillies,7,4,September 22 2013,3
Cincinnati Reds,0,Pittsburgh Pirates,14,11,September 22 2013,3
Los Angeles Dodgers,0,San Diego Padres,1,1,September 22 2013,0
Baltimore Orioles,1,Tampa Bay Rays,4,1,September 22 2013,3
Miami Marlins,0,Washington Nationals,6,4,September 22 2013,2
Miami Marlins,1,Washington Nationals,9,4,September 22 2013,5
Oakland Athletics,0,LA Angels of Anaheim,15,10,September 23 2013,5
Milwaukee Brewers,0,Atlanta Braves,5,5,September 23 2013,0
Toronto Blue Jays,1,Chicago White Sox,5,2,September 23 2013,3
Pittsburgh Pirates,0,Chicago Cubs,3,2,September 23 2013,1
New York Mets,1,Cincinnati Reds,5,2,September 23 2013,3
Philadelphia Phillies,1,Miami Marlins,4,0,September 23 2013,4
Detroit Tigers,1,Minnesota Twins,7,3,September 23 2013,4
Arizona D'Backs,1,San Diego Padres,5,1,September 23 2013,4
Kansas City Royals,0,Seattle Mariners,11,6,September 23 2013,5
Washington Nationals,1,St. Louis Cardinals,7,3,September 23 2013,4
Baltimore Orioles,1,Tampa Bay Rays,9,4,September 23 2013,5
Houston Astros,1,Texas Rangers,12,0,September 23 2013,12
Oakland Athletics,1,LA Angels of Anaheim,3,0,September 24 2013,3
Milwaukee Brewers,1,Atlanta Braves,5,2,September 24 2013,3
Toronto Blue Jays,0,Baltimore Orioles,5,3,September 24 2013,2
Pittsburgh Pirates,0,Chicago Cubs,10,8,September 24 2013,2
New York Mets,0,Cincinnati Reds,6,4,September 24 2013,2
Chicago White Sox,1,Cleveland Indians,9,4,September 24 2013,5
Boston Red Sox,1,Colorado Rockies,11,3,September 24 2013,8
Philadelphia Phillies,0,Miami Marlins,3,2,September 24 2013,1
Detroit Tigers,0,Minnesota Twins,6,4,September 24 2013,2
Tampa Bay Rays,0,New York Yankees,7,7,September 24 2013,0
Arizona D'Backs,0,San Diego Padres,3,2,September 24 2013,1
Kansas City Royals,1,Seattle Mariners,4,0,September 24 2013,4
Los Angeles Dodgers,0,San Francisco Giants,3,2,September 24 2013,1
Washington Nationals,1,St. Louis Cardinals,2,0,September 24 2013,2
Houston Astros,1,Texas Rangers,5,2,September 24 2013,3
Oakland Athletics,1,LA Angels of Anaheim,4,1,September 25 2013,3
Milwaukee Brewers,0,Atlanta Braves,4,4,September 25 2013,0
Toronto Blue Jays,1,Baltimore Orioles,14,5,September 25 2013,9
Pittsburgh Pirates,1,Chicago Cubs,6,2,September 25 2013,4
New York Mets,0,Cincinnati Reds,1,1,September 25 2013,0
Chicago White Sox,1,Cleveland Indians,9,2,September 25 2013,7
Boston Red Sox,0,Colorado Rockies,20,15,September 25 2013,5
Philadelphia Phillies,1,Miami Marlins,5,2,September 25 2013,3
Detroit Tigers,0,Minnesota Twins,1,1,September 25 2013,0
Tampa Bay Rays,0,New York Yankees,11,8,September 25 2013,3
Arizona D'Backs,1,San Diego Padres,14,2,September 25 2013,12
Kansas City Royals,1,Seattle Mariners,6,0,September 25 2013,6
Los Angeles Dodgers,1,San Francisco Giants,10,4,September 25 2013,6
Washington Nationals,1,St. Louis Cardinals,5,1,September 25 2013,4
Houston Astros,1,Texas Rangers,10,3,September 25 2013,7
Philadelphia Phillies,1,Atlanta Braves,8,1,September 26 2013,7
Toronto Blue Jays,1,Baltimore Orioles,5,2,September 26 2013,3
Kansas City Royals,0,Chicago White Sox,5,3,September 26 2013,2
Cleveland Indians,0,Minnesota Twins,11,6,September 26 2013,5
Tampa Bay Rays,0,New York Yankees,4,4,September 26 2013,0
Milwaukee Brewers,0,New York Mets,6,4,September 26 2013,2
Arizona D'Backs,1,San Diego Padres,5,2,September 26 2013,3
Los Angeles Dodgers,1,San Francisco Giants,5,2,September 26 2013,3
LA Angels of Anaheim,1,Texas Rangers,11,5,September 26 2013,6
Washington Nationals,0,Arizona D'Backs,12,8,September 27 2013,4
Philadelphia Phillies,1,Atlanta Braves,1,0,September 27 2013,1
Boston Red Sox,0,Baltimore Orioles,15,12,September 27 2013,3
Kansas City Royals,0,Chicago White Sox,7,6,September 27 2013,1
Pittsburgh Pirates,0,Cincinnati Reds,5,4,September 27 2013,1
New York Yankees,0,Houston Astros,5,3,September 27 2013,2
Colorado Rockies,1,Los Angeles Dodgers,11,0,September 27 2013,11
Detroit Tigers,1,Miami Marlins,5,2,September 27 2013,3
Cleveland Indians,0,Minnesota Twins,18,12,September 27 2013,6
Milwaukee Brewers,0,New York Mets,6,4,September 27 2013,2
Oakland Athletics,0,Seattle Mariners,10,8,September 27 2013,2
San Diego Padres,1,San Francisco Giants,10,3,September 27 2013,7
Chicago Cubs,1,St. Louis Cardinals,7,0,September 27 2013,7
LA Angels of Anaheim,1,Texas Rangers,8,3,September 27 2013,5
Tampa Bay Rays,1,Toronto Blue Jays,9,3,September 27 2013,6
Washington Nationals,0,Arizona D'Backs,2,2,September 28 2013,0
Philadelphia Phillies,0,Atlanta Braves,9,5,September 28 2013,4
Boston Red Sox,1,Baltimore Orioles,11,5,September 28 2013,6
Kansas City Royals,1,Chicago White Sox,11,5,September 28 2013,6
Pittsburgh Pirates,0,Cincinnati Reds,11,8,September 28 2013,3
New York Yankees,0,Houston Astros,3,2,September 28 2013,1
Colorado Rockies,0,Los Angeles Dodgers,1,1,September 28 2013,0
Detroit Tigers,1,Miami Marlins,3,1,September 28 2013,2
Cleveland Indians,0,Minnesota Twins,6,5,September 28 2013,1
Milwaukee Brewers,0,New York Mets,6,4,September 28 2013,2
Oakland Athletics,1,Seattle Mariners,12,5,September 28 2013,7
San Diego Padres,0,San Francisco Giants,12,9,September 28 2013,3
Chicago Cubs,1,St. Louis Cardinals,8,2,September 28 2013,6
LA Angels of Anaheim,1,Texas Rangers,11,4,September 28 2013,7
Tampa Bay Rays,1,Toronto Blue Jays,9,2,September 28 2013,7
Washington Nationals,1,Arizona D'Backs,5,2,September 29 2013,3
Philadelphia Phillies,1,Atlanta Braves,17,5,September 29 2013,12
Boston Red Sox,1,Baltimore Orioles,13,6,September 29 2013,7
Kansas City Royals,0,Chicago White Sox,5,4,September 29 2013,1
Pittsburgh Pirates,0,Cincinnati Reds,6,4,September 29 2013,2
New York Yankees,0,Houston Astros,6,5,September 29 2013,1
Colorado Rockies,0,Los Angeles Dodgers,3,2,September 29 2013,1
Detroit Tigers,1,Miami Marlins,1,0,September 29 2013,1
Cleveland Indians,0,Minnesota Twins,6,5,September 29 2013,1
Milwaukee Brewers,1,New York Mets,5,2,September 29 2013,3
Oakland Athletics,0,Seattle Mariners,9,9,September 29 2013,0
San Diego Padres,1,San Francisco Giants,13,6,September 29 2013,7
Chicago Cubs,1,St. Louis Cardinals,4,0,September 29 2013,4
LA Angels of Anaheim,1,Texas Rangers,8,2,September 29 2013,6
Tampa Bay Rays,0,Toronto Blue Jays,13,7,September 29 2013,6
Tampa Bay Rays,0,Texas Rangers,7,5,September 30 2013,2
Cincinnati Reds,1,Pittsburgh Pirates,8,2,October 1 2013,6
Tampa Bay Rays,0,Cleveland Indians,4,4,October 2 2013,0
Los Angeles Dodgers,0,Atlanta Braves,7,6,October 3 2013,1
Pittsburgh Pirates,1,St. Louis Cardinals,10,1,October 3 2013,9
Los Angeles Dodgers,1,Atlanta Braves,7,3,October 4 2013,4
Tampa Bay Rays,1,Boston Red Sox,14,2,October 4 2013,12
Detroit Tigers,0,Oakland Athletics,5,3,October 4 2013,2
Pittsburgh Pirates,0,St. Louis Cardinals,8,7,October 4 2013,1
Tampa Bay Rays,1,Boston Red Sox,11,4,October 5 2013,7
Detroit Tigers,1,Oakland Athletics,1,0,October 5 2013,1
Atlanta Braves,1,Los Angeles Dodgers,19,6,October 6 2013,13
St. Louis Cardinals,1,Pittsburgh Pirates,8,3,October 6 2013,5
Oakland Athletics,0,Detroit Tigers,9,6,October 7 2013,3
Atlanta Braves,1,Los Angeles Dodgers,7,3,October 7 2013,4
St. Louis Cardinals,0,Pittsburgh Pirates,3,2,October 7 2013,1
Boston Red Sox,1,Tampa Bay Rays,9,4,October 7 2013,5
Oakland Athletics,1,Detroit Tigers,14,6,October 8 2013,8
Boston Red Sox,0,Tampa Bay Rays,4,3,October 8 2013,1
Pittsburgh Pirates,1,St. Louis Cardinals,7,1,October 9 2013,6
Detroit Tigers,0,Oakland Athletics,3,3,October 10 2013,0
Los Angeles Dodgers,1,St. Louis Cardinals,5,2,October 11 2013,3
Detroit Tigers,0,Boston Red Sox,1,1,October 12 2013,0
Los Angeles Dodgers,1,St. Louis Cardinals,1,0,October 12 2013,1
Detroit Tigers,1,Boston Red Sox,11,5,October 13 2013,6
St. Louis Cardinals,1,Los Angeles Dodgers,3,0,October 14 2013,3
Boston Red Sox,0,Detroit Tigers,1,1,October 15 2013,0
St. Louis Cardinals,0,Los Angeles Dodgers,6,4,October 15 2013,2
Boston Red Sox,1,Detroit Tigers,10,3,October 16 2013,7
St. Louis Cardinals,1,Los Angeles Dodgers,10,4,October 16 2013,6
Boston Red Sox,0,Detroit Tigers,7,4,October 17 2013,3
Los Angeles Dodgers,1,St. Louis Cardinals,9,0,October 18 2013,9
Detroit Tigers,1,Boston Red Sox,7,2,October 19 2013,5
St. Louis Cardinals,1,Boston Red Sox,9,1,October 23 2013,8
St. Louis Cardinals,0,Boston Red Sox,6,4,October 24 2013,2
Boston Red Sox,1,St. Louis Cardinals,9,4,October 26 2013,5
Boston Red Sox,0,St. Louis Cardinals,6,4,October 27 2013,2
Boston Red Sox,0,St. Louis Cardinals,4,3,October 28 2013,1
St. Louis Cardinals,1,Boston Red Sox,7,1,October 30 2013,6
Los Angeles Dodgers,0,Arizona D'Backs,4,3,March 22 2014,1
Los Angeles Dodgers,0,Arizona D'Backs,12,7,March 23 2014,5
Los Angeles Dodgers,1,San Diego Padres,4,1,March 30 2014,3
Seattle Mariners,0,LA Angels of Anaheim,13,10,March 31 2014,3
San Francisco Giants,0,Arizona D'Backs,17,9,March 31 2014,8
Boston Red Sox,1,Baltimore Orioles,3,1,March 31 2014,2
Minnesota Twins,1,Chicago White Sox,8,3,March 31 2014,5
St. Louis Cardinals,0,Cincinnati Reds,1,1,March 31 2014,0
Kansas City Royals,1,Detroit Tigers,7,3,March 31 2014,4
Colorado Rockies,1,Miami Marlins,11,1,March 31 2014,10
Atlanta Braves,1,Milwaukee Brewers,2,0,March 31 2014,2
Washington Nationals,0,New York Mets,16,9,March 31 2014,7
Cleveland Indians,0,Oakland Athletics,2,2,March 31 2014,0
Chicago Cubs,1,Pittsburgh Pirates,1,0,March 31 2014,1
Toronto Blue Jays,1,Tampa Bay Rays,11,2,March 31 2014,9
Philadelphia Phillies,0,Texas Rangers,24,14,March 31 2014,10
Seattle Mariners,0,LA Angels of Anaheim,11,8,April 1 2014,3
San Francisco Giants,1,Arizona D'Backs,9,4,April 1 2014,5
New York Yankees,1,Houston Astros,8,2,April 1 2014,6
Colorado Rockies,1,Miami Marlins,7,3,April 1 2014,4
Atlanta Braves,0,Milwaukee Brewers,7,5,April 1 2014,2
Los Angeles Dodgers,0,San Diego Padres,5,3,April 1 2014,2
Toronto Blue Jays,0,Tampa Bay Rays,6,4,April 1 2014,2
Philadelphia Phillies,1,Texas Rangers,5,2,April 1 2014,3
Seattle Mariners,0,LA Angels of Anaheim,10,8,April 2 2014,2
San Francisco Giants,0,Arizona D'Backs,2,2,April 2 2014,0
Boston Red Sox,0,Baltimore Orioles,8,6,April 2 2014,2
Minnesota Twins,1,Chicago White Sox,13,6,April 2 2014,7
St. Louis Cardinals,1,Cincinnati Reds,1,0,April 2 2014,1
Kansas City Royals,1,Detroit Tigers,3,1,April 2 2014,2
New York Yankees,1,Houston Astros,4,1,April 2 2014,3
Colorado Rockies,0,Miami Marlins,11,6,April 2 2014,5
Atlanta Braves,0,Milwaukee Brewers,1,1,April 2 2014,0
Washington Nationals,0,New York Mets,6,5,April 2 2014,1
Cleveland Indians,1,Oakland Athletics,7,1,April 2 2014,6
Cleveland Indians,0,Oakland Athletics,10,6,April 2 2014,4
Chicago Cubs,1,Pittsburgh Pirates,7,3,April 2 2014,4
Los Angeles Dodgers,0,San Diego Padres,6,5,April 2 2014,1
Toronto Blue Jays,0,Tampa Bay Rays,3,3,April 2 2014,0
Philadelphia Phillies,1,Texas Rangers,7,3,April 2 2014,4
San Francisco Giants,0,Arizona D'Backs,13,8,April 3 2014,5
Boston Red Sox,0,Baltimore Orioles,7,4,April 3 2014,3
Minnesota Twins,0,Chicago White Sox,19,10,April 3 2014,9
St. Louis Cardinals,0,Cincinnati Reds,13,7,April 3 2014,6
New York Yankees,0,Houston Astros,6,4,April 3 2014,2
Colorado Rockies,1,Miami Marlins,13,5,April 3 2014,8
Washington Nationals,0,New York Mets,10,8,April 3 2014,2
Seattle Mariners,1,Oakland Athletics,5,2,April 3 2014,3
Chicago Cubs,0,Pittsburgh Pirates,5,3,April 3 2014,2
Toronto Blue Jays,1,Tampa Bay Rays,9,2,April 3 2014,7
Milwaukee Brewers,0,Boston Red Sox,8,6,April 4 2014,2
Philadelphia Phillies,0,Chicago Cubs,9,7,April 4 2014,2
Minnesota Twins,1,Cleveland Indians,9,2,April 4 2014,7
Arizona D'Backs,1,Colorado Rockies,14,2,April 4 2014,12
Baltimore Orioles,1,Detroit Tigers,14,4,April 4 2014,10
LA Angels of Anaheim,0,Houston Astros,12,11,April 4 2014,1
Chicago White Sox,1,Kansas City Royals,12,5,April 4 2014,7
San Francisco Giants,0,Los Angeles Dodgers,12,8,April 4 2014,4
San Diego Padres,1,Miami Marlins,10,2,April 4 2014,8
Cincinnati Reds,1,New York Mets,7,3,April 4 2014,4
St. Louis Cardinals,1,Pittsburgh Pirates,14,2,April 4 2014,12
Texas Rangers,1,Tampa Bay Rays,9,1,April 4 2014,8
New York Yankees,0,Toronto Blue Jays,10,7,April 4 2014,3
Atlanta Braves,0,Washington Nationals,3,2,April 4 2014,1
Milwaukee Brewers,0,Boston Red Sox,13,7,April 5 2014,6
Philadelphia Phillies,0,Chicago Cubs,2,2,April 5 2014,0
Minnesota Twins,0,Cleveland Indians,10,7,April 5 2014,3
Arizona D'Backs,1,Colorado Rockies,13,4,April 5 2014,9
Baltimore Orioles,1,Detroit Tigers,13,6,April 5 2014,7
LA Angels of Anaheim,0,Houston Astros,6,5,April 5 2014,1
Chicago White Sox,1,Kansas City Royals,7,3,April 5 2014,4
San Francisco Giants,0,Los Angeles Dodgers,9,7,April 5 2014,2
San Diego Padres,1,Miami Marlins,5,0,April 5 2014,5
Cincinnati Reds,1,New York Mets,9,3,April 5 2014,6
Seattle Mariners,0,Oakland Athletics,4,3,April 5 2014,1
St. Louis Cardinals,0,Pittsburgh Pirates,7,6,April 5 2014,1
Texas Rangers,1,Tampa Bay Rays,9,4,April 5 2014,5
New York Yankees,1,Toronto Blue Jays,4,0,April 5 2014,4
Atlanta Braves,0,Washington Nationals,8,6,April 5 2014,2
Milwaukee Brewers,0,Boston Red Sox,4,4,April 6 2014,0
Philadelphia Phillies,1,Chicago Cubs,11,3,April 6 2014,8
Minnesota Twins,0,Cleveland Indians,17,10,April 6 2014,7
Arizona D'Backs,0,Colorado Rockies,8,5,April 6 2014,3
Baltimore Orioles,0,Detroit Tigers,4,3,April 6 2014,1
LA Angels of Anaheim,1,Houston Astros,11,4,April 6 2014,7
Chicago White Sox,0,Kansas City Royals,6,5,April 6 2014,1
San Francisco Giants,1,Los Angeles Dodgers,8,2,April 6 2014,6
San Diego Padres,0,Miami Marlins,6,4,April 6 2014,2
Cincinnati Reds,0,New York Mets,3,2,April 6 2014,1
Seattle Mariners,1,Oakland Athletics,9,3,April 6 2014,6
St. Louis Cardinals,1,Pittsburgh Pirates,3,1,April 6 2014,2
Texas Rangers,0,Tampa Bay Rays,3,3,April 6 2014,0
New York Yankees,0,Toronto Blue Jays,10,6,April 6 2014,4
Atlanta Braves,1,Washington Nationals,3,1,April 6 2014,2
Texas Rangers,1,Boston Red Sox,6,1,April 7 2014,5
Chicago White Sox,1,Colorado Rockies,9,1,April 7 2014,8
LA Angels of Anaheim,0,Houston Astros,10,9,April 7 2014,1
Tampa Bay Rays,1,Kansas City Royals,6,2,April 7 2014,4
Oakland Athletics,0,Minnesota Twins,11,8,April 7 2014,3
Baltimore Orioles,1,New York Yankees,6,2,April 7 2014,4
Cincinnati Reds,1,St. Louis Cardinals,8,3,April 7 2014,5
New York Mets,0,Atlanta Braves,4,4,April 8 2014,0
Texas Rangers,0,Boston Red Sox,17,10,April 8 2014,7
Pittsburgh Pirates,0,Chicago Cubs,13,7,April 8 2014,6
San Diego Padres,1,Cleveland Indians,14,6,April 8 2014,8
Chicago White Sox,0,Colorado Rockies,18,15,April 8 2014,3
Tampa Bay Rays,0,Kansas City Royals,1,1,April 8 2014,0
Detroit Tigers,1,Los Angeles Dodgers,5,2,April 8 2014,3
Baltimore Orioles,0,New York Yankees,19,14,April 8 2014,5
Milwaukee Brewers,0,Philadelphia Phillies,14,10,April 8 2014,4
LA Angels of Anaheim,1,Seattle Mariners,8,3,April 8 2014,5
Arizona D'Backs,1,San Francisco Giants,10,3,April 8 2014,7
Cincinnati Reds,1,St. Louis Cardinals,12,5,April 8 2014,7
Houston Astros,1,Toronto Blue Jays,7,2,April 8 2014,5
Miami Marlins,1,Washington Nationals,5,0,April 8 2014,5
New York Mets,1,Atlanta Braves,7,3,April 9 2014,4
Texas Rangers,1,Boston Red Sox,6,2,April 9 2014,4
Pittsburgh Pirates,1,Chicago Cubs,12,5,April 9 2014,7
San Diego Padres,1,Cleveland Indians,2,0,April 9 2014,2
San Diego Padres,0,Cleveland Indians,3,2,April 9 2014,1
Chicago White Sox,1,Colorado Rockies,14,4,April 9 2014,10
Tampa Bay Rays,1,Kansas City Royals,10,3,April 9 2014,7
Detroit Tigers,0,Los Angeles Dodgers,13,7,April 9 2014,6
Oakland Athletics,0,Minnesota Twins,11,7,April 9 2014,4
Baltimore Orioles,0,New York Yankees,9,5,April 9 2014,4
Milwaukee Brewers,0,Philadelphia Phillies,13,9,April 9 2014,4
LA Angels of Anaheim,0,Seattle Mariners,2,2,April 9 2014,0
Arizona D'Backs,0,San Francisco Giants,10,7,April 9 2014,3
Cincinnati Reds,0,St. Louis Cardinals,4,4,April 9 2014,0
Houston Astros,1,Toronto Blue Jays,10,3,April 9 2014,7
Miami Marlins,1,Washington Nationals,17,7,April 9 2014,10
New York Mets,0,Atlanta Braves,10,6,April 10 2014,4
Cleveland Indians,1,Chicago White Sox,10,3,April 10 2014,7
Pittsburgh Pirates,0,Chicago Cubs,9,5,April 10 2014,4
Oakland Athletics,0,Minnesota Twins,7,6,April 10 2014,1
Boston Red Sox,1,New York Yankees,5,1,April 10 2014,4
Milwaukee Brewers,0,Philadelphia Phillies,8,6,April 10 2014,2
Arizona D'Backs,0,San Francisco Giants,11,6,April 10 2014,5
Houston Astros,0,Toronto Blue Jays,10,6,April 10 2014,4
Miami Marlins,1,Washington Nationals,8,1,April 10 2014,7
New York Mets,1,LA Angels of Anaheim,9,4,April 11 2014,5
Los Angeles Dodgers,0,Arizona D'Backs,6,6,April 11 2014,0
Washington Nationals,1,Atlanta Braves,13,6,April 11 2014,7
Toronto Blue Jays,0,Baltimore Orioles,2,2,April 11 2014,0
Cleveland Indians,1,Chicago White Sox,15,6,April 11 2014,9
Tampa Bay Rays,0,Cincinnati Reds,3,2,April 11 2014,1
Pittsburgh Pirates,1,Milwaukee Brewers,6,2,April 11 2014,4
Kansas City Royals,1,Minnesota Twins,11,1,April 11 2014,10
Boston Red Sox,0,New York Yankees,6,4,April 11 2014,2
Miami Marlins,1,Philadelphia Phillies,9,3,April 11 2014,6
Detroit Tigers,1,San Diego Padres,6,0,April 11 2014,6
Oakland Athletics,1,Seattle Mariners,10,4,April 11 2014,6
Colorado Rockies,1,San Francisco Giants,11,5,April 11 2014,6
Chicago Cubs,0,St. Louis Cardinals,9,6,April 11 2014,3
Houston Astros,1,Texas Rangers,1,0,April 11 2014,1
New York Mets,0,LA Angels of Anaheim,13,7,April 12 2014,6
Los Angeles Dodgers,0,Arizona D'Backs,13,8,April 12 2014,5
Washington Nationals,1,Atlanta Braves,9,3,April 12 2014,6
Toronto Blue Jays,1,Baltimore Orioles,3,1,April 12 2014,2
Cleveland Indians,0,Chicago White Sox,18,12,April 12 2014,6
Tampa Bay Rays,0,Cincinnati Reds,1,1,April 12 2014,0
Pittsburgh Pirates,1,Milwaukee Brewers,5,2,April 12 2014,3
Kansas City Royals,1,Minnesota Twins,8,1,April 12 2014,7
Boston Red Sox,1,New York Yankees,11,4,April 12 2014,7
Miami Marlins,1,Philadelphia Phillies,9,4,April 12 2014,5
Detroit Tigers,0,San Diego Padres,8,6,April 12 2014,2
Oakland Athletics,0,Seattle Mariners,4,3,April 12 2014,1
Colorado Rockies,0,San Francisco Giants,1,1,April 12 2014,0
Chicago Cubs,1,St. Louis Cardinals,14,4,April 12 2014,10
Houston Astros,0,Texas Rangers,11,6,April 12 2014,5
New York Mets,1,LA Angels of Anaheim,16,2,April 13 2014,14
Los Angeles Dodgers,0,Arizona D'Backs,14,8,April 13 2014,6
Washington Nationals,1,Atlanta Braves,12,2,April 13 2014,10
Toronto Blue Jays,0,Baltimore Orioles,14,11,April 13 2014,3
Cleveland Indians,1,Chicago White Sox,7,3,April 13 2014,4
Tampa Bay Rays,1,Cincinnati Reds,16,4,April 13 2014,12
Pittsburgh Pirates,1,Milwaukee Brewers,5,1,April 13 2014,4
Kansas City Royals,1,Minnesota Twins,7,3,April 13 2014,4
Boston Red Sox,1,New York Yankees,5,2,April 13 2014,3
Miami Marlins,1,Philadelphia Phillies,7,3,April 13 2014,4
Detroit Tigers,1,San Diego Padres,6,1,April 13 2014,5
Oakland Athletics,0,Seattle Mariners,3,3,April 13 2014,0
Colorado Rockies,1,San Francisco Giants,9,4,April 13 2014,5
Chicago Cubs,1,St. Louis Cardinals,10,4,April 13 2014,6
Houston Astros,1,Texas Rangers,1,0,April 13 2014,1
Oakland Athletics,0,LA Angels of Anaheim,5,3,April 14 2014,2
New York Mets,0,Arizona D'Backs,10,7,April 14 2014,3
Tampa Bay Rays,1,Baltimore Orioles,8,1,April 14 2014,7
Pittsburgh Pirates,0,Cincinnati Reds,15,8,April 14 2014,7
Washington Nationals,0,Miami Marlins,11,9,April 14 2014,2
St. Louis Cardinals,0,Milwaukee Brewers,4,4,April 14 2014,0
Atlanta Braves,0,Philadelphia Phillies,15,9,April 14 2014,6
Colorado Rockies,1,San Diego Padres,9,4,April 14 2014,5
Seattle Mariners,0,Texas Rangers,8,7,April 14 2014,1
Oakland Athletics,0,LA Angels of Anaheim,19,10,April 15 2014,9
New York Mets,0,Arizona D'Backs,9,9,April 15 2014,0
Boston Red Sox,1,Chicago White Sox,3,1,April 15 2014,2
Pittsburgh Pirates,1,Cincinnati Reds,12,5,April 15 2014,7
Kansas City Royals,0,Houston Astros,6,4,April 15 2014,2
Washington Nationals,1,Miami Marlins,13,2,April 15 2014,11
St. Louis Cardinals,0,Milwaukee Brewers,7,6,April 15 2014,1
Toronto Blue Jays,0,Minnesota Twins,12,9,April 15 2014,3
Colorado Rockies,0,San Diego Padres,5,3,April 15 2014,2
Los Angeles Dodgers,1,San Francisco Giants,5,2,April 15 2014,3
Seattle Mariners,1,Texas Rangers,5,0,April 15 2014,5
Oakland Athletics,1,LA Angels of Anaheim,9,4,April 16 2014,5
New York Mets,0,Arizona D'Backs,7,5,April 16 2014,2
Tampa Bay Rays,1,Baltimore Orioles,3,0,April 16 2014,3
Boston Red Sox,0,Chicago White Sox,10,6,April 16 2014,4
Pittsburgh Pirates,1,Cincinnati Reds,4,0,April 16 2014,4
Cleveland Indians,0,Detroit Tigers,5,3,April 16 2014,2
Kansas City Royals,0,Houston Astros,10,6,April 16 2014,4
Washington Nationals,0,Miami Marlins,9,6,April 16 2014,3
St. Louis Cardinals,1,Milwaukee Brewers,6,1,April 16 2014,5
Chicago Cubs,1,New York Yankees,3,0,April 16 2014,3
Chicago Cubs,1,New York Yankees,2,0,April 16 2014,2
Atlanta Braves,0,Philadelphia Phillies,1,1,April 16 2014,0
Colorado Rockies,1,San Diego Padres,6,2,April 16 2014,4
Los Angeles Dodgers,1,San Francisco Giants,3,1,April 16 2014,2
Seattle Mariners,1,Texas Rangers,5,2,April 16 2014,3
Boston Red Sox,0,Chicago White Sox,4,3,April 17 2014,1
Cleveland Indians,1,Detroit Tigers,12,5,April 17 2014,7
Kansas City Royals,0,Houston Astros,6,5,April 17 2014,1
Toronto Blue Jays,1,Minnesota Twins,7,0,April 17 2014,7
Toronto Blue Jays,1,Minnesota Twins,14,5,April 17 2014,9
Atlanta Braves,1,Philadelphia Phillies,1,0,April 17 2014,1
Milwaukee Brewers,1,Pittsburgh Pirates,13,2,April 17 2014,11
Colorado Rockies,0,San Diego Padres,4,3,April 17 2014,1
Los Angeles Dodgers,0,San Francisco Giants,3,2,April 17 2014,1
New York Yankees,0,Tampa Bay Rays,12,10,April 17 2014,2
Seattle Mariners,1,Texas Rangers,14,6,April 17 2014,8
St. Louis Cardinals,0,Washington Nationals,8,8,April 17 2014,0
Baltimore Orioles,0,Boston Red Sox,12,8,April 18 2014,4
Cincinnati Reds,0,Chicago Cubs,5,4,April 18 2014,1
Toronto Blue Jays,0,Cleveland Indians,5,3,April 18 2014,2
Philadelphia Phillies,1,Colorado Rockies,13,1,April 18 2014,12
LA Angels of Anaheim,0,Detroit Tigers,17,11,April 18 2014,6
Minnesota Twins,1,Kansas City Royals,5,0,April 18 2014,5
Arizona D'Backs,0,Los Angeles Dodgers,6,4,April 18 2014,2
Seattle Mariners,1,Miami Marlins,12,4,April 18 2014,8
Atlanta Braves,0,New York Mets,6,6,April 18 2014,0
Houston Astros,1,Oakland Athletics,14,3,April 18 2014,11
Milwaukee Brewers,0,Pittsburgh Pirates,8,5,April 18 2014,3
San Francisco Giants,1,San Diego Padres,3,1,April 18 2014,2
New York Yankees,1,Tampa Bay Rays,16,5,April 18 2014,11
Chicago White Sox,1,Texas Rangers,12,0,April 18 2014,12
St. Louis Cardinals,1,Washington Nationals,4,1,April 18 2014,3
Baltimore Orioles,1,Boston Red Sox,6,2,April 19 2014,4
Cincinnati Reds,1,Chicago Cubs,12,4,April 19 2014,8
Toronto Blue Jays,0,Cleveland Indians,5,5,April 19 2014,0
Philadelphia Phillies,1,Colorado Rockies,4,1,April 19 2014,3
LA Angels of Anaheim,1,Detroit Tigers,7,2,April 19 2014,5
Minnesota Twins,1,Kansas City Royals,9,4,April 19 2014,5
Arizona D'Backs,1,Los Angeles Dodgers,14,6,April 19 2014,8
Seattle Mariners,1,Miami Marlins,7,0,April 19 2014,7
Atlanta Braves,0,New York Mets,12,7,April 19 2014,5
Houston Astros,1,Oakland Athletics,7,3,April 19 2014,4
Milwaukee Brewers,0,Pittsburgh Pirates,15,8,April 19 2014,7
San Francisco Giants,1,San Diego Padres,4,1,April 19 2014,3
New York Yankees,1,Tampa Bay Rays,17,1,April 19 2014,16
Chicago White Sox,1,Texas Rangers,9,3,April 19 2014,6
St. Louis Cardinals,0,Washington Nationals,7,4,April 19 2014,3
Baltimore Orioles,1,Boston Red Sox,11,5,April 20 2014,6
Cincinnati Reds,0,Chicago Cubs,10,8,April 20 2014,2
Toronto Blue Jays,1,Cleveland Indians,10,4,April 20 2014,6
Philadelphia Phillies,0,Colorado Rockies,19,10,April 20 2014,9
LA Angels of Anaheim,1,Detroit Tigers,3,1,April 20 2014,2
Minnesota Twins,0,Kansas City Royals,11,8,April 20 2014,3
Arizona D'Backs,1,Los Angeles Dodgers,5,1,April 20 2014,4
Seattle Mariners,1,Miami Marlins,5,2,April 20 2014,3
Atlanta Braves,1,New York Mets,7,3,April 20 2014,4
Houston Astros,1,Oakland Athletics,5,1,April 20 2014,4
Milwaukee Brewers,0,Pittsburgh Pirates,5,3,April 20 2014,2
San Francisco Giants,0,San Diego Padres,7,4,April 20 2014,3
New York Yankees,0,Tampa Bay Rays,6,5,April 20 2014,1
Chicago White Sox,0,Texas Rangers,18,16,April 20 2014,2
St. Louis Cardinals,1,Washington Nationals,5,2,April 20 2014,3
Miami Marlins,1,Atlanta Braves,6,2,April 21 2014,4
Baltimore Orioles,0,Boston Red Sox,13,7,April 21 2014,6
Arizona D'Backs,1,Chicago Cubs,6,1,April 21 2014,5
Kansas City Royals,1,Cleveland Indians,7,3,April 21 2014,4
San Francisco Giants,1,Colorado Rockies,10,2,April 21 2014,8
Chicago White Sox,0,Detroit Tigers,4,3,April 21 2014,1
Philadelphia Phillies,0,Los Angeles Dodgers,7,7,April 21 2014,0
San Diego Padres,1,Milwaukee Brewers,7,3,April 21 2014,4
St. Louis Cardinals,1,New York Mets,2,0,April 21 2014,2
Texas Rangers,0,Oakland Athletics,7,4,April 21 2014,3
Cincinnati Reds,1,Pittsburgh Pirates,11,5,April 21 2014,6
Houston Astros,0,Seattle Mariners,9,7,April 21 2014,2
LA Angels of Anaheim,0,Washington Nationals,6,4,April 21 2014,2
Miami Marlins,0,Atlanta Braves,1,1,April 22 2014,0
New York Yankees,0,Boston Red Sox,12,9,April 22 2014,3
Arizona D'Backs,1,Chicago Cubs,11,2,April 22 2014,9
Kansas City Royals,0,Cleveland Indians,10,8,April 22 2014,2
San Francisco Giants,1,Colorado Rockies,3,1,April 22 2014,2
Chicago White Sox,1,Detroit Tigers,14,6,April 22 2014,8
Philadelphia Phillies,0,Los Angeles Dodgers,5,3,April 22 2014,2
San Diego Padres,0,Milwaukee Brewers,3,2,April 22 2014,1
St. Louis Cardinals,0,New York Mets,3,3,April 22 2014,0
Texas Rangers,0,Oakland Athletics,9,5,April 22 2014,4
Cincinnati Reds,0,Pittsburgh Pirates,5,4,April 22 2014,1
Houston Astros,0,Seattle Mariners,7,5,April 22 2014,2
Minnesota Twins,1,Tampa Bay Rays,10,3,April 22 2014,7
Baltimore Orioles,1,Toronto Blue Jays,12,3,April 22 2014,9
LA Angels of Anaheim,0,Washington Nationals,9,7,April 22 2014,2
Miami Marlins,1,Atlanta Braves,4,1,April 23 2014,3
New York Yankees,1,Boston Red Sox,6,1,April 23 2014,5
Arizona D'Backs,0,Chicago Cubs,12,7,April 23 2014,5
Kansas City Royals,1,Cleveland Indians,8,3,April 23 2014,5
San Francisco Giants,0,Colorado Rockies,22,12,April 23 2014,10
Chicago White Sox,0,Detroit Tigers,10,6,April 23 2014,4
Philadelphia Phillies,1,Los Angeles Dodgers,7,2,April 23 2014,5
San Diego Padres,1,Milwaukee Brewers,7,2,April 23 2014,5
St. Louis Cardinals,1,New York Mets,5,2,April 23 2014,3
Texas Rangers,0,Oakland Athletics,3,3,April 23 2014,0
Cincinnati Reds,0,Pittsburgh Pirates,7,5,April 23 2014,2
Houston Astros,1,Seattle Mariners,8,3,April 23 2014,5
Minnesota Twins,0,Tampa Bay Rays,10,6,April 23 2014,4
Baltimore Orioles,0,Toronto Blue Jays,18,10,April 23 2014,8
LA Angels of Anaheim,1,Washington Nationals,9,4,April 23 2014,5
New York Yankees,0,Boston Red Sox,19,14,April 24 2014,5
Arizona D'Backs,0,Chicago Cubs,7,5,April 24 2014,2
Kansas City Royals,1,Cleveland Indians,6,1,April 24 2014,5
Chicago White Sox,1,Detroit Tigers,11,4,April 24 2014,7
Oakland Athletics,0,Houston Astros,11,10,April 24 2014,1
Philadelphia Phillies,0,Los Angeles Dodgers,10,7,April 24 2014,3
St. Louis Cardinals,1,New York Mets,5,1,April 24 2014,4
Cincinnati Reds,0,Pittsburgh Pirates,3,2,April 24 2014,1
Minnesota Twins,0,Tampa Bay Rays,16,9,April 24 2014,7
Baltimore Orioles,0,Toronto Blue Jays,15,11,April 24 2014,4
San Diego Padres,0,Washington Nationals,7,4,April 24 2014,3
Philadelphia Phillies,1,Arizona D'Backs,9,4,April 25 2014,5
Cincinnati Reds,1,Atlanta Braves,9,4,April 25 2014,5
Kansas City Royals,0,Baltimore Orioles,5,5,April 25 2014,0
Tampa Bay Rays,1,Chicago White Sox,15,6,April 25 2014,9
Oakland Athletics,0,Houston Astros,17,12,April 25 2014,5
Colorado Rockies,0,Los Angeles Dodgers,9,5,April 25 2014,4
Chicago Cubs,1,Milwaukee Brewers,7,2,April 25 2014,5
Detroit Tigers,0,Minnesota Twins,16,10,April 25 2014,6
LA Angels of Anaheim,0,New York Yankees,14,13,April 25 2014,1
Miami Marlins,1,New York Mets,7,3,April 25 2014,4
Texas Rangers,1,Seattle Mariners,11,5,April 25 2014,6
Cleveland Indians,1,San Francisco Giants,6,1,April 25 2014,5
Pittsburgh Pirates,1,St. Louis Cardinals,1,0,April 25 2014,1
Boston Red Sox,0,Toronto Blue Jays,9,8,April 25 2014,1
San Diego Padres,1,Washington Nationals,12,1,April 25 2014,11
Philadelphia Phillies,0,Arizona D'Backs,11,6,April 26 2014,5
Cincinnati Reds,1,Atlanta Braves,5,1,April 26 2014,4
Kansas City Royals,1,Baltimore Orioles,5,2,April 26 2014,3
Tampa Bay Rays,0,Chicago White Sox,4,4,April 26 2014,0
Oakland Athletics,1,Houston Astros,13,6,April 26 2014,7
Colorado Rockies,1,Los Angeles Dodgers,9,3,April 26 2014,6
Chicago Cubs,1,Milwaukee Brewers,8,3,April 26 2014,5
Detroit Tigers,1,Minnesota Twins,8,3,April 26 2014,5
LA Angels of Anaheim,1,New York Yankees,7,3,April 26 2014,4
Miami Marlins,0,New York Mets,13,7,April 26 2014,6
Texas Rangers,0,Seattle Mariners,9,6,April 26 2014,3
Cleveland Indians,1,San Francisco Giants,8,3,April 26 2014,5
Pittsburgh Pirates,0,St. Louis Cardinals,7,6,April 26 2014,1
Boston Red Sox,0,Toronto Blue Jays,13,7,April 26 2014,6
San Diego Padres,1,Washington Nationals,4,0,April 26 2014,4
Philadelphia Phillies,0,Arizona D'Backs,2,2,April 27 2014,0
Cincinnati Reds,1,Atlanta Braves,1,0,April 27 2014,1
Kansas City Royals,0,Baltimore Orioles,12,9,April 27 2014,3
Tampa Bay Rays,1,Chicago White Sox,11,2,April 27 2014,9
Oakland Athletics,1,Houston Astros,6,1,April 27 2014,5
Colorado Rockies,0,Los Angeles Dodgers,7,6,April 27 2014,1
Chicago Cubs,0,Milwaukee Brewers,4,4,April 27 2014,0
LA Angels of Anaheim,1,New York Yankees,5,2,April 27 2014,3
Miami Marlins,1,New York Mets,4,0,April 27 2014,4
Texas Rangers,1,Seattle Mariners,11,5,April 27 2014,6
Cleveland Indians,1,San Francisco Giants,5,1,April 27 2014,4
Pittsburgh Pirates,1,St. Louis Cardinals,7,0,April 27 2014,7
Boston Red Sox,1,Toronto Blue Jays,8,1,April 27 2014,7
San Diego Padres,0,Washington Nationals,6,4,April 27 2014,2
Cleveland Indians,1,LA Angels of Anaheim,9,3,April 28 2014,6
Colorado Rockies,0,Arizona D'Backs,13,8,April 28 2014,5
Tampa Bay Rays,1,Chicago White Sox,10,3,April 28 2014,7
San Diego Padres,0,San Francisco Giants,10,6,April 28 2014,4
Milwaukee Brewers,0,St. Louis Cardinals,8,5,April 28 2014,3
Oakland Athletics,0,Texas Rangers,4,4,April 28 2014,0
Cleveland Indians,1,LA Angels of Anaheim,10,4,April 29 2014,6
Colorado Rockies,0,Arizona D'Backs,9,5,April 29 2014,4
Tampa Bay Rays,1,Boston Red Sox,11,4,April 29 2014,7
Detroit Tigers,0,Chicago White Sox,7,4,April 29 2014,3
Chicago Cubs,1,Cincinnati Reds,5,2,April 29 2014,3
Washington Nationals,0,Houston Astros,7,4,April 29 2014,3
Toronto Blue Jays,1,Kansas City Royals,17,7,April 29 2014,10
Atlanta Braves,1,Miami Marlins,9,0,April 29 2014,9
Seattle Mariners,0,New York Yankees,9,6,April 29 2014,3
New York Mets,0,Philadelphia Phillies,7,6,April 29 2014,1
San Diego Padres,1,San Francisco Giants,6,0,April 29 2014,6
Milwaukee Brewers,0,St. Louis Cardinals,9,5,April 29 2014,4
Oakland Athletics,0,Texas Rangers,12,9,April 29 2014,3
Cleveland Indians,1,LA Angels of Anaheim,8,1,April 30 2014,7
Colorado Rockies,1,Arizona D'Backs,9,4,April 30 2014,5
Detroit Tigers,0,Chicago White Sox,6,5,April 30 2014,1
Chicago Cubs,0,Cincinnati Reds,13,9,April 30 2014,4
Washington Nationals,0,Houston Astros,7,7,April 30 2014,0
Toronto Blue Jays,1,Kansas City Royals,6,2,April 30 2014,4
Atlanta Braves,1,Miami Marlins,12,3,April 30 2014,9
Los Angeles Dodgers,0,Minnesota Twins,10,6,April 30 2014,4
San Diego Padres,1,San Francisco Giants,5,2,April 30 2014,3
Milwaukee Brewers,1,St. Louis Cardinals,12,3,April 30 2014,9
Oakland Athletics,0,Texas Rangers,13,12,April 30 2014,1
Pittsburgh Pirates,1,Baltimore Orioles,6,1,May 1 2014,5
Pittsburgh Pirates,1,Baltimore Orioles,11,5,May 1 2014,6
Tampa Bay Rays,0,Boston Red Sox,3,2,May 1 2014,1
Tampa Bay Rays,0,Boston Red Sox,11,6,May 1 2014,5
Milwaukee Brewers,1,Cincinnati Reds,11,3,May 1 2014,8
New York Mets,1,Colorado Rockies,11,4,May 1 2014,7
Toronto Blue Jays,0,Kansas City Royals,10,7,May 1 2014,3
Atlanta Braves,1,Miami Marlins,9,4,May 1 2014,5
Los Angeles Dodgers,0,Minnesota Twins,13,9,May 1 2014,4
Los Angeles Dodgers,0,Minnesota Twins,7,4,May 1 2014,3
Seattle Mariners,0,New York Yankees,6,4,May 1 2014,2
Texas Rangers,0,LA Angels of Anaheim,7,5,May 2 2014,2
San Francisco Giants,0,Atlanta Braves,3,2,May 2 2014,1
Oakland Athletics,1,Boston Red Sox,8,1,May 2 2014,7
St. Louis Cardinals,1,Chicago Cubs,11,5,May 2 2014,6
Milwaukee Brewers,0,Cincinnati Reds,2,2,May 2 2014,0
Chicago White Sox,1,Cleveland Indians,17,5,May 2 2014,12
New York Mets,1,Colorado Rockies,13,3,May 2 2014,10
Seattle Mariners,1,Houston Astros,9,4,May 2 2014,5
Detroit Tigers,0,Kansas City Royals,10,8,May 2 2014,2
Los Angeles Dodgers,1,Miami Marlins,9,3,May 2 2014,6
Baltimore Orioles,0,Minnesota Twins,3,3,May 2 2014,0
Tampa Bay Rays,0,New York Yankees,15,10,May 2 2014,5
Washington Nationals,0,Philadelphia Phillies,8,5,May 2 2014,3
Toronto Blue Jays,1,Pittsburgh Pirates,11,5,May 2 2014,6
Arizona D'Backs,0,San Diego Padres,2,2,May 2 2014,0
Texas Rangers,1,LA Angels of Anaheim,8,3,May 3 2014,5
San Francisco Giants,0,Atlanta Braves,4,3,May 3 2014,1
Oakland Athletics,1,Boston Red Sox,9,3,May 3 2014,6
St. Louis Cardinals,1,Chicago Cubs,3,0,May 3 2014,3
Milwaukee Brewers,1,Cincinnati Reds,8,2,May 3 2014,6
Chicago White Sox,1,Cleveland Indians,2,0,May 3 2014,2
New York Mets,1,Colorado Rockies,21,10,May 3 2014,11
Seattle Mariners,0,Houston Astros,17,9,May 3 2014,8
Detroit Tigers,0,Kansas City Royals,11,9,May 3 2014,2
Los Angeles Dodgers,0,Miami Marlins,16,9,May 3 2014,7
Baltimore Orioles,1,Minnesota Twins,7,1,May 3 2014,6
Tampa Bay Rays,1,New York Yankees,12,3,May 3 2014,9
Washington Nationals,1,Philadelphia Phillies,9,2,May 3 2014,7
Toronto Blue Jays,1,Pittsburgh Pirates,14,6,May 3 2014,8
Arizona D'Backs,0,San Diego Padres,7,4,May 3 2014,3
Texas Rangers,0,LA Angels of Anaheim,17,14,May 4 2014,3
San Francisco Giants,0,Atlanta Braves,5,4,May 4 2014,1
Oakland Athletics,0,Boston Red Sox,5,3,May 4 2014,2
St. Louis Cardinals,0,Chicago Cubs,9,5,May 4 2014,4
Milwaukee Brewers,1,Cincinnati Reds,7,3,May 4 2014,4
Chicago White Sox,0,Cleveland Indians,7,4,May 4 2014,3
New York Mets,0,Colorado Rockies,6,5,May 4 2014,1
Seattle Mariners,0,Houston Astros,15,8,May 4 2014,7
Detroit Tigers,0,Kansas City Royals,13,9,May 4 2014,4
Los Angeles Dodgers,1,Miami Marlins,9,4,May 4 2014,5
Baltimore Orioles,1,Minnesota Twins,7,2,May 4 2014,5
Tampa Bay Rays,0,New York Yankees,6,5,May 4 2014,1
Washington Nationals,1,Philadelphia Phillies,1,0,May 4 2014,1
Toronto Blue Jays,0,Pittsburgh Pirates,9,7,May 4 2014,2
Arizona D'Backs,1,San Diego Padres,7,3,May 4 2014,4
New York Yankees,1,LA Angels of Anaheim,5,1,May 5 2014,4
St. Louis Cardinals,0,Atlanta Braves,7,4,May 5 2014,3
Chicago White Sox,0,Chicago Cubs,4,3,May 5 2014,1
Minnesota Twins,0,Cleveland Indians,1,1,May 5 2014,0
Texas Rangers,1,Colorado Rockies,10,2,May 5 2014,8
Houston Astros,1,Detroit Tigers,2,0,May 5 2014,2
New York Mets,1,Miami Marlins,7,3,May 5 2014,4
Arizona D'Backs,1,Milwaukee Brewers,11,3,May 5 2014,8
Seattle Mariners,0,Oakland Athletics,6,4,May 5 2014,2
Toronto Blue Jays,0,Philadelphia Phillies,3,3,May 5 2014,0
San Francisco Giants,0,Pittsburgh Pirates,21,11,May 5 2014,10
Kansas City Royals,1,San Diego Padres,11,5,May 5 2014,6
Los Angeles Dodgers,1,Washington Nationals,4,0,May 5 2014,4
New York Yankees,0,LA Angels of Anaheim,7,4,May 6 2014,3
St. Louis Cardinals,1,Atlanta Braves,3,1,May 6 2014,2
Cincinnati Reds,1,Boston Red Sox,7,3,May 6 2014,4
Chicago White Sox,0,Chicago Cubs,6,5,May 6 2014,1
Minnesota Twins,1,Cleveland Indians,6,2,May 6 2014,4
Texas Rangers,1,Colorado Rockies,13,1,May 6 2014,12
Houston Astros,1,Detroit Tigers,15,4,May 6 2014,11
New York Mets,1,Miami Marlins,3,0,May 6 2014,3
Arizona D'Backs,0,Milwaukee Brewers,12,7,May 6 2014,5
Seattle Mariners,0,Oakland Athletics,11,8,May 6 2014,3
Toronto Blue Jays,0,Philadelphia Phillies,11,6,May 6 2014,5
San Francisco Giants,1,Pittsburgh Pirates,3,1,May 6 2014,2
Kansas City Royals,0,San Diego Padres,4,3,May 6 2014,1
Baltimore Orioles,0,Tampa Bay Rays,8,5,May 6 2014,3
Los Angeles Dodgers,0,Washington Nationals,11,8,May 6 2014,3
New York Yankees,0,LA Angels of Anaheim,11,9,May 7 2014,2
St. Louis Cardinals,0,Atlanta Braves,8,7,May 7 2014,1
Cincinnati Reds,1,Boston Red Sox,7,3,May 7 2014,4
Chicago Cubs,1,Chicago White Sox,11,3,May 7 2014,8
Minnesota Twins,1,Cleveland Indians,7,3,May 7 2014,4
Houston Astros,1,Detroit Tigers,5,2,May 7 2014,3
New York Mets,1,Miami Marlins,1,0,May 7 2014,1
Arizona D'Backs,0,Milwaukee Brewers,5,3,May 7 2014,2
Seattle Mariners,0,Oakland Athletics,10,6,May 7 2014,4
Seattle Mariners,1,Oakland Athletics,2,0,May 7 2014,2
San Francisco Giants,1,Pittsburgh Pirates,7,3,May 7 2014,4
Kansas City Royals,0,San Diego Padres,8,8,May 7 2014,0
Baltimore Orioles,0,Tampa Bay Rays,7,4,May 7 2014,3
Colorado Rockies,0,Texas Rangers,11,9,May 7 2014,2
Philadelphia Phillies,1,Toronto Blue Jays,10,0,May 7 2014,10
Los Angeles Dodgers,1,Washington Nationals,5,2,May 7 2014,3
Chicago Cubs,0,Chicago White Sox,17,12,May 8 2014,5
Minnesota Twins,1,Cleveland Indians,13,4,May 8 2014,9
Houston Astros,0,Detroit Tigers,8,6,May 8 2014,2
San Francisco Giants,0,Los Angeles Dodgers,4,3,May 8 2014,1
Miami Marlins,0,San Diego Padres,4,3,May 8 2014,1
Kansas City Royals,1,Seattle Mariners,1,0,May 8 2014,1
Baltimore Orioles,0,Tampa Bay Rays,4,3,May 8 2014,1
Colorado Rockies,1,Texas Rangers,5,0,May 8 2014,5
Philadelphia Phillies,1,Toronto Blue Jays,18,6,May 8 2014,12
Chicago Cubs,1,Atlanta Braves,5,2,May 9 2014,3
Houston Astros,1,Baltimore Orioles,7,3,May 9 2014,4
Arizona D'Backs,1,Chicago White Sox,12,3,May 9 2014,9
Colorado Rockies,1,Cincinnati Reds,7,3,May 9 2014,4
Minnesota Twins,0,Detroit Tigers,3,2,May 9 2014,1
San Francisco Giants,0,Los Angeles Dodgers,4,3,May 9 2014,1
New York Yankees,0,Milwaukee Brewers,8,5,May 9 2014,3
Philadelphia Phillies,0,New York Mets,5,3,May 9 2014,2
Washington Nationals,1,Oakland Athletics,8,0,May 9 2014,8
St. Louis Cardinals,1,Pittsburgh Pirates,10,4,May 9 2014,6
Miami Marlins,1,San Diego Padres,11,1,May 9 2014,10
Kansas City Royals,0,Seattle Mariners,7,6,May 9 2014,1
Cleveland Indians,0,Tampa Bay Rays,9,6,May 9 2014,3
Boston Red Sox,1,Texas Rangers,8,0,May 9 2014,8
LA Angels of Anaheim,0,Toronto Blue Jays,7,4,May 9 2014,3
Chicago Cubs,1,Atlanta Braves,2,0,May 10 2014,2
Houston Astros,1,Baltimore Orioles,9,4,May 10 2014,5
Arizona D'Backs,0,Chicago White Sox,7,4,May 10 2014,3
Colorado Rockies,0,Cincinnati Reds,13,11,May 10 2014,2
Minnesota Twins,1,Detroit Tigers,12,3,May 10 2014,9
San Francisco Giants,1,Los Angeles Dodgers,8,2,May 10 2014,6
New York Yankees,1,Milwaukee Brewers,9,4,May 10 2014,5
Philadelphia Phillies,0,New York Mets,9,5,May 10 2014,4
Washington Nationals,1,Oakland Athletics,7,3,May 10 2014,4
St. Louis Cardinals,1,Pittsburgh Pirates,7,3,May 10 2014,4
Miami Marlins,1,San Diego Padres,12,3,May 10 2014,9
Kansas City Royals,1,Seattle Mariners,4,1,May 10 2014,3
Cleveland Indians,1,Tampa Bay Rays,8,1,May 10 2014,7
Boston Red Sox,0,Texas Rangers,11,8,May 10 2014,3
LA Angels of Anaheim,0,Toronto Blue Jays,8,5,May 10 2014,3
Chicago Cubs,1,Atlanta Braves,7,2,May 11 2014,5
Houston Astros,0,Baltimore Orioles,7,5,May 11 2014,2
Arizona D'Backs,0,Chicago White Sox,6,5,May 11 2014,1
Colorado Rockies,1,Cincinnati Reds,5,1,May 11 2014,4
Minnesota Twins,0,Detroit Tigers,7,4,May 11 2014,3
San Francisco Giants,0,Los Angeles Dodgers,11,7,May 11 2014,4
New York Yankees,1,Milwaukee Brewers,11,5,May 11 2014,6
Philadelphia Phillies,1,New York Mets,9,4,May 11 2014,5
Washington Nationals,1,Oakland Athletics,10,1,May 11 2014,9
St. Louis Cardinals,0,Pittsburgh Pirates,11,6,May 11 2014,5
Miami Marlins,1,San Diego Padres,9,4,May 11 2014,5
Kansas City Royals,0,Seattle Mariners,16,9,May 11 2014,7
Cleveland Indians,0,Tampa Bay Rays,11,6,May 11 2014,5
Boston Red Sox,0,Texas Rangers,7,5,May 11 2014,2
LA Angels of Anaheim,0,Toronto Blue Jays,12,9,May 11 2014,3
Washington Nationals,0,Arizona D'Backs,11,6,May 12 2014,5
Detroit Tigers,0,Baltimore Orioles,5,4,May 12 2014,1
Texas Rangers,0,Houston Astros,4,4,May 12 2014,0
Miami Marlins,1,Los Angeles Dodgers,11,5,May 12 2014,6
New York Mets,0,New York Yankees,16,9,May 12 2014,7
Chicago White Sox,1,Oakland Athletics,9,4,May 12 2014,5
Tampa Bay Rays,1,Seattle Mariners,17,5,May 12 2014,12
Atlanta Braves,1,San Francisco Giants,6,2,May 12 2014,4
Chicago Cubs,0,St. Louis Cardinals,22,17,May 12 2014,5
LA Angels of Anaheim,1,Toronto Blue Jays,10,3,May 12 2014,7
Washington Nationals,1,Arizona D'Backs,4,1,May 13 2014,3
Detroit Tigers,0,Baltimore Orioles,5,4,May 13 2014,1
San Diego Padres,0,Cincinnati Reds,3,2,May 13 2014,1
Texas Rangers,1,Houston Astros,8,0,May 13 2014,8
Colorado Rockies,1,Kansas City Royals,6,1,May 13 2014,5
Miami Marlins,1,Los Angeles Dodgers,8,1,May 13 2014,7
Pittsburgh Pirates,1,Milwaukee Brewers,7,2,May 13 2014,5
Boston Red Sox,1,Minnesota Twins,14,6,May 13 2014,8
New York Mets,0,New York Yankees,19,12,May 13 2014,7
Chicago White Sox,1,Oakland Athletics,11,0,May 13 2014,11
LA Angels of Anaheim,0,Philadelphia Phillies,7,4,May 13 2014,3
Tampa Bay Rays,0,Seattle Mariners,3,2,May 13 2014,1
Atlanta Braves,0,San Francisco Giants,5,5,May 13 2014,0
Chicago Cubs,1,St. Louis Cardinals,7,3,May 13 2014,4
Cleveland Indians,1,Toronto Blue Jays,9,4,May 13 2014,5
Washington Nationals,0,Arizona D'Backs,6,5,May 14 2014,1
Detroit Tigers,0,Baltimore Orioles,12,7,May 14 2014,5
Texas Rangers,1,Houston Astros,9,4,May 14 2014,5
Colorado Rockies,1,Kansas City Royals,5,2,May 14 2014,3
Miami Marlins,0,Los Angeles Dodgers,16,13,May 14 2014,3
Pittsburgh Pirates,0,Milwaukee Brewers,5,4,May 14 2014,1
Boston Red Sox,0,Minnesota Twins,13,9,May 14 2014,4
New York Yankees,0,New York Mets,4,4,May 14 2014,0
Chicago White Sox,0,Oakland Athletics,6,4,May 14 2014,2
LA Angels of Anaheim,0,Philadelphia Phillies,3,3,May 14 2014,0
Tampa Bay Rays,0,Seattle Mariners,2,2,May 14 2014,0
Atlanta Braves,1,San Francisco Giants,14,4,May 14 2014,10
Cleveland Indians,0,Toronto Blue Jays,19,15,May 14 2014,4
Tampa Bay Rays,1,LA Angels of Anaheim,11,5,May 15 2014,6
San Diego Padres,1,Cincinnati Reds,5,0,May 15 2014,5
San Diego Padres,0,Cincinnati Reds,7,6,May 15 2014,1
Baltimore Orioles,0,Kansas City Royals,3,2,May 15 2014,1
Pittsburgh Pirates,1,Milwaukee Brewers,7,3,May 15 2014,4
Boston Red Sox,1,Minnesota Twins,7,3,May 15 2014,4
New York Yankees,0,New York Mets,1,1,May 15 2014,0
Miami Marlins,1,San Francisco Giants,10,4,May 15 2014,6
Chicago Cubs,1,St. Louis Cardinals,8,3,May 15 2014,5
Cleveland Indians,1,Toronto Blue Jays,6,2,May 15 2014,4
Tampa Bay Rays,0,LA Angels of Anaheim,3,3,May 16 2014,0
Los Angeles Dodgers,0,Arizona D'Backs,7,7,May 16 2014,0
Detroit Tigers,0,Boston Red Sox,1,1,May 16 2014,0
Milwaukee Brewers,0,Chicago Cubs,7,4,May 16 2014,3
Oakland Athletics,0,Cleveland Indians,12,11,May 16 2014,1
San Diego Padres,1,Colorado Rockies,4,1,May 16 2014,3
Chicago White Sox,0,Houston Astros,9,7,May 16 2014,2
Baltimore Orioles,0,Kansas City Royals,4,4,May 16 2014,0
Seattle Mariners,1,Minnesota Twins,9,4,May 16 2014,5
Cincinnati Reds,0,Philadelphia Phillies,3,3,May 16 2014,0
Miami Marlins,0,San Francisco Giants,12,7,May 16 2014,5
Atlanta Braves,1,St. Louis Cardinals,7,2,May 16 2014,5
Toronto Blue Jays,0,Texas Rangers,2,2,May 16 2014,0
New York Mets,1,Washington Nationals,7,2,May 16 2014,5
Tampa Bay Rays,1,LA Angels of Anaheim,6,0,May 17 2014,6
Los Angeles Dodgers,1,Arizona D'Backs,25,7,May 17 2014,18
Detroit Tigers,0,Boston Red Sox,7,6,May 17 2014,1
Milwaukee Brewers,1,Chicago Cubs,3,0,May 17 2014,3
Oakland Athletics,0,Cleveland Indians,8,6,May 17 2014,2
San Diego Padres,0,Colorado Rockies,13,8,May 17 2014,5
Chicago White Sox,1,Houston Astros,11,5,May 17 2014,6
Baltimore Orioles,1,Kansas City Royals,1,0,May 17 2014,1
Seattle Mariners,1,Minnesota Twins,7,3,May 17 2014,4
Pittsburgh Pirates,1,New York Yankees,8,1,May 17 2014,7
Cincinnati Reds,1,Philadelphia Phillies,13,1,May 17 2014,12
Miami Marlins,0,San Francisco Giants,5,5,May 17 2014,0
Atlanta Braves,1,St. Louis Cardinals,5,1,May 17 2014,4
Toronto Blue Jays,0,Texas Rangers,6,4,May 17 2014,2
New York Mets,0,Washington Nationals,7,5,May 17 2014,2
Tampa Bay Rays,1,LA Angels of Anaheim,8,2,May 18 2014,6
Los Angeles Dodgers,1,Arizona D'Backs,8,3,May 18 2014,5
Detroit Tigers,0,Boston Red Sox,8,6,May 18 2014,2
Milwaukee Brewers,1,Chicago Cubs,6,2,May 18 2014,4
Oakland Athletics,0,Cleveland Indians,16,13,May 18 2014,3
San Diego Padres,1,Colorado Rockies,14,6,May 18 2014,8
Chicago White Sox,1,Houston Astros,10,2,May 18 2014,8
Baltimore Orioles,1,Kansas City Royals,14,6,May 18 2014,8
Seattle Mariners,0,Minnesota Twins,8,6,May 18 2014,2
Pittsburgh Pirates,1,New York Yankees,7,3,May 18 2014,4
Pittsburgh Pirates,0,New York Yankees,8,5,May 18 2014,3
Cincinnati Reds,1,Philadelphia Phillies,11,3,May 18 2014,8
Miami Marlins,1,San Francisco Giants,5,1,May 18 2014,4
Atlanta Braves,0,St. Louis Cardinals,11,6,May 18 2014,5
Toronto Blue Jays,1,Texas Rangers,8,2,May 18 2014,6
New York Mets,1,Washington Nationals,9,3,May 18 2014,6
Houston Astros,0,LA Angels of Anaheim,7,5,May 19 2014,2
Milwaukee Brewers,1,Atlanta Braves,12,3,May 19 2014,9
Detroit Tigers,1,Cleveland Indians,9,4,May 19 2014,5
Chicago White Sox,0,Kansas City Royals,13,7,May 19 2014,6
Cincinnati Reds,0,Washington Nationals,7,4,May 19 2014,3
Houston Astros,1,LA Angels of Anaheim,12,3,May 20 2014,9
Milwaukee Brewers,1,Atlanta Braves,5,0,May 20 2014,5
Toronto Blue Jays,0,Boston Red Sox,11,7,May 20 2014,4
New York Yankees,1,Chicago Cubs,7,1,May 20 2014,6
Detroit Tigers,1,Cleveland Indians,8,2,May 20 2014,6
San Francisco Giants,1,Colorado Rockies,9,4,May 20 2014,5
Chicago White Sox,0,Kansas City Royals,13,7,May 20 2014,6
Philadelphia Phillies,0,Miami Marlins,11,6,May 20 2014,5
Los Angeles Dodgers,0,New York Mets,13,9,May 20 2014,4
Baltimore Orioles,0,Pittsburgh Pirates,11,9,May 20 2014,2
Minnesota Twins,0,San Diego Padres,8,5,May 20 2014,3
Arizona D'Backs,1,St. Louis Cardinals,5,0,May 20 2014,5
Oakland Athletics,0,Tampa Bay Rays,3,3,May 20 2014,0
Seattle Mariners,0,Texas Rangers,8,6,May 20 2014,2
Cincinnati Reds,1,Washington Nationals,13,4,May 20 2014,9
Houston Astros,1,LA Angels of Anaheim,3,1,May 21 2014,2
Milwaukee Brewers,0,Atlanta Braves,7,6,May 21 2014,1
Toronto Blue Jays,0,Boston Red Sox,10,6,May 21 2014,4
New York Yankees,0,Chicago Cubs,6,4,May 21 2014,2
Detroit Tigers,1,Cleveland Indians,21,10,May 21 2014,11
San Francisco Giants,0,Colorado Rockies,6,5,May 21 2014,1
Chicago White Sox,1,Kansas City Royals,4,1,May 21 2014,3
Philadelphia Phillies,1,Miami Marlins,19,5,May 21 2014,14
Los Angeles Dodgers,0,New York Mets,7,4,May 21 2014,3
Baltimore Orioles,1,Pittsburgh Pirates,17,8,May 21 2014,9
Minnesota Twins,0,San Diego Padres,2,2,May 21 2014,0
Arizona D'Backs,1,St. Louis Cardinals,5,2,May 21 2014,3
Oakland Athletics,0,Tampa Bay Rays,5,3,May 21 2014,2
Seattle Mariners,1,Texas Rangers,7,3,May 21 2014,4
Cincinnati Reds,0,Washington Nationals,3,2,May 21 2014,1
Milwaukee Brewers,1,Atlanta Braves,9,4,May 22 2014,5
Cleveland Indians,0,Baltimore Orioles,15,8,May 22 2014,7
Toronto Blue Jays,0,Boston Red Sox,9,7,May 22 2014,2
New York Yankees,1,Chicago White Sox,5,2,May 22 2014,3
San Francisco Giants,0,Colorado Rockies,6,4,May 22 2014,2
Texas Rangers,0,Detroit Tigers,11,9,May 22 2014,2
Philadelphia Phillies,1,Miami Marlins,7,3,May 22 2014,4
Los Angeles Dodgers,1,New York Mets,8,3,May 22 2014,5
Washington Nationals,1,Pittsburgh Pirates,4,1,May 22 2014,3
Chicago Cubs,0,San Diego Padres,6,5,May 22 2014,1
Houston Astros,1,Seattle Mariners,4,1,May 22 2014,3
Arizona D'Backs,1,St. Louis Cardinals,6,2,May 22 2014,4
Oakland Athletics,1,Tampa Bay Rays,7,2,May 22 2014,5
Kansas City Royals,1,LA Angels of Anaheim,7,1,May 23 2014,6
Colorado Rockies,1,Atlanta Braves,5,2,May 23 2014,3
Cleveland Indians,1,Baltimore Orioles,12,4,May 23 2014,8
New York Yankees,1,Chicago White Sox,11,5,May 23 2014,6
St. Louis Cardinals,1,Cincinnati Reds,8,3,May 23 2014,5
Texas Rangers,1,Detroit Tigers,9,2,May 23 2014,7
Milwaukee Brewers,0,Miami Marlins,14,9,May 23 2014,5
Los Angeles Dodgers,0,Philadelphia Phillies,2,2,May 23 2014,0
Washington Nationals,1,Pittsburgh Pirates,7,3,May 23 2014,4
Chicago Cubs,1,San Diego Padres,12,1,May 23 2014,11
Houston Astros,1,Seattle Mariners,7,1,May 23 2014,6
Minnesota Twins,1,San Francisco Giants,8,2,May 23 2014,6
Boston Red Sox,1,Tampa Bay Rays,1,0,May 23 2014,1
Oakland Athletics,1,Toronto Blue Jays,5,2,May 23 2014,3
Kansas City Royals,0,LA Angels of Anaheim,11,7,May 24 2014,4
Colorado Rockies,0,Atlanta Braves,4,3,May 24 2014,1
Cleveland Indians,0,Baltimore Orioles,9,9,May 24 2014,0
New York Yankees,0,Chicago White Sox,7,4,May 24 2014,3
St. Louis Cardinals,0,Cincinnati Reds,9,6,May 24 2014,3
Texas Rangers,0,Detroit Tigers,14,12,May 24 2014,2
Milwaukee Brewers,1,Miami Marlins,3,1,May 24 2014,2
Arizona D'Backs,0,New York Mets,5,3,May 24 2014,2
Los Angeles Dodgers,1,Philadelphia Phillies,8,3,May 24 2014,5
Washington Nationals,1,Pittsburgh Pirates,5,2,May 24 2014,3
Chicago Cubs,0,San Diego Padres,5,3,May 24 2014,2
Houston Astros,0,Seattle Mariners,13,9,May 24 2014,4
Minnesota Twins,1,San Francisco Giants,3,1,May 24 2014,2
Boston Red Sox,1,Tampa Bay Rays,11,5,May 24 2014,6
Oakland Athletics,1,Toronto Blue Jays,7,2,May 24 2014,5
Kansas City Royals,1,LA Angels of Anaheim,7,3,May 25 2014,4
Colorado Rockies,1,Atlanta Braves,7,0,May 25 2014,7
Cleveland Indians,1,Baltimore Orioles,6,2,May 25 2014,4
New York Yankees,0,Chicago White Sox,8,7,May 25 2014,1
St. Louis Cardinals,0,Cincinnati Reds,4,4,May 25 2014,0
Texas Rangers,0,Detroit Tigers,16,12,May 25 2014,4
Milwaukee Brewers,0,Miami Marlins,8,7,May 25 2014,1
Arizona D'Backs,0,New York Mets,3,2,May 25 2014,1
Arizona D'Backs,1,New York Mets,6,2,May 25 2014,4
Los Angeles Dodgers,0,Philadelphia Phillies,6,6,May 25 2014,0
Washington Nationals,0,Pittsburgh Pirates,7,5,May 25 2014,2
Chicago Cubs,1,San Diego Padres,7,3,May 25 2014,4
Houston Astros,0,Seattle Mariners,5,4,May 25 2014,1
Minnesota Twins,1,San Francisco Giants,9,1,May 25 2014,8
Boston Red Sox,1,Tampa Bay Rays,13,5,May 25 2014,8
Oakland Athletics,1,Toronto Blue Jays,4,1,May 25 2014,3
San Diego Padres,1,Arizona D'Backs,12,5,May 26 2014,7
Boston Red Sox,0,Atlanta Braves,14,8,May 26 2014,6
Cleveland Indians,1,Chicago White Sox,8,2,May 26 2014,6
Houston Astros,0,Kansas City Royals,11,9,May 26 2014,2
Cincinnati Reds,1,Los Angeles Dodgers,7,3,May 26 2014,4
Baltimore Orioles,0,Milwaukee Brewers,13,7,May 26 2014,6
Texas Rangers,0,Minnesota Twins,9,7,May 26 2014,2
Pittsburgh Pirates,0,New York Mets,8,5,May 26 2014,3
Detroit Tigers,1,Oakland Athletics,10,0,May 26 2014,10
Colorado Rockies,1,Philadelphia Phillies,9,0,May 26 2014,9
LA Angels of Anaheim,1,Seattle Mariners,6,1,May 26 2014,5
Chicago Cubs,0,San Francisco Giants,12,8,May 26 2014,4
New York Yankees,0,St. Louis Cardinals,10,6,May 26 2014,4
Tampa Bay Rays,1,Toronto Blue Jays,15,5,May 26 2014,10
Miami Marlins,0,Washington Nationals,5,3,May 26 2014,2
San Diego Padres,0,Arizona D'Backs,7,4,May 27 2014,3
Boston Red Sox,0,Atlanta Braves,9,6,May 27 2014,3
Cleveland Indians,1,Chicago White Sox,3,1,May 27 2014,2
Houston Astros,0,Kansas City Royals,3,3,May 27 2014,0
Cincinnati Reds,1,Los Angeles Dodgers,9,3,May 27 2014,6
Baltimore Orioles,1,Milwaukee Brewers,13,6,May 27 2014,7
Texas Rangers,1,Minnesota Twins,7,3,May 27 2014,4
Pittsburgh Pirates,1,New York Mets,6,2,May 27 2014,4
Detroit Tigers,0,Oakland Athletics,11,6,May 27 2014,5
Colorado Rockies,0,Philadelphia Phillies,8,6,May 27 2014,2
LA Angels of Anaheim,0,Seattle Mariners,10,6,May 27 2014,4
Chicago Cubs,1,San Francisco Giants,4,0,May 27 2014,4
New York Yankees,1,St. Louis Cardinals,6,0,May 27 2014,6
Tampa Bay Rays,1,Toronto Blue Jays,15,6,May 27 2014,9
San Diego Padres,1,Arizona D'Backs,18,6,May 28 2014,12
Atlanta Braves,1,Boston Red Sox,4,0,May 28 2014,4
Cleveland Indians,1,Chicago White Sox,5,2,May 28 2014,3
Houston Astros,0,Kansas City Royals,12,9,May 28 2014,3
Cincinnati Reds,0,Los Angeles Dodgers,5,3,May 28 2014,2
Baltimore Orioles,1,Milwaukee Brewers,11,3,May 28 2014,8
Texas Rangers,0,Minnesota Twins,1,1,May 28 2014,0
Pittsburgh Pirates,1,New York Mets,5,0,May 28 2014,5
Detroit Tigers,1,Oakland Athletics,4,1,May 28 2014,3
Colorado Rockies,1,Philadelphia Phillies,9,3,May 28 2014,6
LA Angels of Anaheim,1,Seattle Mariners,4,1,May 28 2014,3
Chicago Cubs,1,San Francisco Giants,5,0,May 28 2014,5
New York Yankees,0,St. Louis Cardinals,11,7,May 28 2014,4
Tampa Bay Rays,1,Toronto Blue Jays,5,2,May 28 2014,3
Miami Marlins,0,Washington Nationals,13,8,May 28 2014,5
Cincinnati Reds,1,Arizona D'Backs,4,0,May 29 2014,4
Atlanta Braves,1,Boston Red Sox,7,3,May 29 2014,4
Baltimore Orioles,1,Houston Astros,4,1,May 29 2014,3
Pittsburgh Pirates,0,Los Angeles Dodgers,9,6,May 29 2014,3
Texas Rangers,0,Minnesota Twins,9,5,May 29 2014,4
Detroit Tigers,0,Oakland Athletics,9,5,May 29 2014,4
New York Mets,0,Philadelphia Phillies,5,4,May 29 2014,1
LA Angels of Anaheim,0,Seattle Mariners,12,7,May 29 2014,5
San Francisco Giants,0,St. Louis Cardinals,11,6,May 29 2014,5
Kansas City Royals,0,Toronto Blue Jays,14,8,May 29 2014,6
Cincinnati Reds,0,Arizona D'Backs,10,6,May 30 2014,4
Tampa Bay Rays,1,Boston Red Sox,5,2,May 30 2014,3
San Diego Padres,0,Chicago White Sox,5,4,May 30 2014,1
Colorado Rockies,1,Cleveland Indians,7,2,May 30 2014,5
Baltimore Orioles,1,Houston Astros,3,1,May 30 2014,2
Pittsburgh Pirates,0,Los Angeles Dodgers,3,2,May 30 2014,1
Atlanta Braves,0,Miami Marlins,5,3,May 30 2014,2
Chicago Cubs,1,Milwaukee Brewers,16,5,May 30 2014,11
Minnesota Twins,0,New York Yankees,7,6,May 30 2014,1
LA Angels of Anaheim,1,Oakland Athletics,14,5,May 30 2014,9
New York Mets,1,Philadelphia Phillies,11,5,May 30 2014,6
Detroit Tigers,0,Seattle Mariners,9,6,May 30 2014,3
San Francisco Giants,0,St. Louis Cardinals,13,9,May 30 2014,4
Kansas City Royals,0,Toronto Blue Jays,7,6,May 30 2014,1
Texas Rangers,1,Washington Nationals,11,2,May 30 2014,9
Cincinnati Reds,0,Arizona D'Backs,5,5,May 31 2014,0
Tampa Bay Rays,1,Boston Red Sox,8,1,May 31 2014,7
San Diego Padres,0,Chicago White Sox,6,4,May 31 2014,2
Colorado Rockies,1,Cleveland Indians,13,6,May 31 2014,7
Baltimore Orioles,0,Houston Astros,5,4,May 31 2014,1
Pittsburgh Pirates,1,Los Angeles Dodgers,14,2,May 31 2014,12
Atlanta Braves,0,Miami Marlins,14,9,May 31 2014,5
Chicago Cubs,0,Milwaukee Brewers,8,8,May 31 2014,0
Minnesota Twins,1,New York Yankees,4,1,May 31 2014,3
LA Angels of Anaheim,1,Oakland Athletics,14,3,May 31 2014,11
New York Mets,0,Philadelphia Phillies,9,5,May 31 2014,4
Detroit Tigers,1,Seattle Mariners,5,2,May 31 2014,3
San Francisco Giants,1,St. Louis Cardinals,2,0,May 31 2014,2
Kansas City Royals,1,Toronto Blue Jays,14,2,May 31 2014,12
Texas Rangers,1,Washington Nationals,12,2,May 31 2014,10
Cincinnati Reds,0,Arizona D'Backs,7,4,June 1 2014,3
Tampa Bay Rays,1,Boston Red Sox,4,0,June 1 2014,4
San Diego Padres,1,Chicago White Sox,5,1,June 1 2014,4
Colorado Rockies,1,Cleveland Indians,10,4,June 1 2014,6
Baltimore Orioles,0,Houston Astros,13,9,June 1 2014,4
Pittsburgh Pirates,0,Los Angeles Dodgers,8,5,June 1 2014,3
Atlanta Braves,0,Miami Marlins,6,4,June 1 2014,2
Chicago Cubs,1,Milwaukee Brewers,9,0,June 1 2014,9
Minnesota Twins,0,New York Yankees,9,7,June 1 2014,2
LA Angels of Anaheim,1,Oakland Athletics,9,3,June 1 2014,6
New York Mets,0,Philadelphia Phillies,7,4,June 1 2014,3
Detroit Tigers,1,Seattle Mariners,4,0,June 1 2014,4
San Francisco Giants,0,St. Louis Cardinals,8,8,June 1 2014,0
Kansas City Royals,1,Toronto Blue Jays,4,0,June 1 2014,4
Texas Rangers,0,Washington Nationals,2,2,June 1 2014,0
Boston Red Sox,1,Cleveland Indians,5,2,June 2 2014,3
Chicago White Sox,1,Los Angeles Dodgers,7,2,June 2 2014,5
Tampa Bay Rays,1,Miami Marlins,4,1,June 2 2014,3
Minnesota Twins,1,Milwaukee Brewers,8,2,June 2 2014,6
Seattle Mariners,0,New York Yankees,12,10,June 2 2014,2
New York Mets,0,Philadelphia Phillies,13,11,June 2 2014,2
Pittsburgh Pirates,0,San Diego Padres,13,10,June 2 2014,3
Kansas City Royals,0,St. Louis Cardinals,6,6,June 2 2014,0
Seattle Mariners,0,Atlanta Braves,12,7,June 3 2014,5
New York Mets,1,Chicago Cubs,3,1,June 3 2014,2
San Francisco Giants,1,Cincinnati Reds,11,3,June 3 2014,8
Boston Red Sox,1,Cleveland Indians,8,3,June 3 2014,5
Arizona D'Backs,0,Colorado Rockies,6,4,June 3 2014,2
Toronto Blue Jays,0,Detroit Tigers,8,5,June 3 2014,3
LA Angels of Anaheim,1,Houston Astros,9,2,June 3 2014,7
Chicago White Sox,0,Los Angeles Dodgers,5,4,June 3 2014,1
Tampa Bay Rays,1,Miami Marlins,1,0,June 3 2014,1
Minnesota Twins,0,Milwaukee Brewers,10,6,June 3 2014,4
Oakland Athletics,0,New York Yankees,7,5,June 3 2014,2
Pittsburgh Pirates,0,San Diego Padres,5,4,June 3 2014,1
Kansas City Royals,0,St. Louis Cardinals,15,8,June 3 2014,7
Baltimore Orioles,0,Texas Rangers,11,8,June 3 2014,3
Philadelphia Phillies,1,Washington Nationals,7,0,June 3 2014,7
Seattle Mariners,0,Atlanta Braves,2,2,June 4 2014,0
New York Mets,1,Chicago Cubs,9,4,June 4 2014,5
San Francisco Giants,0,Cincinnati Reds,5,3,June 4 2014,2
Boston Red Sox,1,Cleveland Indians,11,4,June 4 2014,7
Arizona D'Backs,0,Colorado Rockies,24,16,June 4 2014,8
Toronto Blue Jays,0,Detroit Tigers,10,8,June 4 2014,2
LA Angels of Anaheim,0,Houston Astros,4,4,June 4 2014,0
St. Louis Cardinals,0,Kansas City Royals,7,5,June 4 2014,2
Chicago White Sox,0,Los Angeles Dodgers,3,2,June 4 2014,1
Milwaukee Brewers,1,Minnesota Twins,10,4,June 4 2014,6
Oakland Athletics,0,New York Yankees,11,7,June 4 2014,4
Pittsburgh Pirates,1,San Diego Padres,5,2,June 4 2014,3
Miami Marlins,0,Tampa Bay Rays,9,5,June 4 2014,4
Baltimore Orioles,0,Texas Rangers,11,6,June 4 2014,5
Philadelphia Phillies,1,Washington Nationals,12,4,June 4 2014,8
New York Mets,1,Chicago Cubs,11,4,June 5 2014,7
San Francisco Giants,0,Cincinnati Reds,7,6,June 5 2014,1
Arizona D'Backs,0,Colorado Rockies,19,12,June 5 2014,7
Toronto Blue Jays,0,Detroit Tigers,10,7,June 5 2014,3
LA Angels of Anaheim,1,Houston Astros,13,5,June 5 2014,8
St. Louis Cardinals,1,Kansas City Royals,5,2,June 5 2014,3
Milwaukee Brewers,0,Minnesota Twins,13,8,June 5 2014,5
Oakland Athletics,1,New York Yankees,3,1,June 5 2014,2
Miami Marlins,0,Tampa Bay Rays,17,11,June 5 2014,6
Baltimore Orioles,1,Texas Rangers,14,6,June 5 2014,8
Philadelphia Phillies,1,Washington Nationals,6,2,June 5 2014,4
Chicago White Sox,1,LA Angels of Anaheim,12,4,June 6 2014,8
Atlanta Braves,0,Arizona D'Backs,7,5,June 6 2014,2
Oakland Athletics,0,Baltimore Orioles,7,4,June 6 2014,3
Miami Marlins,1,Chicago Cubs,8,3,June 6 2014,5
Philadelphia Phillies,0,Cincinnati Reds,8,8,June 6 2014,0
Los Angeles Dodgers,0,Colorado Rockies,9,7,June 6 2014,2
Boston Red Sox,1,Detroit Tigers,8,2,June 6 2014,6
New York Yankees,0,Kansas City Royals,6,4,June 6 2014,2
Houston Astros,0,Minnesota Twins,9,5,June 6 2014,4
Milwaukee Brewers,1,Pittsburgh Pirates,20,5,June 6 2014,15
Washington Nationals,0,San Diego Padres,6,6,June 6 2014,0
New York Mets,1,San Francisco Giants,6,2,June 6 2014,4
Seattle Mariners,1,Tampa Bay Rays,4,0,June 6 2014,4
Cleveland Indians,1,Texas Rangers,10,4,June 6 2014,6
St. Louis Cardinals,1,Toronto Blue Jays,4,1,June 6 2014,3
Chicago White Sox,1,LA Angels of Anaheim,11,5,June 7 2014,6
Atlanta Braves,1,Arizona D'Backs,7,3,June 7 2014,4
Oakland Athletics,1,Baltimore Orioles,9,3,June 7 2014,6
Miami Marlins,1,Chicago Cubs,7,2,June 7 2014,5
Philadelphia Phillies,1,Cincinnati Reds,11,5,June 7 2014,6
Los Angeles Dodgers,1,Colorado Rockies,9,4,June 7 2014,5
Boston Red Sox,1,Detroit Tigers,14,6,June 7 2014,8
New York Yankees,1,Kansas City Royals,12,4,June 7 2014,8
Houston Astros,1,Minnesota Twins,8,0,June 7 2014,8
Milwaukee Brewers,0,Pittsburgh Pirates,12,9,June 7 2014,3
Washington Nationals,1,San Diego Padres,7,3,June 7 2014,4
New York Mets,1,San Francisco Giants,9,4,June 7 2014,5
Seattle Mariners,0,Tampa Bay Rays,11,7,June 7 2014,4
Cleveland Indians,0,Texas Rangers,11,8,June 7 2014,3
St. Louis Cardinals,0,Toronto Blue Jays,5,5,June 7 2014,0
Chicago White Sox,1,LA Angels of Anaheim,6,2,June 8 2014,4
Atlanta Braves,1,Arizona D'Backs,11,5,June 8 2014,6
Oakland Athletics,0,Baltimore Orioles,12,11,June 8 2014,1
Miami Marlins,0,Chicago Cubs,7,4,June 8 2014,3
Philadelphia Phillies,1,Cincinnati Reds,5,1,June 8 2014,4
Los Angeles Dodgers,0,Colorado Rockies,7,6,June 8 2014,1
Boston Red Sox,0,Detroit Tigers,8,5,June 8 2014,3
New York Yankees,1,Kansas City Royals,3,1,June 8 2014,2
Houston Astros,0,Minnesota Twins,19,14,June 8 2014,5
Milwaukee Brewers,0,Pittsburgh Pirates,1,1,June 8 2014,0
Washington Nationals,0,San Diego Padres,6,6,June 8 2014,0
New York Mets,1,San Francisco Giants,10,4,June 8 2014,6
Seattle Mariners,0,Tampa Bay Rays,5,5,June 8 2014,0
Cleveland Indians,0,Texas Rangers,5,3,June 8 2014,2
St. Louis Cardinals,0,Toronto Blue Jays,5,5,June 8 2014,0
Oakland Athletics,1,LA Angels of Anaheim,5,1,June 9 2014,4
Houston Astros,0,Arizona D'Backs,7,4,June 9 2014,3
Boston Red Sox,1,Baltimore Orioles,4,0,June 9 2014,4
Detroit Tigers,1,Chicago White Sox,11,5,June 9 2014,6
Los Angeles Dodgers,0,Cincinnati Reds,8,6,June 9 2014,2
Atlanta Braves,0,Colorado Rockies,4,3,June 9 2014,1
Chicago Cubs,1,Pittsburgh Pirates,8,2,June 9 2014,6
Washington Nationals,0,San Francisco Giants,11,9,June 9 2014,2
Seattle Mariners,0,Tampa Bay Rays,3,3,June 9 2014,0
Cleveland Indians,0,Texas Rangers,24,17,June 9 2014,7
Minnesota Twins,1,Toronto Blue Jays,9,4,June 9 2014,5
Oakland Athletics,1,LA Angels of Anaheim,3,1,June 10 2014,2
Houston Astros,1,Arizona D'Backs,5,1,June 10 2014,4
Boston Red Sox,0,Baltimore Orioles,1,1,June 10 2014,0
Los Angeles Dodgers,0,Cincinnati Reds,7,6,June 10 2014,1
Atlanta Braves,0,Colorado Rockies,23,13,June 10 2014,10
Cleveland Indians,1,Kansas City Royals,14,5,June 10 2014,9
Milwaukee Brewers,1,New York Mets,8,2,June 10 2014,6
San Diego Padres,1,Philadelphia Phillies,7,2,June 10 2014,5
Chicago Cubs,0,Pittsburgh Pirates,10,7,June 10 2014,3
New York Yankees,0,Seattle Mariners,5,3,June 10 2014,2
Washington Nationals,0,San Francisco Giants,3,2,June 10 2014,1
St. Louis Cardinals,0,Tampa Bay Rays,1,1,June 10 2014,0
Miami Marlins,0,Texas Rangers,13,8,June 10 2014,5
Minnesota Twins,0,Toronto Blue Jays,4,4,June 10 2014,0
Oakland Athletics,0,LA Angels of Anaheim,8,7,June 11 2014,1
Boston Red Sox,1,Baltimore Orioles,6,0,June 11 2014,6
Detroit Tigers,1,Chicago White Sox,10,2,June 11 2014,8
Los Angeles Dodgers,1,Cincinnati Reds,5,0,June 11 2014,5
Atlanta Braves,1,Colorado Rockies,10,2,June 11 2014,8
Arizona D'Backs,1,Houston Astros,6,1,June 11 2014,5
Cleveland Indians,1,Kansas City Royals,5,1,June 11 2014,4
Milwaukee Brewers,0,New York Mets,4,3,June 11 2014,1
San Diego Padres,1,Philadelphia Phillies,3,0,June 11 2014,3
Chicago Cubs,1,Pittsburgh Pirates,6,2,June 11 2014,4
New York Yankees,0,Seattle Mariners,6,4,June 11 2014,2
Washington Nationals,0,San Francisco Giants,8,6,June 11 2014,2
St. Louis Cardinals,1,Tampa Bay Rays,9,3,June 11 2014,6
Miami Marlins,1,Texas Rangers,6,0,June 11 2014,6
Minnesota Twins,0,Toronto Blue Jays,9,7,June 11 2014,2
Toronto Blue Jays,1,Baltimore Orioles,6,2,June 12 2014,4
Cleveland Indians,1,Boston Red Sox,7,2,June 12 2014,5
Detroit Tigers,0,Chicago White Sox,4,4,June 12 2014,0
Los Angeles Dodgers,1,Cincinnati Reds,5,1,June 12 2014,4
Atlanta Braves,1,Colorado Rockies,13,3,June 12 2014,10
Arizona D'Backs,1,Houston Astros,9,4,June 12 2014,5
Milwaukee Brewers,0,New York Mets,6,5,June 12 2014,1
San Diego Padres,1,Philadelphia Phillies,10,3,June 12 2014,7
Chicago Cubs,1,Pittsburgh Pirates,4,0,June 12 2014,4
New York Yankees,0,Seattle Mariners,9,6,June 12 2014,3
Washington Nationals,1,San Francisco Giants,8,1,June 12 2014,7
LA Angels of Anaheim,1,Atlanta Braves,7,3,June 13 2014,4
Toronto Blue Jays,0,Baltimore Orioles,4,4,June 13 2014,0
Cleveland Indians,1,Boston Red Sox,13,3,June 13 2014,10
Kansas City Royals,0,Chicago White Sox,9,7,June 13 2014,2
Minnesota Twins,0,Detroit Tigers,2,2,June 13 2014,0
Tampa Bay Rays,0,Houston Astros,7,6,June 13 2014,1
Arizona D'Backs,1,Los Angeles Dodgers,7,3,June 13 2014,4
Pittsburgh Pirates,0,Miami Marlins,14,8,June 13 2014,6
Cincinnati Reds,0,Milwaukee Brewers,11,6,June 13 2014,5
San Diego Padres,1,New York Mets,8,2,June 13 2014,6
New York Yankees,0,Oakland Athletics,7,7,June 13 2014,0
Chicago Cubs,0,Philadelphia Phillies,3,2,June 13 2014,1
Texas Rangers,0,Seattle Mariners,1,1,June 13 2014,0
Colorado Rockies,0,San Francisco Giants,11,7,June 13 2014,4
Washington Nationals,1,St. Louis Cardinals,1,0,June 13 2014,1
LA Angels of Anaheim,0,Atlanta Braves,17,11,June 14 2014,6
Toronto Blue Jays,1,Baltimore Orioles,5,2,June 14 2014,3
Cleveland Indians,0,Boston Red Sox,5,3,June 14 2014,2
Kansas City Royals,0,Chicago White Sox,10,9,June 14 2014,1
Minnesota Twins,1,Detroit Tigers,21,9,June 14 2014,12
Tampa Bay Rays,1,Houston Astros,10,3,June 14 2014,7
Arizona D'Backs,1,Los Angeles Dodgers,10,4,June 14 2014,6
Pittsburgh Pirates,0,Miami Marlins,14,8,June 14 2014,6
Cincinnati Reds,1,Milwaukee Brewers,6,2,June 14 2014,4
San Diego Padres,0,New York Mets,5,5,June 14 2014,0
New York Yankees,1,Oakland Athletics,6,1,June 14 2014,5
Chicago Cubs,1,Philadelphia Phillies,11,4,June 14 2014,7
Texas Rangers,0,Seattle Mariners,7,4,June 14 2014,3
Colorado Rockies,0,San Francisco Giants,9,5,June 14 2014,4
Washington Nationals,1,St. Louis Cardinals,5,1,June 14 2014,4
LA Angels of Anaheim,1,Atlanta Braves,10,3,June 15 2014,7
Toronto Blue Jays,0,Baltimore Orioles,7,5,June 15 2014,2
Cleveland Indians,0,Boston Red Sox,5,3,June 15 2014,2
Kansas City Royals,0,Chicago White Sox,9,6,June 15 2014,3
Minnesota Twins,1,Detroit Tigers,7,3,June 15 2014,4
Tampa Bay Rays,0,Houston Astros,7,4,June 15 2014,3
Arizona D'Backs,0,Los Angeles Dodgers,9,6,June 15 2014,3
Pittsburgh Pirates,1,Miami Marlins,5,2,June 15 2014,3
Cincinnati Reds,0,Milwaukee Brewers,17,13,June 15 2014,4
San Diego Padres,1,New York Mets,4,1,June 15 2014,3
New York Yankees,1,Oakland Athletics,15,5,June 15 2014,10
Chicago Cubs,0,Philadelphia Phillies,3,3,June 15 2014,0
Texas Rangers,1,Seattle Mariners,6,1,June 15 2014,5
Colorado Rockies,0,San Francisco Giants,15,8,June 15 2014,7
Washington Nationals,1,St. Louis Cardinals,7,2,June 15 2014,5
Milwaukee Brewers,0,Arizona D'Backs,12,9,June 16 2014,3
Philadelphia Phillies,0,Atlanta Braves,7,6,June 16 2014,1
Minnesota Twins,1,Boston Red Sox,1,0,June 16 2014,1
LA Angels of Anaheim,1,Cleveland Indians,7,3,June 16 2014,4
Kansas City Royals,0,Detroit Tigers,19,11,June 16 2014,8
Colorado Rockies,1,Los Angeles Dodgers,7,1,June 16 2014,6
Chicago Cubs,0,Miami Marlins,9,5,June 16 2014,4
Texas Rangers,0,Oakland Athletics,22,14,June 16 2014,8
San Diego Padres,1,Seattle Mariners,6,1,June 16 2014,5
New York Mets,1,St. Louis Cardinals,8,2,June 16 2014,6
Baltimore Orioles,1,Tampa Bay Rays,9,4,June 16 2014,5
Milwaukee Brewers,0,Arizona D'Backs,12,7,June 17 2014,5
Philadelphia Phillies,0,Atlanta Braves,7,5,June 17 2014,2
Minnesota Twins,1,Boston Red Sox,3,1,June 17 2014,2
San Francisco Giants,1,Chicago White Sox,10,2,June 17 2014,8
LA Angels of Anaheim,0,Cleveland Indians,12,9,June 17 2014,3
Kansas City Royals,0,Detroit Tigers,15,11,June 17 2014,4
Colorado Rockies,1,Los Angeles Dodgers,6,2,June 17 2014,4
Chicago Cubs,1,Miami Marlins,11,5,June 17 2014,6
Toronto Blue Jays,1,New York Yankees,4,1,June 17 2014,3
Texas Rangers,1,Oakland Athletics,16,6,June 17 2014,10
Cincinnati Reds,0,Pittsburgh Pirates,11,6,June 17 2014,5
San Diego Padres,1,Seattle Mariners,7,1,June 17 2014,6
New York Mets,1,St. Louis Cardinals,7,2,June 17 2014,5
Baltimore Orioles,0,Tampa Bay Rays,12,7,June 17 2014,5
Houston Astros,1,Washington Nationals,11,5,June 17 2014,6
Milwaukee Brewers,1,Arizona D'Backs,7,3,June 18 2014,4
Philadelphia Phillies,0,Atlanta Braves,15,10,June 18 2014,5
Minnesota Twins,1,Boston Red Sox,3,1,June 18 2014,2
San Francisco Giants,1,Chicago White Sox,13,6,June 18 2014,7
Kansas City Royals,0,Detroit Tigers,3,2,June 18 2014,1
Colorado Rockies,1,Los Angeles Dodgers,8,0,June 18 2014,8
Chicago Cubs,0,Miami Marlins,7,6,June 18 2014,1
Toronto Blue Jays,1,New York Yankees,10,3,June 18 2014,7
Texas Rangers,1,Oakland Athletics,6,2,June 18 2014,4
Cincinnati Reds,0,Pittsburgh Pirates,15,11,June 18 2014,4
Seattle Mariners,1,San Diego Padres,3,1,June 18 2014,2
New York Mets,0,St. Louis Cardinals,5,3,June 18 2014,2
Baltimore Orioles,0,Tampa Bay Rays,2,2,June 18 2014,0
Houston Astros,1,Washington Nationals,11,5,June 18 2014,6
Milwaukee Brewers,0,Arizona D'Backs,5,4,June 19 2014,1
LA Angels of Anaheim,1,Cleveland Indians,8,3,June 19 2014,5
Kansas City Royals,1,Detroit Tigers,3,1,June 19 2014,2
New York Mets,0,Miami Marlins,1,1,June 19 2014,0
Chicago White Sox,1,Minnesota Twins,6,2,June 19 2014,4
Toronto Blue Jays,1,New York Yankees,10,4,June 19 2014,6
Boston Red Sox,1,Oakland Athletics,6,2,June 19 2014,4
Cincinnati Reds,1,Pittsburgh Pirates,7,3,June 19 2014,4
Seattle Mariners,1,San Diego Padres,5,1,June 19 2014,4
Philadelphia Phillies,0,St. Louis Cardinals,5,4,June 19 2014,1
Houston Astros,1,Tampa Bay Rays,5,0,June 19 2014,5
Atlanta Braves,0,Washington Nationals,3,3,June 19 2014,0
Texas Rangers,1,LA Angels of Anaheim,10,3,June 20 2014,7
San Francisco Giants,1,Arizona D'Backs,5,1,June 20 2014,4
Pittsburgh Pirates,1,Chicago Cubs,9,3,June 20 2014,6
Toronto Blue Jays,0,Cincinnati Reds,23,14,June 20 2014,9
Detroit Tigers,0,Cleveland Indians,10,6,June 20 2014,4
Milwaukee Brewers,0,Colorado Rockies,23,13,June 20 2014,10
Seattle Mariners,0,Kansas City Royals,12,7,June 20 2014,5
New York Mets,1,Miami Marlins,5,2,June 20 2014,3
Chicago White Sox,1,Minnesota Twins,9,4,June 20 2014,5
Baltimore Orioles,1,New York Yankees,8,3,June 20 2014,5
Boston Red Sox,1,Oakland Athletics,7,3,June 20 2014,4
Los Angeles Dodgers,1,San Diego Padres,11,5,June 20 2014,6
Philadelphia Phillies,0,St. Louis Cardinals,6,5,June 20 2014,1
Houston Astros,0,Tampa Bay Rays,4,3,June 20 2014,1
Atlanta Braves,0,Washington Nationals,10,6,June 20 2014,4
Texas Rangers,1,LA Angels of Anaheim,5,2,June 21 2014,3
San Francisco Giants,0,Arizona D'Backs,10,6,June 21 2014,4
Pittsburgh Pirates,0,Chicago Cubs,8,5,June 21 2014,3
Toronto Blue Jays,1,Cincinnati Reds,12,1,June 21 2014,11
Detroit Tigers,0,Cleveland Indians,9,5,June 21 2014,4
Milwaukee Brewers,0,Colorado Rockies,13,9,June 21 2014,4
Seattle Mariners,0,Kansas City Royals,3,2,June 21 2014,1
New York Mets,0,Miami Marlins,4,4,June 21 2014,0
Chicago White Sox,1,Minnesota Twins,7,3,June 21 2014,4
Baltimore Orioles,0,New York Yankees,7,6,June 21 2014,1
Boston Red Sox,1,Oakland Athletics,3,1,June 21 2014,2
Los Angeles Dodgers,0,San Diego Padres,6,4,June 21 2014,2
Philadelphia Phillies,1,St. Louis Cardinals,5,1,June 21 2014,4
Houston Astros,1,Tampa Bay Rays,8,0,June 21 2014,8
Atlanta Braves,1,Washington Nationals,3,0,June 21 2014,3
Texas Rangers,1,LA Angels of Anaheim,7,2,June 22 2014,5
San Francisco Giants,0,Arizona D'Backs,5,4,June 22 2014,1
Pittsburgh Pirates,0,Chicago Cubs,3,2,June 22 2014,1
Toronto Blue Jays,1,Cincinnati Reds,7,3,June 22 2014,4
Detroit Tigers,0,Cleveland Indians,14,10,June 22 2014,4
Milwaukee Brewers,0,Colorado Rockies,11,6,June 22 2014,5
Seattle Mariners,0,Kansas City Royals,3,2,June 22 2014,1
New York Mets,0,Miami Marlins,16,11,June 22 2014,5
Chicago White Sox,1,Minnesota Twins,11,5,June 22 2014,6
Baltimore Orioles,0,New York Yankees,8,8,June 22 2014,0
Boston Red Sox,0,Oakland Athletics,13,7,June 22 2014,6
Los Angeles Dodgers,0,San Diego Padres,3,2,June 22 2014,1
Philadelphia Phillies,1,St. Louis Cardinals,8,3,June 22 2014,5
Houston Astros,1,Tampa Bay Rays,7,2,June 22 2014,5
Atlanta Braves,1,Washington Nationals,5,1,June 22 2014,4
Chicago White Sox,1,Baltimore Orioles,10,4,June 23 2014,6
Cincinnati Reds,0,Chicago Cubs,7,6,June 23 2014,1
St. Louis Cardinals,0,Colorado Rockies,8,8,June 23 2014,0
Los Angeles Dodgers,1,Kansas City Royals,8,3,June 23 2014,5
Washington Nationals,0,Milwaukee Brewers,3,3,June 23 2014,0
Miami Marlins,0,Philadelphia Phillies,4,4,June 23 2014,0
Boston Red Sox,1,Seattle Mariners,15,3,June 23 2014,12
San Diego Padres,0,San Francisco Giants,6,6,June 23 2014,0
Pittsburgh Pirates,0,Tampa Bay Rays,9,8,June 23 2014,1
New York Yankees,1,Toronto Blue Jays,11,3,June 23 2014,8
Minnesota Twins,1,LA Angels of Anaheim,14,6,June 24 2014,8
Cleveland Indians,1,Arizona D'Backs,17,8,June 24 2014,9
Chicago White Sox,0,Baltimore Orioles,6,4,June 24 2014,2
Cincinnati Reds,1,Chicago Cubs,10,3,June 24 2014,7
St. Louis Cardinals,1,Colorado Rockies,15,5,June 24 2014,10
Atlanta Braves,0,Houston Astros,5,3,June 24 2014,2
Los Angeles Dodgers,0,Kansas City Royals,2,2,June 24 2014,0
Washington Nationals,0,Milwaukee Brewers,6,4,June 24 2014,2
Oakland Athletics,1,New York Mets,11,1,June 24 2014,10
Miami Marlins,1,Philadelphia Phillies,11,4,June 24 2014,7
Boston Red Sox,1,Seattle Mariners,10,2,June 24 2014,8
San Diego Padres,0,San Francisco Giants,9,7,June 24 2014,2
Pittsburgh Pirates,0,Tampa Bay Rays,11,6,June 24 2014,5
Detroit Tigers,0,Texas Rangers,10,8,June 24 2014,2
New York Yankees,1,Toronto Blue Jays,13,6,June 24 2014,7
Minnesota Twins,1,LA Angels of Anaheim,8,2,June 25 2014,6
Cleveland Indians,0,Arizona D'Backs,7,6,June 25 2014,1
Chicago White Sox,1,Baltimore Orioles,9,4,June 25 2014,5
Cincinnati Reds,0,Chicago Cubs,5,4,June 25 2014,1
St. Louis Cardinals,0,Colorado Rockies,15,9,June 25 2014,6
Atlanta Braves,0,Houston Astros,4,4,June 25 2014,0
Los Angeles Dodgers,0,Kansas City Royals,9,5,June 25 2014,4
Washington Nationals,1,Milwaukee Brewers,11,2,June 25 2014,9
Oakland Athletics,0,New York Mets,13,8,June 25 2014,5
Miami Marlins,0,Philadelphia Phillies,5,3,June 25 2014,2
Boston Red Sox,0,Seattle Mariners,9,5,June 25 2014,4
San Diego Padres,1,San Francisco Giants,4,0,June 25 2014,4
Pittsburgh Pirates,1,Tampa Bay Rays,6,1,June 25 2014,5
Detroit Tigers,0,Texas Rangers,14,8,June 25 2014,6
New York Yankees,0,Toronto Blue Jays,8,5,June 25 2014,3
Minnesota Twins,1,LA Angels of Anaheim,10,4,June 26 2014,6
Washington Nationals,1,Chicago Cubs,8,3,June 26 2014,5
Atlanta Braves,1,Houston Astros,7,1,June 26 2014,6
St. Louis Cardinals,1,Los Angeles Dodgers,1,0,June 26 2014,1
Colorado Rockies,1,Milwaukee Brewers,11,4,June 26 2014,7
Miami Marlins,1,Philadelphia Phillies,8,3,June 26 2014,5
New York Mets,1,Pittsburgh Pirates,7,2,June 26 2014,5
Cincinnati Reds,0,San Francisco Giants,4,3,June 26 2014,1
Detroit Tigers,0,Texas Rangers,6,6,June 26 2014,0
Chicago White Sox,1,Toronto Blue Jays,7,0,June 26 2014,7
Tampa Bay Rays,0,Baltimore Orioles,7,5,June 27 2014,2
Tampa Bay Rays,1,Baltimore Orioles,5,1,June 27 2014,4
Washington Nationals,1,Chicago Cubs,9,2,June 27 2014,7
Detroit Tigers,1,Houston Astros,7,3,June 27 2014,4
LA Angels of Anaheim,1,Kansas City Royals,14,6,June 27 2014,8
St. Louis Cardinals,0,Los Angeles Dodgers,4,3,June 27 2014,1
Oakland Athletics,0,Miami Marlins,14,9,June 27 2014,5
Colorado Rockies,1,Milwaukee Brewers,5,2,June 27 2014,3
Boston Red Sox,1,New York Yankees,6,0,June 27 2014,6
Atlanta Braves,0,Philadelphia Phillies,6,4,June 27 2014,2
New York Mets,1,Pittsburgh Pirates,5,2,June 27 2014,3
Arizona D'Backs,0,San Diego Padres,3,2,June 27 2014,1
Cleveland Indians,1,Seattle Mariners,5,2,June 27 2014,3
Cincinnati Reds,0,San Francisco Giants,8,6,June 27 2014,2
Minnesota Twins,1,Texas Rangers,9,4,June 27 2014,5
Chicago White Sox,0,Toronto Blue Jays,9,5,June 27 2014,4
Tampa Bay Rays,0,Baltimore Orioles,9,5,June 28 2014,4
Washington Nationals,0,Chicago Cubs,3,3,June 28 2014,0
Washington Nationals,0,Chicago Cubs,9,7,June 28 2014,2
Detroit Tigers,0,Houston Astros,7,4,June 28 2014,3
LA Angels of Anaheim,0,Kansas City Royals,8,6,June 28 2014,2
St. Louis Cardinals,1,Los Angeles Dodgers,10,1,June 28 2014,9
Oakland Athletics,0,Miami Marlins,13,7,June 28 2014,6
Colorado Rockies,1,Milwaukee Brewers,11,4,June 28 2014,7
Boston Red Sox,0,New York Yankees,3,2,June 28 2014,1
Atlanta Braves,0,Philadelphia Phillies,13,10,June 28 2014,3
Atlanta Braves,0,Philadelphia Phillies,6,5,June 28 2014,1
New York Mets,0,Pittsburgh Pirates,8,5,June 28 2014,3
Arizona D'Backs,0,San Diego Padres,4,3,June 28 2014,1
Cleveland Indians,0,Seattle Mariners,5,5,June 28 2014,0
Cincinnati Reds,0,San Francisco Giants,10,7,June 28 2014,3
Minnesota Twins,1,Texas Rangers,5,0,June 28 2014,5
Chicago White Sox,0,Toronto Blue Jays,7,4,June 28 2014,3
Tampa Bay Rays,0,Baltimore Orioles,19,12,June 29 2014,7
Detroit Tigers,1,Houston Astros,10,4,June 29 2014,6
LA Angels of Anaheim,1,Kansas City Royals,9,4,June 29 2014,5
St. Louis Cardinals,1,Los Angeles Dodgers,6,0,June 29 2014,6
Oakland Athletics,0,Miami Marlins,7,4,June 29 2014,3
Colorado Rockies,0,Milwaukee Brewers,14,10,June 29 2014,4
Boston Red Sox,0,New York Yankees,13,8,June 29 2014,5
Atlanta Braves,0,Philadelphia Phillies,5,3,June 29 2014,2
New York Mets,1,Pittsburgh Pirates,7,2,June 29 2014,5
Arizona D'Backs,1,San Diego Padres,3,1,June 29 2014,2
Cleveland Indians,1,Seattle Mariners,3,0,June 29 2014,3
Cincinnati Reds,0,San Francisco Giants,4,4,June 29 2014,0
Minnesota Twins,0,Texas Rangers,5,3,June 29 2014,2
Chicago White Sox,0,Toronto Blue Jays,4,4,June 29 2014,0
New York Mets,1,Atlanta Braves,8,3,June 30 2014,5
Texas Rangers,1,Baltimore Orioles,8,1,June 30 2014,7
Chicago Cubs,0,Boston Red Sox,2,2,June 30 2014,0
Oakland Athletics,1,Detroit Tigers,9,4,June 30 2014,5
Seattle Mariners,0,Houston Astros,14,10,June 30 2014,4
Cleveland Indians,1,Los Angeles Dodgers,1,0,June 30 2014,1
Kansas City Royals,0,Minnesota Twins,7,6,June 30 2014,1
Tampa Bay Rays,0,New York Yankees,7,4,June 30 2014,3
Cincinnati Reds,1,San Diego Padres,1,0,June 30 2014,1
Colorado Rockies,1,Washington Nationals,10,3,June 30 2014,7
New York Mets,1,Atlanta Braves,9,4,July 1 2014,5
Texas Rangers,1,Baltimore Orioles,11,3,July 1 2014,8
Chicago Cubs,0,Boston Red Sox,3,2,July 1 2014,1
LA Angels of Anaheim,0,Chicago White Sox,12,8,July 1 2014,4
LA Angels of Anaheim,0,Chicago White Sox,12,7,July 1 2014,5
Oakland Athletics,1,Detroit Tigers,3,0,July 1 2014,3
Seattle Mariners,0,Houston Astros,15,13,July 1 2014,2
Cleveland Indians,0,Los Angeles Dodgers,13,10,July 1 2014,3
Philadelphia Phillies,1,Miami Marlins,9,4,July 1 2014,5
Kansas City Royals,1,Minnesota Twins,12,2,July 1 2014,10
Tampa Bay Rays,0,New York Yankees,3,2,July 1 2014,1
Arizona D'Backs,1,Pittsburgh Pirates,5,2,July 1 2014,3
Cincinnati Reds,1,San Diego Padres,10,2,July 1 2014,8
St. Louis Cardinals,1,San Francisco Giants,5,0,July 1 2014,5
Milwaukee Brewers,1,Toronto Blue Jays,5,1,July 1 2014,4
Colorado Rockies,1,Washington Nationals,8,1,July 1 2014,7
New York Mets,1,Atlanta Braves,4,1,July 2 2014,3
Texas Rangers,1,Baltimore Orioles,10,4,July 2 2014,6
Chicago Cubs,0,Boston Red Sox,25,16,July 2 2014,9
LA Angels of Anaheim,1,Chicago White Sox,5,2,July 2 2014,3
Oakland Athletics,1,Detroit Tigers,12,3,July 2 2014,9
Seattle Mariners,0,Houston Astros,7,5,July 2 2014,2
Cleveland Indians,0,Los Angeles Dodgers,9,5,July 2 2014,4
Philadelphia Phillies,1,Miami Marlins,5,0,July 2 2014,5
Kansas City Royals,0,Minnesota Twins,4,4,July 2 2014,0
Tampa Bay Rays,0,New York Yankees,9,6,July 2 2014,3
Arizona D'Backs,1,Pittsburgh Pirates,6,1,July 2 2014,5
Cincinnati Reds,1,San Diego Padres,3,0,July 2 2014,3
St. Louis Cardinals,0,San Francisco Giants,2,2,July 2 2014,0
Milwaukee Brewers,1,Toronto Blue Jays,11,4,July 2 2014,7
Colorado Rockies,1,Washington Nationals,7,3,July 2 2014,4
Houston Astros,1,LA Angels of Anaheim,7,2,July 3 2014,5
Texas Rangers,1,Baltimore Orioles,7,2,July 3 2014,5
Los Angeles Dodgers,0,Colorado Rockies,5,3,July 3 2014,2
Tampa Bay Rays,1,Detroit Tigers,9,1,July 3 2014,8
Philadelphia Phillies,0,Miami Marlins,9,5,July 3 2014,4
New York Yankees,0,Minnesota Twins,11,7,July 3 2014,4
Toronto Blue Jays,1,Oakland Athletics,5,1,July 3 2014,4
Arizona D'Backs,0,Pittsburgh Pirates,12,10,July 3 2014,2
St. Louis Cardinals,0,San Francisco Giants,9,7,July 3 2014,2
Houston Astros,1,LA Angels of Anaheim,13,6,July 4 2014,7
Arizona D'Backs,1,Atlanta Braves,7,2,July 4 2014,5
Seattle Mariners,1,Chicago White Sox,8,1,July 4 2014,7
Milwaukee Brewers,1,Cincinnati Reds,6,2,July 4 2014,4
Kansas City Royals,0,Cleveland Indians,8,7,July 4 2014,1
Los Angeles Dodgers,0,Colorado Rockies,9,9,July 4 2014,0
Tampa Bay Rays,0,Detroit Tigers,9,6,July 4 2014,3
New York Yankees,0,Minnesota Twins,11,6,July 4 2014,5
Texas Rangers,1,New York Mets,11,5,July 4 2014,6
Toronto Blue Jays,1,Oakland Athletics,1,0,July 4 2014,1
Philadelphia Phillies,1,Pittsburgh Pirates,10,2,July 4 2014,8
San Francisco Giants,1,San Diego Padres,2,0,July 4 2014,2
Miami Marlins,1,St. Louis Cardinals,5,2,July 4 2014,3
Chicago Cubs,0,Washington Nationals,9,7,July 4 2014,2
Houston Astros,1,LA Angels of Anaheim,16,5,July 5 2014,11
Arizona D'Backs,1,Atlanta Braves,14,4,July 5 2014,10
Baltimore Orioles,1,Boston Red Sox,5,2,July 5 2014,3
Baltimore Orioles,0,Boston Red Sox,11,7,July 5 2014,4
Seattle Mariners,0,Chicago White Sox,5,3,July 5 2014,2
Milwaukee Brewers,0,Cincinnati Reds,1,1,July 5 2014,0
Kansas City Royals,1,Cleveland Indians,10,3,July 5 2014,7
Los Angeles Dodgers,1,Colorado Rockies,15,7,July 5 2014,8
Tampa Bay Rays,0,Detroit Tigers,9,7,July 5 2014,2
New York Yankees,1,Minnesota Twins,3,1,July 5 2014,2
Texas Rangers,0,New York Mets,8,5,July 5 2014,3
Toronto Blue Jays,1,Oakland Athletics,6,1,July 5 2014,5
Philadelphia Phillies,1,Pittsburgh Pirates,5,2,July 5 2014,3
San Francisco Giants,0,San Diego Padres,8,5,July 5 2014,3
Miami Marlins,0,St. Louis Cardinals,11,6,July 5 2014,5
Chicago Cubs,1,Washington Nationals,13,0,July 5 2014,13
Houston Astros,1,LA Angels of Anaheim,7,1,July 6 2014,6
Arizona D'Backs,0,Atlanta Braves,4,3,July 6 2014,1
Baltimore Orioles,0,Boston Red Sox,13,7,July 6 2014,6
Seattle Mariners,1,Chicago White Sox,1,0,July 6 2014,1
Milwaukee Brewers,1,Cincinnati Reds,6,2,July 6 2014,4
Kansas City Royals,1,Cleveland Indians,5,1,July 6 2014,4
Los Angeles Dodgers,0,Colorado Rockies,10,8,July 6 2014,2
Tampa Bay Rays,0,Detroit Tigers,10,7,July 6 2014,3
New York Yankees,0,Minnesota Twins,16,9,July 6 2014,7
Texas Rangers,1,New York Mets,12,4,July 6 2014,8
Toronto Blue Jays,1,Oakland Athletics,6,2,July 6 2014,4
Philadelphia Phillies,1,Pittsburgh Pirates,8,2,July 6 2014,6
San Francisco Giants,0,San Diego Padres,8,5,July 6 2014,3
Miami Marlins,0,St. Louis Cardinals,12,8,July 6 2014,4
Chicago Cubs,1,Washington Nationals,3,1,July 6 2014,2
Toronto Blue Jays,1,LA Angels of Anaheim,7,2,July 7 2014,5
Miami Marlins,1,Arizona D'Backs,10,1,July 7 2014,9
Chicago White Sox,0,Boston Red Sox,4,4,July 7 2014,0
Chicago Cubs,1,Cincinnati Reds,12,3,July 7 2014,9
New York Yankees,0,Cleveland Indians,8,5,July 7 2014,3
San Diego Padres,0,Colorado Rockies,7,6,July 7 2014,1
Philadelphia Phillies,0,Milwaukee Brewers,5,3,July 7 2014,2
Atlanta Braves,1,New York Mets,7,3,July 7 2014,4
San Francisco Giants,1,Oakland Athletics,5,0,July 7 2014,5
Minnesota Twins,1,Seattle Mariners,2,0,July 7 2014,2
Pittsburgh Pirates,1,St. Louis Cardinals,2,0,July 7 2014,2
Kansas City Royals,0,Tampa Bay Rays,6,6,July 7 2014,0
Houston Astros,0,Texas Rangers,19,12,July 7 2014,7
Baltimore Orioles,0,Washington Nationals,10,8,July 7 2014,2
Toronto Blue Jays,0,LA Angels of Anaheim,4,4,July 8 2014,0
Miami Marlins,0,Arizona D'Backs,3,2,July 8 2014,1
Chicago White Sox,0,Boston Red Sox,11,8,July 8 2014,3
Chicago Cubs,1,Cincinnati Reds,6,2,July 8 2014,4
Chicago Cubs,1,Cincinnati Reds,11,5,July 8 2014,6
New York Yankees,1,Cleveland Indians,8,3,July 8 2014,5
San Diego Padres,1,Colorado Rockies,3,1,July 8 2014,2
Los Angeles Dodgers,1,Detroit Tigers,19,5,July 8 2014,14
Philadelphia Phillies,0,Milwaukee Brewers,16,9,July 8 2014,7
Atlanta Braves,1,New York Mets,11,3,July 8 2014,8
San Francisco Giants,1,Oakland Athletics,7,1,July 8 2014,6
Minnesota Twins,0,Seattle Mariners,2,2,July 8 2014,0
Pittsburgh Pirates,1,St. Louis Cardinals,9,4,July 8 2014,5
Kansas City Royals,1,Tampa Bay Rays,7,3,July 8 2014,4
Houston Astros,0,Texas Rangers,11,8,July 8 2014,3
Toronto Blue Jays,1,LA Angels of Anaheim,15,7,July 9 2014,8
Miami Marlins,1,Arizona D'Backs,7,3,July 9 2014,4
Washington Nationals,0,Baltimore Orioles,8,6,July 9 2014,2
Chicago White Sox,1,Boston Red Sox,9,4,July 9 2014,5
Chicago Cubs,1,Cincinnati Reds,5,1,July 9 2014,4
New York Yankees,0,Cleveland Indians,9,5,July 9 2014,4
San Diego Padres,1,Colorado Rockies,9,3,July 9 2014,6
Los Angeles Dodgers,1,Detroit Tigers,5,1,July 9 2014,4
Philadelphia Phillies,0,Milwaukee Brewers,5,4,July 9 2014,1
Atlanta Braves,1,New York Mets,5,1,July 9 2014,4
Minnesota Twins,0,Seattle Mariners,9,8,July 9 2014,1
Oakland Athletics,1,San Francisco Giants,7,2,July 9 2014,5
Pittsburgh Pirates,1,St. Louis Cardinals,7,2,July 9 2014,5
Kansas City Royals,0,Tampa Bay Rays,9,5,July 9 2014,4
Houston Astros,0,Texas Rangers,12,8,July 9 2014,4
Washington Nationals,1,Baltimore Orioles,7,3,July 10 2014,4
Chicago White Sox,1,Boston Red Sox,7,3,July 10 2014,4
Chicago Cubs,0,Cincinnati Reds,10,6,July 10 2014,4
New York Yankees,1,Cleveland Indians,12,3,July 10 2014,9
Detroit Tigers,0,Kansas City Royals,20,16,July 10 2014,4
San Diego Padres,1,Los Angeles Dodgers,3,1,July 10 2014,2
Philadelphia Phillies,0,Milwaukee Brewers,10,9,July 10 2014,1
Atlanta Braves,0,New York Mets,4,3,July 10 2014,1
Minnesota Twins,0,Seattle Mariners,6,4,July 10 2014,2
Oakland Athletics,0,San Francisco Giants,7,6,July 10 2014,1
Pittsburgh Pirates,0,St. Louis Cardinals,10,9,July 10 2014,1
LA Angels of Anaheim,0,Texas Rangers,21,15,July 10 2014,6
New York Yankees,1,Baltimore Orioles,5,2,July 11 2014,3
Atlanta Braves,1,Chicago Cubs,9,4,July 11 2014,5
Pittsburgh Pirates,1,Cincinnati Reds,11,5,July 11 2014,6
Chicago White Sox,1,Cleveland Indians,11,4,July 11 2014,7
Minnesota Twins,1,Colorado Rockies,8,2,July 11 2014,6
Boston Red Sox,0,Houston Astros,11,8,July 11 2014,3
Detroit Tigers,0,Kansas City Royals,3,2,July 11 2014,1
San Diego Padres,0,Los Angeles Dodgers,9,6,July 11 2014,3
St. Louis Cardinals,0,Milwaukee Brewers,13,7,July 11 2014,6
Miami Marlins,1,New York Mets,8,1,July 11 2014,7
Washington Nationals,1,Philadelphia Phillies,8,2,July 11 2014,6
Oakland Athletics,1,Seattle Mariners,5,2,July 11 2014,3
Arizona D'Backs,1,San Francisco Giants,5,0,July 11 2014,5
Toronto Blue Jays,0,Tampa Bay Rays,13,8,July 11 2014,5
LA Angels of Anaheim,0,Texas Rangers,3,3,July 11 2014,0
New York Yankees,0,Baltimore Orioles,3,3,July 12 2014,0
Atlanta Braves,0,Chicago Cubs,17,11,July 12 2014,6
Pittsburgh Pirates,0,Cincinnati Reds,11,6,July 12 2014,5
Chicago White Sox,0,Cleveland Indians,8,6,July 12 2014,2
Minnesota Twins,0,Colorado Rockies,12,9,July 12 2014,3
Boston Red Sox,1,Houston Astros,5,2,July 12 2014,3
Detroit Tigers,0,Kansas City Royals,6,5,July 12 2014,1
San Diego Padres,1,Los Angeles Dodgers,1,0,July 12 2014,1
St. Louis Cardinals,0,Milwaukee Brewers,12,10,July 12 2014,2
Miami Marlins,1,New York Mets,9,4,July 12 2014,5
Washington Nationals,0,Philadelphia Phillies,8,5,July 12 2014,3
Oakland Athletics,1,Seattle Mariners,8,2,July 12 2014,6
Arizona D'Backs,0,San Francisco Giants,2,2,July 12 2014,0
Toronto Blue Jays,1,Tampa Bay Rays,13,3,July 12 2014,10
LA Angels of Anaheim,0,Texas Rangers,7,5,July 12 2014,2
New York Yankees,1,Baltimore Orioles,4,1,July 13 2014,3
Atlanta Braves,0,Chicago Cubs,17,10,July 13 2014,7
Pittsburgh Pirates,1,Cincinnati Reds,9,3,July 13 2014,6
Chicago White Sox,1,Cleveland Indians,5,2,July 13 2014,3
Minnesota Twins,0,Colorado Rockies,18,13,July 13 2014,5
Boston Red Sox,0,Houston Astros,11,11,July 13 2014,0
Detroit Tigers,1,Kansas City Royals,7,2,July 13 2014,5
San Diego Padres,1,Los Angeles Dodgers,1,0,July 13 2014,1
St. Louis Cardinals,1,Milwaukee Brewers,13,2,July 13 2014,11
Miami Marlins,1,New York Mets,10,1,July 13 2014,9
Washington Nationals,0,Philadelphia Phillies,13,10,July 13 2014,3
Oakland Athletics,0,Seattle Mariners,5,4,July 13 2014,1
Arizona D'Backs,1,San Francisco Giants,12,4,July 13 2014,8
Toronto Blue Jays,1,Tampa Bay Rays,3,0,July 13 2014,3
LA Angels of Anaheim,0,Texas Rangers,17,10,July 13 2014,7
Seattle Mariners,1,LA Angels of Anaheim,5,2,July 18 2014,3
Chicago Cubs,1,Arizona D'Backs,9,4,July 18 2014,5
Philadelphia Phillies,1,Atlanta Braves,10,4,July 18 2014,6
Kansas City Royals,1,Boston Red Sox,9,4,July 18 2014,5
Houston Astros,1,Chicago White Sox,5,2,July 18 2014,3
Cleveland Indians,0,Detroit Tigers,12,9,July 18 2014,3
San Francisco Giants,0,Miami Marlins,10,9,July 18 2014,1
Tampa Bay Rays,0,Minnesota Twins,8,6,July 18 2014,2
Cincinnati Reds,1,New York Yankees,7,3,July 18 2014,4
Baltimore Orioles,1,Oakland Athletics,9,4,July 18 2014,5
Colorado Rockies,1,Pittsburgh Pirates,6,2,July 18 2014,4
New York Mets,0,San Diego Padres,9,5,July 18 2014,4
Los Angeles Dodgers,1,St. Louis Cardinals,5,2,July 18 2014,3
Texas Rangers,0,Toronto Blue Jays,6,5,July 18 2014,1
Milwaukee Brewers,0,Washington Nationals,6,4,July 18 2014,2
Seattle Mariners,0,LA Angels of Anaheim,5,3,July 19 2014,2
Chicago Cubs,1,Arizona D'Backs,12,3,July 19 2014,9
Philadelphia Phillies,0,Atlanta Braves,3,2,July 19 2014,1
Kansas City Royals,1,Boston Red Sox,3,1,July 19 2014,2
Houston Astros,1,Chicago White Sox,7,3,July 19 2014,4
Cleveland Indians,0,Detroit Tigers,8,6,July 19 2014,2
Cleveland Indians,0,Detroit Tigers,7,5,July 19 2014,2
San Francisco Giants,0,Miami Marlins,8,5,July 19 2014,3
Tampa Bay Rays,0,Minnesota Twins,6,5,July 19 2014,1
Cincinnati Reds,1,New York Yankees,8,1,July 19 2014,7
Baltimore Orioles,0,Oakland Athletics,12,8,July 19 2014,4
Colorado Rockies,1,Pittsburgh Pirates,5,2,July 19 2014,3
New York Mets,1,San Diego Padres,6,0,July 19 2014,6
Los Angeles Dodgers,1,St. Louis Cardinals,6,2,July 19 2014,4
Texas Rangers,1,Toronto Blue Jays,5,1,July 19 2014,4
Milwaukee Brewers,1,Washington Nationals,11,3,July 19 2014,8
Seattle Mariners,1,LA Angels of Anaheim,11,5,July 20 2014,6
Chicago Cubs,1,Arizona D'Backs,5,2,July 20 2014,3
Philadelphia Phillies,1,Atlanta Braves,10,2,July 20 2014,8
Kansas City Royals,1,Boston Red Sox,6,0,July 20 2014,6
Houston Astros,0,Chicago White Sox,18,11,July 20 2014,7
Cleveland Indians,1,Detroit Tigers,6,1,July 20 2014,5
San Francisco Giants,1,Miami Marlins,5,2,July 20 2014,3
Tampa Bay Rays,0,Minnesota Twins,8,5,July 20 2014,3
Cincinnati Reds,1,New York Yankees,5,2,July 20 2014,3
Baltimore Orioles,1,Oakland Athletics,12,2,July 20 2014,10
Colorado Rockies,1,Pittsburgh Pirates,8,3,July 20 2014,5
New York Mets,1,San Diego Padres,3,1,July 20 2014,2
Los Angeles Dodgers,0,St. Louis Cardinals,7,4,July 20 2014,3
Texas Rangers,1,Toronto Blue Jays,15,6,July 20 2014,9
Milwaukee Brewers,1,Washington Nationals,9,4,July 20 2014,5
Baltimore Orioles,0,LA Angels of Anaheim,6,4,July 21 2014,2
Detroit Tigers,0,Arizona D'Backs,7,4,July 21 2014,3
Miami Marlins,0,Atlanta Braves,4,3,July 21 2014,1
Kansas City Royals,1,Chicago White Sox,4,1,July 21 2014,3
Washington Nationals,0,Colorado Rockies,9,7,July 21 2014,2
Cincinnati Reds,1,Milwaukee Brewers,7,2,July 21 2014,5
Cleveland Indians,1,Minnesota Twins,7,3,July 21 2014,4
Texas Rangers,0,New York Yankees,6,4,July 21 2014,2
San Francisco Giants,0,Philadelphia Phillies,11,7,July 21 2014,4
Los Angeles Dodgers,0,Pittsburgh Pirates,7,5,July 21 2014,2
New York Mets,1,Seattle Mariners,7,2,July 21 2014,5
Boston Red Sox,0,Toronto Blue Jays,15,14,July 21 2014,1
Baltimore Orioles,0,LA Angels of Anaheim,6,4,July 22 2014,2
Detroit Tigers,1,Arizona D'Backs,9,4,July 22 2014,5
Miami Marlins,0,Atlanta Braves,11,6,July 22 2014,5
Kansas City Royals,0,Chicago White Sox,8,7,July 22 2014,1
San Diego Padres,1,Chicago Cubs,6,0,July 22 2014,6
Washington Nationals,0,Colorado Rockies,11,7,July 22 2014,4
Cincinnati Reds,1,Milwaukee Brewers,7,3,July 22 2014,4
Cleveland Indians,0,Minnesota Twins,10,8,July 22 2014,2
Texas Rangers,1,New York Yankees,3,1,July 22 2014,2
Houston Astros,0,Oakland Athletics,5,3,July 22 2014,2
San Francisco Giants,0,Philadelphia Phillies,15,9,July 22 2014,6
Los Angeles Dodgers,1,Pittsburgh Pirates,19,7,July 22 2014,12
New York Mets,0,Seattle Mariners,4,3,July 22 2014,1
Tampa Bay Rays,0,St. Louis Cardinals,9,7,July 22 2014,2
Boston Red Sox,1,Toronto Blue Jays,10,3,July 22 2014,7
Baltimore Orioles,1,LA Angels of Anaheim,5,2,July 23 2014,3
Detroit Tigers,0,Arizona D'Backs,16,11,July 23 2014,5
Miami Marlins,1,Atlanta Braves,7,1,July 23 2014,6
Kansas City Royals,0,Chicago White Sox,3,2,July 23 2014,1
San Diego Padres,0,Chicago Cubs,11,8,July 23 2014,3
Washington Nationals,1,Colorado Rockies,10,4,July 23 2014,6
Cincinnati Reds,1,Milwaukee Brewers,6,1,July 23 2014,5
Cleveland Indians,1,Minnesota Twins,4,1,July 23 2014,3
Texas Rangers,1,New York Yankees,3,1,July 23 2014,2
Houston Astros,1,Oakland Athletics,16,7,July 23 2014,9
San Francisco Giants,0,Philadelphia Phillies,4,3,July 23 2014,1
Los Angeles Dodgers,1,Pittsburgh Pirates,7,1,July 23 2014,6
New York Mets,0,Seattle Mariners,5,3,July 23 2014,2
Tampa Bay Rays,0,St. Louis Cardinals,3,3,July 23 2014,0
Boston Red Sox,1,Toronto Blue Jays,10,4,July 23 2014,6
Detroit Tigers,0,LA Angels of Anaheim,10,6,July 24 2014,4
Miami Marlins,0,Atlanta Braves,5,3,July 24 2014,2
San Diego Padres,0,Chicago Cubs,16,13,July 24 2014,3
Cleveland Indians,1,Kansas City Royals,3,1,July 24 2014,2
New York Mets,1,Milwaukee Brewers,10,1,July 24 2014,9
Chicago White Sox,0,Minnesota Twins,7,5,July 24 2014,2
Texas Rangers,1,New York Yankees,6,2,July 24 2014,4
Houston Astros,1,Oakland Athletics,14,1,July 24 2014,13
San Francisco Giants,1,Philadelphia Phillies,3,1,July 24 2014,2
Baltimore Orioles,0,Seattle Mariners,4,4,July 24 2014,0
Boston Red Sox,1,Toronto Blue Jays,8,0,July 24 2014,8
Detroit Tigers,1,LA Angels of Anaheim,3,1,July 25 2014,2
San Diego Padres,0,Atlanta Braves,7,5,July 25 2014,2
St. Louis Cardinals,1,Chicago Cubs,13,6,July 25 2014,7
Washington Nationals,0,Cincinnati Reds,5,4,July 25 2014,1
Pittsburgh Pirates,1,Colorado Rockies,9,1,July 25 2014,8
Miami Marlins,0,Houston Astros,2,2,July 25 2014,0
Cleveland Indians,1,Kansas City Royals,10,4,July 25 2014,6
New York Mets,0,Milwaukee Brewers,5,3,July 25 2014,2
Chicago White Sox,0,Minnesota Twins,14,9,July 25 2014,5
Toronto Blue Jays,1,New York Yankees,10,4,July 25 2014,6
Arizona D'Backs,1,Philadelphia Phillies,14,5,July 25 2014,9
Baltimore Orioles,0,Seattle Mariners,3,2,July 25 2014,1
Los Angeles Dodgers,0,San Francisco Giants,9,8,July 25 2014,1
Boston Red Sox,1,Tampa Bay Rays,10,4,July 25 2014,6
Oakland Athletics,1,Texas Rangers,5,1,July 25 2014,4
Detroit Tigers,1,LA Angels of Anaheim,4,0,July 26 2014,4
San Diego Padres,1,Atlanta Braves,8,3,July 26 2014,5
St. Louis Cardinals,0,Chicago Cubs,9,6,July 26 2014,3
Washington Nationals,1,Cincinnati Reds,1,0,July 26 2014,1
Pittsburgh Pirates,1,Colorado Rockies,9,1,July 26 2014,8
Miami Marlins,0,Houston Astros,10,7,July 26 2014,3
Cleveland Indians,1,Kansas City Royals,12,5,July 26 2014,7
New York Mets,1,Milwaukee Brewers,7,2,July 26 2014,5
Chicago White Sox,0,Minnesota Twins,7,7,July 26 2014,0
Toronto Blue Jays,0,New York Yankees,10,6,July 26 2014,4
Arizona D'Backs,0,Philadelphia Phillies,16,10,July 26 2014,6
Baltimore Orioles,1,Seattle Mariners,7,3,July 26 2014,4
Los Angeles Dodgers,0,San Francisco Giants,5,5,July 26 2014,0
Boston Red Sox,1,Tampa Bay Rays,3,0,July 26 2014,3
Oakland Athletics,0,Texas Rangers,6,5,July 26 2014,1
Detroit Tigers,1,LA Angels of Anaheim,3,1,July 27 2014,2
San Diego Padres,1,Atlanta Braves,11,3,July 27 2014,8
St. Louis Cardinals,0,Chicago Cubs,1,1,July 27 2014,0
Washington Nationals,0,Cincinnati Reds,6,4,July 27 2014,2
Pittsburgh Pirates,0,Colorado Rockies,12,7,July 27 2014,5
Miami Marlins,0,Houston Astros,6,4,July 27 2014,2
Cleveland Indians,0,Kansas City Royals,13,10,July 27 2014,3
New York Mets,0,Milwaukee Brewers,2,2,July 27 2014,0
Chicago White Sox,1,Minnesota Twins,7,3,July 27 2014,4
Toronto Blue Jays,0,New York Yankees,9,5,July 27 2014,4
Arizona D'Backs,1,Philadelphia Phillies,6,2,July 27 2014,4
Baltimore Orioles,0,Seattle Mariners,5,3,July 27 2014,2
Los Angeles Dodgers,0,San Francisco Giants,7,4,July 27 2014,3
Boston Red Sox,0,Tampa Bay Rays,5,3,July 27 2014,2
Oakland Athletics,0,Texas Rangers,12,9,July 27 2014,3
San Diego Padres,1,Atlanta Braves,2,0,July 28 2014,2
Toronto Blue Jays,0,Boston Red Sox,15,14,July 28 2014,1
Colorado Rockies,1,Chicago Cubs,5,1,July 28 2014,4
Arizona D'Backs,0,Cincinnati Reds,3,2,July 28 2014,1
Oakland Athletics,1,Houston Astros,10,3,July 28 2014,7
Washington Nationals,1,Miami Marlins,13,6,July 28 2014,7
Philadelphia Phillies,1,New York Mets,8,1,July 28 2014,7
Pittsburgh Pirates,0,San Francisco Giants,5,5,July 28 2014,0
Milwaukee Brewers,1,Tampa Bay Rays,3,1,July 28 2014,2
New York Yankees,1,Texas Rangers,6,2,July 28 2014,4
LA Angels of Anaheim,1,Baltimore Orioles,13,6,July 29 2014,7
Toronto Blue Jays,0,Boston Red Sox,6,4,July 29 2014,2
Colorado Rockies,1,Chicago Cubs,7,3,July 29 2014,4
Arizona D'Backs,1,Cincinnati Reds,3,0,July 29 2014,3
Seattle Mariners,0,Cleveland Indians,7,5,July 29 2014,2
Chicago White Sox,0,Detroit Tigers,15,11,July 29 2014,4
Oakland Athletics,0,Houston Astros,11,7,July 29 2014,4
Minnesota Twins,0,Kansas City Royals,3,2,July 29 2014,1
Atlanta Braves,1,Los Angeles Dodgers,12,4,July 29 2014,8
Washington Nationals,1,Miami Marlins,3,0,July 29 2014,3
Philadelphia Phillies,0,New York Mets,6,6,July 29 2014,0
St. Louis Cardinals,1,San Diego Padres,4,1,July 29 2014,3
Pittsburgh Pirates,0,San Francisco Giants,4,3,July 29 2014,1
Milwaukee Brewers,1,Tampa Bay Rays,6,1,July 29 2014,5
New York Yankees,0,Texas Rangers,23,12,July 29 2014,11
LA Angels of Anaheim,1,Baltimore Orioles,7,3,July 30 2014,4
Toronto Blue Jays,0,Boston Red Sox,7,6,July 30 2014,1
Colorado Rockies,0,Chicago Cubs,10,6,July 30 2014,4
Arizona D'Backs,0,Cincinnati Reds,9,5,July 30 2014,4
Seattle Mariners,1,Cleveland Indians,2,0,July 30 2014,2
Chicago White Sox,1,Detroit Tigers,9,2,July 30 2014,7
Oakland Athletics,1,Houston Astros,9,1,July 30 2014,8
Minnesota Twins,1,Kansas City Royals,5,2,July 30 2014,3
Atlanta Braves,1,Los Angeles Dodgers,5,2,July 30 2014,3
Washington Nationals,0,Miami Marlins,7,4,July 30 2014,3
Philadelphia Phillies,1,New York Mets,13,2,July 30 2014,11
St. Louis Cardinals,1,San Diego Padres,13,1,July 30 2014,12
Pittsburgh Pirates,1,San Francisco Giants,12,5,July 30 2014,7
Milwaukee Brewers,0,Tampa Bay Rays,5,5,July 30 2014,0
New York Yankees,1,Texas Rangers,5,2,July 30 2014,3
Pittsburgh Pirates,1,Arizona D'Backs,11,4,July 31 2014,7
LA Angels of Anaheim,0,Baltimore Orioles,1,1,July 31 2014,0
Colorado Rockies,1,Chicago Cubs,4,1,July 31 2014,3
Seattle Mariners,0,Cleveland Indians,11,6,July 31 2014,5
Chicago White Sox,0,Detroit Tigers,11,7,July 31 2014,4
Toronto Blue Jays,0,Houston Astros,11,6,July 31 2014,5
Minnesota Twins,1,Kansas City Royals,9,3,July 31 2014,6
Atlanta Braves,1,Los Angeles Dodgers,3,1,July 31 2014,2
Cincinnati Reds,0,Miami Marlins,4,3,July 31 2014,1
St. Louis Cardinals,0,San Diego Padres,8,6,July 31 2014,2
Philadelphia Phillies,0,Washington Nationals,14,10,July 31 2014,4
Pittsburgh Pirates,0,Arizona D'Backs,13,9,August 1 2014,4
Seattle Mariners,1,Baltimore Orioles,3,1,August 1 2014,2
New York Yankees,1,Boston Red Sox,7,3,August 1 2014,4
Minnesota Twins,1,Chicago White Sox,18,8,August 1 2014,10
Texas Rangers,1,Cleveland Indians,14,2,August 1 2014,12
Colorado Rockies,1,Detroit Tigers,6,2,August 1 2014,4
Toronto Blue Jays,1,Houston Astros,4,1,August 1 2014,3
Chicago Cubs,0,Los Angeles Dodgers,10,8,August 1 2014,2
Cincinnati Reds,0,Miami Marlins,7,5,August 1 2014,2
San Francisco Giants,0,New York Mets,6,5,August 1 2014,1
Kansas City Royals,0,Oakland Athletics,1,1,August 1 2014,0
Atlanta Braves,1,San Diego Padres,11,1,August 1 2014,10
Milwaukee Brewers,0,St. Louis Cardinals,11,7,August 1 2014,4
LA Angels of Anaheim,0,Tampa Bay Rays,8,5,August 1 2014,3
Philadelphia Phillies,0,Washington Nationals,3,2,August 1 2014,1
Pittsburgh Pirates,0,Arizona D'Backs,11,8,August 2 2014,3
Seattle Mariners,0,Baltimore Orioles,9,6,August 2 2014,3
New York Yankees,0,Boston Red Sox,10,6,August 2 2014,4
Minnesota Twins,0,Chicago White Sox,14,8,August 2 2014,6
Texas Rangers,1,Cleveland Indians,2,0,August 2 2014,2
Colorado Rockies,1,Detroit Tigers,16,5,August 2 2014,11
Toronto Blue Jays,1,Houston Astros,10,2,August 2 2014,8
Chicago Cubs,1,Los Angeles Dodgers,7,2,August 2 2014,5
Cincinnati Reds,1,Miami Marlins,3,1,August 2 2014,2
San Francisco Giants,1,New York Mets,6,2,August 2 2014,4
Kansas City Royals,1,Oakland Athletics,11,3,August 2 2014,8
Atlanta Braves,1,San Diego Padres,5,2,August 2 2014,3
Milwaukee Brewers,1,St. Louis Cardinals,16,7,August 2 2014,9
LA Angels of Anaheim,1,Tampa Bay Rays,13,3,August 2 2014,10
Philadelphia Phillies,1,Washington Nationals,11,0,August 2 2014,11
Pittsburgh Pirates,1,Arizona D'Backs,5,2,August 3 2014,3
Seattle Mariners,1,Baltimore Orioles,1,0,August 3 2014,1
New York Yankees,0,Boston Red Sox,15,8,August 3 2014,7
Minnesota Twins,0,Chicago White Sox,19,16,August 3 2014,3
Texas Rangers,1,Cleveland Indians,7,3,August 3 2014,4
Colorado Rockies,1,Detroit Tigers,4,0,August 3 2014,4
Toronto Blue Jays,1,Houston Astros,7,1,August 3 2014,6
Chicago Cubs,0,Los Angeles Dodgers,10,7,August 3 2014,3
Cincinnati Reds,0,Miami Marlins,10,7,August 3 2014,3
San Francisco Giants,0,New York Mets,9,9,August 3 2014,0
Kansas City Royals,0,Oakland Athletics,6,4,August 3 2014,2
Atlanta Braves,1,San Diego Padres,7,3,August 3 2014,4
Milwaukee Brewers,1,St. Louis Cardinals,5,2,August 3 2014,3
LA Angels of Anaheim,0,Tampa Bay Rays,12,7,August 3 2014,5
Philadelphia Phillies,1,Washington Nationals,4,0,August 3 2014,4
Texas Rangers,1,Chicago White Sox,8,3,August 4 2014,5
Cincinnati Reds,1,Cleveland Indians,8,1,August 4 2014,7
LA Angels of Anaheim,0,Los Angeles Dodgers,5,5,August 4 2014,0
Detroit Tigers,1,New York Yankees,3,1,August 4 2014,2
San Francisco Giants,0,New York Mets,7,4,August 4 2014,3
Tampa Bay Rays,1,Oakland Athletics,5,2,August 4 2014,3
Baltimore Orioles,0,Washington Nationals,10,7,August 4 2014,3
Kansas City Royals,0,Arizona D'Backs,14,12,August 5 2014,2
Texas Rangers,0,Chicago White Sox,16,16,August 5 2014,0
Cincinnati Reds,0,Cleveland Indians,11,9,August 5 2014,2
Chicago Cubs,0,Colorado Rockies,11,6,August 5 2014,5
LA Angels of Anaheim,1,Los Angeles Dodgers,9,4,August 5 2014,5
San Francisco Giants,1,Milwaukee Brewers,7,3,August 5 2014,4
San Diego Padres,1,Minnesota Twins,4,1,August 5 2014,3
Detroit Tigers,0,New York Yankees,7,4,August 5 2014,3
Tampa Bay Rays,1,Oakland Athletics,3,0,August 5 2014,3
Houston Astros,1,Philadelphia Phillies,3,1,August 5 2014,2
Miami Marlins,0,Pittsburgh Pirates,9,6,August 5 2014,3
Atlanta Braves,1,Seattle Mariners,6,2,August 5 2014,4
Boston Red Sox,1,St. Louis Cardinals,5,2,August 5 2014,3
Baltimore Orioles,0,Toronto Blue Jays,12,9,August 5 2014,3
New York Mets,0,Washington Nationals,7,6,August 5 2014,1
Los Angeles Dodgers,0,LA Angels of Anaheim,3,2,August 6 2014,1
Kansas City Royals,0,Arizona D'Backs,7,4,August 6 2014,3
Texas Rangers,0,Chicago White Sox,4,3,August 6 2014,1
Cleveland Indians,1,Cincinnati Reds,11,3,August 6 2014,8
Chicago Cubs,1,Colorado Rockies,17,4,August 6 2014,13
San Francisco Giants,0,Milwaukee Brewers,11,7,August 6 2014,4
San Diego Padres,0,Minnesota Twins,9,5,August 6 2014,4
Detroit Tigers,1,New York Yankees,6,1,August 6 2014,5
Tampa Bay Rays,0,Oakland Athletics,10,7,August 6 2014,3
Houston Astros,1,Philadelphia Phillies,13,3,August 6 2014,10
Miami Marlins,1,Pittsburgh Pirates,10,3,August 6 2014,7
Atlanta Braves,1,Seattle Mariners,10,3,August 6 2014,7
Boston Red Sox,0,St. Louis Cardinals,3,2,August 6 2014,1
Baltimore Orioles,1,Toronto Blue Jays,6,1,August 6 2014,5
New York Mets,1,Washington Nationals,8,1,August 6 2014,7
Los Angeles Dodgers,0,LA Angels of Anaheim,7,7,August 7 2014,0
Kansas City Royals,0,Arizona D'Backs,8,6,August 7 2014,2
Cleveland Indians,1,Cincinnati Reds,4,0,August 7 2014,4
Chicago Cubs,0,Colorado Rockies,8,6,August 7 2014,2
San Francisco Giants,1,Milwaukee Brewers,4,1,August 7 2014,3
Detroit Tigers,1,New York Yankees,1,0,August 7 2014,1
Minnesota Twins,1,Oakland Athletics,3,0,August 7 2014,3
Houston Astros,1,Philadelphia Phillies,11,5,August 7 2014,6
Miami Marlins,1,Pittsburgh Pirates,9,2,August 7 2014,7
Chicago White Sox,1,Seattle Mariners,16,3,August 7 2014,13
Boston Red Sox,1,St. Louis Cardinals,7,2,August 7 2014,5
Baltimore Orioles,0,Toronto Blue Jays,3,2,August 7 2014,1
New York Mets,1,Washington Nationals,8,3,August 7 2014,5
Boston Red Sox,0,LA Angels of Anaheim,6,4,August 8 2014,2
Colorado Rockies,1,Arizona D'Backs,8,3,August 8 2014,5
Washington Nationals,1,Atlanta Braves,13,6,August 8 2014,7
St. Louis Cardinals,1,Baltimore Orioles,14,2,August 8 2014,12
Tampa Bay Rays,0,Chicago Cubs,7,4,August 8 2014,3
Miami Marlins,0,Cincinnati Reds,3,2,August 8 2014,1
Texas Rangers,1,Houston Astros,7,3,August 8 2014,4
San Francisco Giants,1,Kansas City Royals,6,2,August 8 2014,4
Los Angeles Dodgers,1,Milwaukee Brewers,12,3,August 8 2014,9
Cleveland Indians,1,New York Yankees,16,6,August 8 2014,10
Minnesota Twins,1,Oakland Athletics,11,5,August 8 2014,6
New York Mets,0,Philadelphia Phillies,9,5,August 8 2014,4
San Diego Padres,1,Pittsburgh Pirates,3,1,August 8 2014,2
Chicago White Sox,1,Seattle Mariners,5,1,August 8 2014,4
Detroit Tigers,0,Toronto Blue Jays,9,5,August 8 2014,4
Boston Red Sox,1,LA Angels of Anaheim,9,4,August 9 2014,5
Colorado Rockies,1,Arizona D'Backs,18,4,August 9 2014,14
Washington Nationals,0,Atlanta Braves,5,4,August 9 2014,1
St. Louis Cardinals,1,Baltimore Orioles,13,3,August 9 2014,10
Tampa Bay Rays,0,Chicago Cubs,4,4,August 9 2014,0
Miami Marlins,0,Cincinnati Reds,7,4,August 9 2014,3
Texas Rangers,1,Houston Astros,11,3,August 9 2014,8
San Francisco Giants,1,Kansas City Royals,5,0,August 9 2014,5
Los Angeles Dodgers,1,Milwaukee Brewers,5,1,August 9 2014,4
Cleveland Indians,0,New York Yankees,3,3,August 9 2014,0
Minnesota Twins,1,Oakland Athletics,13,4,August 9 2014,9
New York Mets,0,Philadelphia Phillies,3,2,August 9 2014,1
San Diego Padres,0,Pittsburgh Pirates,3,2,August 9 2014,1
Chicago White Sox,0,Seattle Mariners,3,2,August 9 2014,1
Detroit Tigers,1,Toronto Blue Jays,5,2,August 9 2014,3
Boston Red Sox,0,LA Angels of Anaheim,4,3,August 10 2014,1
Colorado Rockies,0,Arizona D'Backs,8,5,August 10 2014,3
Washington Nationals,1,Atlanta Braves,4,1,August 10 2014,3
St. Louis Cardinals,0,Baltimore Orioles,11,8,August 10 2014,3
Tampa Bay Rays,1,Chicago Cubs,5,2,August 10 2014,3
Miami Marlins,1,Cincinnati Reds,9,2,August 10 2014,7
Texas Rangers,0,Houston Astros,8,6,August 10 2014,2
San Francisco Giants,1,Kansas City Royals,11,4,August 10 2014,7
Los Angeles Dodgers,0,Milwaukee Brewers,6,5,August 10 2014,1
Cleveland Indians,0,New York Yankees,5,4,August 10 2014,1
Minnesota Twins,0,Oakland Athletics,7,6,August 10 2014,1
New York Mets,1,Philadelphia Phillies,13,6,August 10 2014,7
San Diego Padres,0,Pittsburgh Pirates,10,8,August 10 2014,2
Chicago White Sox,1,Seattle Mariners,6,2,August 10 2014,4
Detroit Tigers,1,Toronto Blue Jays,11,5,August 10 2014,6
Los Angeles Dodgers,0,Atlanta Braves,8,6,August 11 2014,2
New York Yankees,1,Baltimore Orioles,14,3,August 11 2014,11
Milwaukee Brewers,0,Chicago Cubs,4,3,August 11 2014,1
Minnesota Twins,0,Houston Astros,6,4,August 11 2014,2
Oakland Athletics,1,Kansas City Royals,5,2,August 11 2014,3
St. Louis Cardinals,1,Miami Marlins,11,5,August 11 2014,6
New York Mets,0,Philadelphia Phillies,8,5,August 11 2014,3
Detroit Tigers,1,Pittsburgh Pirates,17,6,August 11 2014,11
Colorado Rockies,1,San Diego Padres,7,3,August 11 2014,4
Toronto Blue Jays,1,Seattle Mariners,12,1,August 11 2014,11
Tampa Bay Rays,0,Texas Rangers,7,7,August 11 2014,0
Philadelphia Phillies,1,LA Angels of Anaheim,9,2,August 12 2014,7
Los Angeles Dodgers,0,Atlanta Braves,6,4,August 12 2014,2
Milwaukee Brewers,1,Chicago Cubs,3,0,August 12 2014,3
Boston Red Sox,0,Cincinnati Reds,5,3,August 12 2014,2
Minnesota Twins,1,Houston Astros,14,4,August 12 2014,10
Oakland Athletics,0,Kansas City Royals,14,11,August 12 2014,3
St. Louis Cardinals,1,Miami Marlins,3,0,August 12 2014,3
Washington Nationals,0,New York Mets,8,7,August 12 2014,1
Detroit Tigers,1,Pittsburgh Pirates,6,2,August 12 2014,4
Colorado Rockies,1,San Diego Padres,5,1,August 12 2014,4
Toronto Blue Jays,1,Seattle Mariners,9,3,August 12 2014,6
Chicago White Sox,0,San Francisco Giants,5,3,August 12 2014,2
Tampa Bay Rays,1,Texas Rangers,5,2,August 12 2014,3
Philadelphia Phillies,1,LA Angels of Anaheim,7,3,August 13 2014,4
Los Angeles Dodgers,1,Atlanta Braves,5,2,August 13 2014,3
New York Yankees,1,Baltimore Orioles,8,3,August 13 2014,5
Milwaukee Brewers,1,Chicago Cubs,6,2,August 13 2014,4
Boston Red Sox,0,Cincinnati Reds,9,5,August 13 2014,4
Arizona D'Backs,1,Cleveland Indians,5,2,August 13 2014,3
Arizona D'Backs,0,Cleveland Indians,1,1,August 13 2014,0
Pittsburgh Pirates,1,Detroit Tigers,12,4,August 13 2014,8
Minnesota Twins,0,Houston Astros,4,3,August 13 2014,1
Oakland Athletics,1,Kansas City Royals,3,0,August 13 2014,3
St. Louis Cardinals,0,Miami Marlins,7,5,August 13 2014,2
Washington Nationals,0,New York Mets,5,3,August 13 2014,2
Colorado Rockies,1,San Diego Padres,8,3,August 13 2014,5
Toronto Blue Jays,1,Seattle Mariners,2,0,August 13 2014,2
Chicago White Sox,1,San Francisco Giants,8,1,August 13 2014,7
Tampa Bay Rays,0,Texas Rangers,11,10,August 13 2014,1
Los Angeles Dodgers,0,Atlanta Braves,10,6,August 14 2014,4
Houston Astros,1,Boston Red Sox,13,4,August 14 2014,9
Milwaukee Brewers,0,Chicago Cubs,8,6,August 14 2014,2
Cincinnati Reds,1,Colorado Rockies,10,3,August 14 2014,7
Pittsburgh Pirates,1,Detroit Tigers,7,2,August 14 2014,5
Oakland Athletics,1,Kansas City Royals,10,3,August 14 2014,7
Arizona D'Backs,1,Miami Marlins,9,4,August 14 2014,5
Washington Nationals,0,New York Mets,5,4,August 14 2014,1
San Diego Padres,1,St. Louis Cardinals,7,3,August 14 2014,4
Tampa Bay Rays,0,Texas Rangers,9,6,August 14 2014,3
Oakland Athletics,1,Atlanta Braves,9,2,August 15 2014,7
Houston Astros,0,Boston Red Sox,8,5,August 15 2014,3
Toronto Blue Jays,1,Chicago White Sox,16,5,August 15 2014,11
Baltimore Orioles,1,Cleveland Indians,3,1,August 15 2014,2
Cincinnati Reds,0,Colorado Rockies,5,3,August 15 2014,2
Seattle Mariners,0,Detroit Tigers,9,7,August 15 2014,2
Milwaukee Brewers,0,Los Angeles Dodgers,9,6,August 15 2014,3
Arizona D'Backs,0,Miami Marlins,5,3,August 15 2014,2
Kansas City Royals,0,Minnesota Twins,11,6,August 15 2014,5
Chicago Cubs,1,New York Mets,5,2,August 15 2014,3
Philadelphia Phillies,0,San Francisco Giants,8,5,August 15 2014,3
San Diego Padres,1,St. Louis Cardinals,6,2,August 15 2014,4
New York Yankees,1,Tampa Bay Rays,5,0,August 15 2014,5
LA Angels of Anaheim,0,Texas Rangers,9,5,August 15 2014,4
Pittsburgh Pirates,1,Washington Nationals,9,4,August 15 2014,5
Oakland Athletics,1,Atlanta Braves,7,3,August 16 2014,4
Houston Astros,1,Boston Red Sox,17,7,August 16 2014,10
Toronto Blue Jays,0,Chicago White Sox,9,6,August 16 2014,3
Baltimore Orioles,1,Cleveland Indians,6,0,August 16 2014,6
Seattle Mariners,1,Detroit Tigers,6,2,August 16 2014,4
Milwaukee Brewers,0,Los Angeles Dodgers,5,3,August 16 2014,2
Arizona D'Backs,1,Miami Marlins,3,1,August 16 2014,2
Kansas City Royals,1,Minnesota Twins,5,1,August 16 2014,4
Chicago Cubs,1,New York Mets,10,3,August 16 2014,7
Philadelphia Phillies,1,San Francisco Giants,11,5,August 16 2014,6
San Diego Padres,0,St. Louis Cardinals,14,9,August 16 2014,5
New York Yankees,0,Tampa Bay Rays,5,3,August 16 2014,2
LA Angels of Anaheim,0,Texas Rangers,9,5,August 16 2014,4
Pittsburgh Pirates,1,Washington Nationals,7,3,August 16 2014,4
Oakland Athletics,1,Atlanta Braves,7,3,August 17 2014,4
Houston Astros,0,Boston Red Sox,9,8,August 17 2014,1
Toronto Blue Jays,1,Chicago White Sox,12,5,August 17 2014,7
Baltimore Orioles,0,Cleveland Indians,5,4,August 17 2014,1
Cincinnati Reds,1,Colorado Rockies,19,9,August 17 2014,10
Cincinnati Reds,1,Colorado Rockies,15,5,August 17 2014,10
Seattle Mariners,0,Detroit Tigers,9,8,August 17 2014,1
Milwaukee Brewers,0,Los Angeles Dodgers,9,7,August 17 2014,2
Arizona D'Backs,1,Miami Marlins,13,3,August 17 2014,10
Kansas City Royals,0,Minnesota Twins,18,12,August 17 2014,6
Chicago Cubs,0,New York Mets,3,2,August 17 2014,1
Philadelphia Phillies,1,San Francisco Giants,7,2,August 17 2014,5
San Diego Padres,1,St. Louis Cardinals,13,6,August 17 2014,7
New York Yankees,0,Tampa Bay Rays,6,4,August 17 2014,2
LA Angels of Anaheim,1,Texas Rangers,5,2,August 17 2014,3
Pittsburgh Pirates,1,Washington Nationals,11,5,August 17 2014,6
LA Angels of Anaheim,0,Boston Red Sox,6,4,August 18 2014,2
Baltimore Orioles,0,Chicago White Sox,10,8,August 18 2014,2
Kansas City Royals,0,Minnesota Twins,10,6,August 18 2014,4
Chicago Cubs,0,New York Mets,5,4,August 18 2014,1
Seattle Mariners,1,Philadelphia Phillies,5,1,August 18 2014,4
Atlanta Braves,0,Pittsburgh Pirates,10,7,August 18 2014,3
Cincinnati Reds,1,St. Louis Cardinals,11,5,August 18 2014,6
Arizona D'Backs,1,Washington Nationals,9,4,August 18 2014,5
LA Angels of Anaheim,0,Boston Red Sox,7,4,August 19 2014,3
Baltimore Orioles,0,Chicago White Sox,6,5,August 19 2014,1
San Francisco Giants,1,Chicago Cubs,3,1,August 19 2014,2
Kansas City Royals,0,Colorado Rockies,11,7,August 19 2014,4
San Diego Padres,1,Los Angeles Dodgers,14,6,August 19 2014,8
Texas Rangers,1,Miami Marlins,7,3,August 19 2014,4
Toronto Blue Jays,1,Milwaukee Brewers,7,1,August 19 2014,6
Cleveland Indians,0,Minnesota Twins,12,7,August 19 2014,5
Houston Astros,0,New York Yankees,11,7,August 19 2014,4
New York Mets,1,Oakland Athletics,8,2,August 19 2014,6
Seattle Mariners,0,Philadelphia Phillies,7,5,August 19 2014,2
Atlanta Braves,0,Pittsburgh Pirates,14,11,August 19 2014,3
Cincinnati Reds,1,St. Louis Cardinals,9,4,August 19 2014,5
Detroit Tigers,0,Tampa Bay Rays,14,8,August 19 2014,6
Arizona D'Backs,1,Washington Nationals,9,1,August 19 2014,8
LA Angels of Anaheim,0,Boston Red Sox,11,8,August 20 2014,3
Baltimore Orioles,0,Chicago White Sox,7,4,August 20 2014,3
San Francisco Giants,0,Chicago Cubs,11,8,August 20 2014,3
Kansas City Royals,1,Colorado Rockies,7,2,August 20 2014,5
San Diego Padres,0,Los Angeles Dodgers,5,4,August 20 2014,1
Texas Rangers,0,Miami Marlins,9,5,August 20 2014,4
Toronto Blue Jays,0,Milwaukee Brewers,14,9,August 20 2014,5
Cleveland Indians,0,Minnesota Twins,5,5,August 20 2014,0
Houston Astros,0,New York Yankees,7,5,August 20 2014,2
New York Mets,0,Oakland Athletics,13,8,August 20 2014,5
Seattle Mariners,1,Philadelphia Phillies,7,3,August 20 2014,4
Atlanta Braves,1,Pittsburgh Pirates,5,2,August 20 2014,3
Cincinnati Reds,1,St. Louis Cardinals,10,3,August 20 2014,7
Detroit Tigers,0,Tampa Bay Rays,6,6,August 20 2014,0
Arizona D'Backs,1,Washington Nationals,5,2,August 20 2014,3
LA Angels of Anaheim,0,Boston Red Sox,2,2,August 21 2014,0
San Francisco Giants,0,Chicago Cubs,8,5,August 21 2014,3
Atlanta Braves,0,Cincinnati Reds,8,8,August 21 2014,0
San Diego Padres,1,Los Angeles Dodgers,3,1,August 21 2014,2
Cleveland Indians,1,Minnesota Twins,5,1,August 21 2014,4
Houston Astros,1,New York Yankees,3,0,August 21 2014,3
Detroit Tigers,1,Tampa Bay Rays,1,0,August 21 2014,1
Arizona D'Backs,1,Washington Nationals,1,0,August 21 2014,1
San Diego Padres,1,Arizona D'Backs,6,1,August 22 2014,5
Seattle Mariners,0,Boston Red Sox,8,5,August 22 2014,3
Baltimore Orioles,1,Chicago Cubs,5,1,August 22 2014,4
Atlanta Braves,0,Cincinnati Reds,4,3,August 22 2014,1
Houston Astros,0,Cleveland Indians,6,5,August 22 2014,1
Miami Marlins,0,Colorado Rockies,18,13,August 22 2014,5
New York Mets,1,Los Angeles Dodgers,8,2,August 22 2014,6
Pittsburgh Pirates,0,Milwaukee Brewers,11,8,August 22 2014,3
Detroit Tigers,1,Minnesota Twins,26,6,August 22 2014,20
Chicago White Sox,1,New York Yankees,7,3,August 22 2014,4
LA Angels of Anaheim,1,Oakland Athletics,8,3,August 22 2014,5
St. Louis Cardinals,1,Philadelphia Phillies,9,4,August 22 2014,5
Kansas City Royals,0,Texas Rangers,9,6,August 22 2014,3
Tampa Bay Rays,0,Toronto Blue Jays,8,8,August 22 2014,0
San Francisco Giants,0,Washington Nationals,13,10,August 22 2014,3
San Diego Padres,1,Arizona D'Backs,7,2,August 23 2014,5
Seattle Mariners,0,Boston Red Sox,10,7,August 23 2014,3
Baltimore Orioles,1,Chicago Cubs,9,2,August 23 2014,7
Atlanta Braves,1,Cincinnati Reds,1,0,August 23 2014,1
Houston Astros,1,Cleveland Indians,5,2,August 23 2014,3
Miami Marlins,1,Colorado Rockies,9,4,August 23 2014,5
New York Mets,1,Los Angeles Dodgers,11,4,August 23 2014,7
Pittsburgh Pirates,0,Milwaukee Brewers,12,10,August 23 2014,2
Detroit Tigers,1,Minnesota Twins,16,4,August 23 2014,12
Detroit Tigers,0,Minnesota Twins,14,8,August 23 2014,6
Chicago White Sox,1,New York Yankees,8,3,August 23 2014,5
LA Angels of Anaheim,1,Oakland Athletics,3,1,August 23 2014,2
St. Louis Cardinals,0,Philadelphia Phillies,11,6,August 23 2014,5
Kansas City Royals,0,Texas Rangers,9,6,August 23 2014,3
Tampa Bay Rays,1,Toronto Blue Jays,9,4,August 23 2014,5
San Francisco Giants,1,Washington Nationals,8,2,August 23 2014,6
San Diego Padres,0,Arizona D'Backs,11,7,August 24 2014,4
Seattle Mariners,0,Boston Red Sox,14,8,August 24 2014,6
Baltimore Orioles,1,Chicago Cubs,3,1,August 24 2014,2
Atlanta Braves,1,Cincinnati Reds,8,3,August 24 2014,5
Houston Astros,1,Cleveland Indians,4,1,August 24 2014,3
Miami Marlins,1,Colorado Rockies,11,4,August 24 2014,7
New York Mets,0,Los Angeles Dodgers,14,11,August 24 2014,3
Pittsburgh Pirates,1,Milwaukee Brewers,7,3,August 24 2014,4
Detroit Tigers,0,Minnesota Twins,17,13,August 24 2014,4
Chicago White Sox,1,New York Yankees,11,4,August 24 2014,7
LA Angels of Anaheim,0,Oakland Athletics,13,9,August 24 2014,4
St. Louis Cardinals,1,Philadelphia Phillies,8,1,August 24 2014,7
Kansas City Royals,1,Texas Rangers,4,1,August 24 2014,3
Tampa Bay Rays,0,Toronto Blue Jays,3,2,August 24 2014,1
San Francisco Giants,1,Washington Nationals,20,6,August 24 2014,14
Miami Marlins,0,LA Angels of Anaheim,8,7,August 25 2014,1
Tampa Bay Rays,1,Baltimore Orioles,10,1,August 25 2014,9
Oakland Athletics,0,Houston Astros,10,8,August 25 2014,2
New York Yankees,0,Kansas City Royals,9,8,August 25 2014,1
Washington Nationals,1,Philadelphia Phillies,5,2,August 25 2014,3
St. Louis Cardinals,0,Pittsburgh Pirates,5,3,August 25 2014,2
Milwaukee Brewers,0,San Diego Padres,11,10,August 25 2014,1
Texas Rangers,0,Seattle Mariners,2,2,August 25 2014,0
Colorado Rockies,0,San Francisco Giants,5,3,August 25 2014,2
Boston Red Sox,0,Toronto Blue Jays,7,4,August 25 2014,3
Miami Marlins,1,LA Angels of Anaheim,10,2,August 26 2014,8
Los Angeles Dodgers,0,Arizona D'Backs,14,9,August 26 2014,5
Tampa Bay Rays,1,Baltimore Orioles,6,2,August 26 2014,4
Cleveland Indians,0,Chicago White Sox,14,8,August 26 2014,6
Chicago Cubs,0,Cincinnati Reds,3,3,August 26 2014,0
New York Yankees,1,Detroit Tigers,7,2,August 26 2014,5
Oakland Athletics,1,Houston Astros,6,2,August 26 2014,4
Minnesota Twins,1,Kansas City Royals,3,1,August 26 2014,2
Atlanta Braves,1,New York Mets,5,2,August 26 2014,3
Washington Nationals,1,Philadelphia Phillies,7,3,August 26 2014,4
St. Louis Cardinals,1,Pittsburgh Pirates,7,2,August 26 2014,5
Milwaukee Brewers,1,San Diego Padres,5,1,August 26 2014,4
Texas Rangers,1,Seattle Mariners,5,0,August 26 2014,5
Colorado Rockies,1,San Francisco Giants,3,0,August 26 2014,3
Boston Red Sox,0,Toronto Blue Jays,18,11,August 26 2014,7
Miami Marlins,1,LA Angels of Anaheim,7,1,August 27 2014,6
Los Angeles Dodgers,0,Arizona D'Backs,4,3,August 27 2014,1
Tampa Bay Rays,0,Baltimore Orioles,4,3,August 27 2014,1
Cleveland Indians,1,Chicago White Sox,5,2,August 27 2014,3
Chicago Cubs,1,Cincinnati Reds,12,5,August 27 2014,7
New York Yankees,0,Detroit Tigers,12,8,August 27 2014,4
Oakland Athletics,0,Houston Astros,9,5,August 27 2014,4
Minnesota Twins,1,Kansas City Royals,7,1,August 27 2014,6
Atlanta Braves,0,New York Mets,5,3,August 27 2014,2
Washington Nationals,1,Philadelphia Phillies,12,4,August 27 2014,8
St. Louis Cardinals,1,Pittsburgh Pirates,4,1,August 27 2014,3
Milwaukee Brewers,1,San Diego Padres,5,2,August 27 2014,3
Texas Rangers,0,Seattle Mariners,16,12,August 27 2014,4
Colorado Rockies,1,San Francisco Giants,6,2,August 27 2014,4
Boston Red Sox,1,Toronto Blue Jays,7,2,August 27 2014,5
Oakland Athletics,1,LA Angels of Anaheim,7,3,August 28 2014,4
Tampa Bay Rays,1,Baltimore Orioles,9,4,August 28 2014,5
Cleveland Indians,0,Chicago White Sox,5,3,August 28 2014,2
Chicago Cubs,1,Cincinnati Reds,9,2,August 28 2014,7
New York Yankees,1,Detroit Tigers,5,2,August 28 2014,3
Texas Rangers,1,Houston Astros,6,2,August 28 2014,4
Minnesota Twins,0,Kansas City Royals,16,11,August 28 2014,5
Atlanta Braves,0,New York Mets,7,6,August 28 2014,1
Colorado Rockies,1,San Francisco Giants,5,1,August 28 2014,4
Oakland Athletics,1,LA Angels of Anaheim,4,0,August 29 2014,4
Colorado Rockies,1,Arizona D'Backs,7,2,August 29 2014,5
Miami Marlins,1,Atlanta Braves,7,2,August 29 2014,5
Minnesota Twins,1,Baltimore Orioles,10,1,August 29 2014,9
Detroit Tigers,0,Chicago White Sox,8,7,August 29 2014,1
Texas Rangers,0,Houston Astros,19,13,August 29 2014,6
Cleveland Indians,0,Kansas City Royals,7,6,August 29 2014,1
Philadelphia Phillies,1,New York Mets,5,1,August 29 2014,4
Cincinnati Reds,1,Pittsburgh Pirates,3,1,August 29 2014,2
Los Angeles Dodgers,1,San Diego Padres,5,2,August 29 2014,3
Washington Nationals,0,Seattle Mariners,11,8,August 29 2014,3
Milwaukee Brewers,1,San Francisco Giants,15,2,August 29 2014,13
Chicago Cubs,0,St. Louis Cardinals,9,7,August 29 2014,2
Boston Red Sox,0,Tampa Bay Rays,12,8,August 29 2014,4
New York Yankees,0,Toronto Blue Jays,9,6,August 29 2014,3
Oakland Athletics,1,LA Angels of Anaheim,2,0,August 30 2014,2
Colorado Rockies,0,Arizona D'Backs,2,2,August 30 2014,0
Miami Marlins,0,Atlanta Braves,4,4,August 30 2014,0
Minnesota Twins,1,Baltimore Orioles,5,2,August 30 2014,3
Detroit Tigers,1,Chicago White Sox,9,3,August 30 2014,6
Detroit Tigers,0,Chicago White Sox,12,8,August 30 2014,4
Texas Rangers,1,Houston Astros,2,0,August 30 2014,2
Cleveland Indians,0,Kansas City Royals,5,3,August 30 2014,2
Philadelphia Phillies,0,New York Mets,9,7,August 30 2014,2
Cincinnati Reds,1,Pittsburgh Pirates,5,2,August 30 2014,3
Los Angeles Dodgers,1,San Diego Padres,3,1,August 30 2014,2
Washington Nationals,0,Seattle Mariners,4,3,August 30 2014,1
Milwaukee Brewers,1,San Francisco Giants,4,1,August 30 2014,3
Chicago Cubs,0,St. Louis Cardinals,6,5,August 30 2014,1
Chicago Cubs,1,St. Louis Cardinals,15,2,August 30 2014,13
Boston Red Sox,1,Tampa Bay Rays,7,0,August 30 2014,7
New York Yankees,1,Toronto Blue Jays,2,0,August 30 2014,2
Oakland Athletics,1,LA Angels of Anaheim,9,1,August 31 2014,8
Colorado Rockies,1,Arizona D'Backs,8,2,August 31 2014,6
Miami Marlins,1,Atlanta Braves,1,0,August 31 2014,1
Minnesota Twins,1,Baltimore Orioles,20,8,August 31 2014,12
Detroit Tigers,1,Chicago White Sox,8,2,August 31 2014,6
Texas Rangers,1,Houston Astros,5,2,August 31 2014,3
Cleveland Indians,0,Kansas City Royals,7,4,August 31 2014,3
Philadelphia Phillies,1,New York Mets,11,5,August 31 2014,6
Cincinnati Reds,0,Pittsburgh Pirates,5,3,August 31 2014,2
Los Angeles Dodgers,0,San Diego Padres,8,7,August 31 2014,1
Washington Nationals,1,Seattle Mariners,8,3,August 31 2014,5
Milwaukee Brewers,1,San Francisco Giants,20,5,August 31 2014,15
Chicago Cubs,1,St. Louis Cardinals,15,6,August 31 2014,9
Boston Red Sox,0,Tampa Bay Rays,3,3,August 31 2014,0
New York Yankees,1,Toronto Blue Jays,7,3,August 31 2014,4
Philadelphia Phillies,0,Atlanta Braves,7,7,September 1 2014,0
Minnesota Twins,0,Baltimore Orioles,10,6,September 1 2014,4
Milwaukee Brewers,1,Chicago Cubs,6,2,September 1 2014,4
Detroit Tigers,0,Cleveland Indians,13,12,September 1 2014,1
San Francisco Giants,1,Colorado Rockies,19,9,September 1 2014,10
Texas Rangers,1,Kansas City Royals,7,3,September 1 2014,4
Washington Nationals,0,Los Angeles Dodgers,10,6,September 1 2014,4
New York Mets,1,Miami Marlins,15,6,September 1 2014,9
Seattle Mariners,1,Oakland Athletics,7,1,September 1 2014,6
Arizona D'Backs,1,San Diego Padres,4,1,September 1 2014,3
Pittsburgh Pirates,1,St. Louis Cardinals,9,4,September 1 2014,5
Boston Red Sox,1,Tampa Bay Rays,7,3,September 1 2014,4
Philadelphia Phillies,0,Atlanta Braves,4,4,September 2 2014,0
Cincinnati Reds,1,Baltimore Orioles,9,4,September 2 2014,5
Milwaukee Brewers,1,Chicago Cubs,8,1,September 2 2014,7
Detroit Tigers,0,Cleveland Indians,6,4,September 2 2014,2
San Francisco Giants,0,Colorado Rockies,19,12,September 2 2014,7
LA Angels of Anaheim,1,Houston Astros,11,3,September 2 2014,8
Texas Rangers,1,Kansas City Royals,3,1,September 2 2014,2
Washington Nationals,1,Los Angeles Dodgers,5,1,September 2 2014,4
New York Mets,0,Miami Marlins,14,8,September 2 2014,6
Chicago White Sox,0,Minnesota Twins,9,6,September 2 2014,3
Boston Red Sox,0,New York Yankees,13,9,September 2 2014,4
Seattle Mariners,0,Oakland Athletics,11,6,September 2 2014,5
Arizona D'Backs,1,San Diego Padres,3,1,September 2 2014,2
Pittsburgh Pirates,1,St. Louis Cardinals,10,4,September 2 2014,6
Toronto Blue Jays,0,Tampa Bay Rays,10,8,September 2 2014,2
Philadelphia Phillies,1,Atlanta Braves,11,4,September 3 2014,7
Cincinnati Reds,1,Baltimore Orioles,6,0,September 3 2014,6
Milwaukee Brewers,1,Chicago Cubs,8,2,September 3 2014,6
Detroit Tigers,1,Cleveland Indians,7,0,September 3 2014,7
San Francisco Giants,1,Colorado Rockies,11,2,September 3 2014,9
LA Angels of Anaheim,1,Houston Astros,5,1,September 3 2014,4
Texas Rangers,1,Kansas City Royals,5,1,September 3 2014,4
Washington Nationals,0,Los Angeles Dodgers,13,8,September 3 2014,5
New York Mets,0,Miami Marlins,7,4,September 3 2014,3
Chicago White Sox,1,Minnesota Twins,15,4,September 3 2014,11
Boston Red Sox,1,New York Yankees,6,1,September 3 2014,5
Seattle Mariners,0,Oakland Athletics,3,2,September 3 2014,1
Arizona D'Backs,0,San Diego Padres,7,6,September 3 2014,1
Pittsburgh Pirates,1,St. Louis Cardinals,1,0,September 3 2014,1
Toronto Blue Jays,0,Tampa Bay Rays,11,7,September 3 2014,4
Cincinnati Reds,1,Baltimore Orioles,16,7,September 4 2014,9
Detroit Tigers,0,Cleveland Indians,15,11,September 4 2014,4
St. Louis Cardinals,0,Milwaukee Brewers,5,3,September 4 2014,2
LA Angels of Anaheim,0,Minnesota Twins,9,5,September 4 2014,4
Boston Red Sox,1,New York Yankees,9,4,September 4 2014,5
Arizona D'Backs,0,San Diego Padres,6,5,September 4 2014,1
Toronto Blue Jays,0,Tampa Bay Rays,1,1,September 4 2014,0
Seattle Mariners,0,Texas Rangers,12,10,September 4 2014,2
Toronto Blue Jays,1,Boston Red Sox,17,8,September 5 2014,9
Pittsburgh Pirates,0,Chicago Cubs,8,5,September 5 2014,3
New York Mets,0,Cincinnati Reds,19,14,September 5 2014,5
Chicago White Sox,1,Cleveland Indians,3,1,September 5 2014,2
San Diego Padres,1,Colorado Rockies,3,0,September 5 2014,3
San Francisco Giants,0,Detroit Tigers,10,8,September 5 2014,2
Arizona D'Backs,1,Los Angeles Dodgers,3,1,September 5 2014,2
Atlanta Braves,1,Miami Marlins,14,3,September 5 2014,11
St. Louis Cardinals,1,Milwaukee Brewers,8,2,September 5 2014,6
LA Angels of Anaheim,0,Minnesota Twins,13,7,September 5 2014,6
Kansas City Royals,0,New York Yankees,1,1,September 5 2014,0
Houston Astros,0,Oakland Athletics,7,4,September 5 2014,3
Baltimore Orioles,1,Tampa Bay Rays,3,0,September 5 2014,3
Seattle Mariners,0,Texas Rangers,12,7,September 5 2014,5
Philadelphia Phillies,0,Washington Nationals,17,9,September 5 2014,8
Toronto Blue Jays,1,Boston Red Sox,7,3,September 6 2014,4
Pittsburgh Pirates,0,Chicago Cubs,5,5,September 6 2014,0
New York Mets,1,Cincinnati Reds,3,1,September 6 2014,2
Chicago White Sox,1,Cleveland Indians,4,1,September 6 2014,3
San Diego Padres,1,Colorado Rockies,13,6,September 6 2014,7
San Francisco Giants,0,Detroit Tigers,9,5,September 6 2014,4
Arizona D'Backs,1,Los Angeles Dodgers,7,2,September 6 2014,5
Atlanta Braves,0,Miami Marlins,7,4,September 6 2014,3
St. Louis Cardinals,0,Milwaukee Brewers,8,5,September 6 2014,3
LA Angels of Anaheim,0,Minnesota Twins,13,8,September 6 2014,5
Kansas City Royals,1,New York Yankees,8,2,September 6 2014,6
Houston Astros,1,Oakland Athletics,7,3,September 6 2014,4
Baltimore Orioles,1,Tampa Bay Rays,5,2,September 6 2014,3
Seattle Mariners,0,Texas Rangers,6,4,September 6 2014,2
Philadelphia Phillies,0,Washington Nationals,4,3,September 6 2014,1
Toronto Blue Jays,0,Boston Red Sox,4,3,September 7 2014,1
Pittsburgh Pirates,0,Chicago Cubs,14,10,September 7 2014,4
New York Mets,0,Cincinnati Reds,7,4,September 7 2014,3
Chicago White Sox,1,Cleveland Indians,2,0,September 7 2014,2
San Diego Padres,1,Colorado Rockies,6,0,September 7 2014,6
San Francisco Giants,1,Detroit Tigers,7,1,September 7 2014,6
Arizona D'Backs,1,Los Angeles Dodgers,9,2,September 7 2014,7
Atlanta Braves,1,Miami Marlins,4,0,September 7 2014,4
St. Louis Cardinals,0,Milwaukee Brewers,10,9,September 7 2014,1
LA Angels of Anaheim,0,Minnesota Twins,18,14,September 7 2014,4
Kansas City Royals,0,New York Yankees,2,2,September 7 2014,0
Houston Astros,0,Oakland Athletics,7,4,September 7 2014,3
Baltimore Orioles,0,Tampa Bay Rays,12,7,September 7 2014,5
Seattle Mariners,1,Texas Rangers,1,0,September 7 2014,1
Philadelphia Phillies,1,Washington Nationals,5,2,September 7 2014,3
Baltimore Orioles,0,Boston Red Sox,4,4,September 8 2014,0
Oakland Athletics,1,Chicago White Sox,9,4,September 8 2014,5
St. Louis Cardinals,0,Cincinnati Reds,5,5,September 8 2014,0
LA Angels of Anaheim,0,Cleveland Indians,15,12,September 8 2014,3
Kansas City Royals,1,Detroit Tigers,14,5,September 8 2014,9
San Diego Padres,1,Los Angeles Dodgers,13,4,September 8 2014,9
Miami Marlins,0,Milwaukee Brewers,10,6,September 8 2014,4
Colorado Rockies,1,New York Mets,5,2,September 8 2014,3
Pittsburgh Pirates,0,Philadelphia Phillies,10,6,September 8 2014,4
Houston Astros,1,Seattle Mariners,5,1,September 8 2014,4
Chicago Cubs,1,Toronto Blue Jays,8,0,September 8 2014,8
Atlanta Braves,1,Washington Nationals,3,1,September 8 2014,2
Baltimore Orioles,0,Boston Red Sox,5,4,September 9 2014,1
Oakland Athletics,0,Chicago White Sox,13,11,September 9 2014,2
St. Louis Cardinals,1,Cincinnati Reds,14,5,September 9 2014,9
Minnesota Twins,0,Cleveland Indians,7,4,September 9 2014,3
Kansas City Royals,1,Detroit Tigers,6,2,September 9 2014,4
San Diego Padres,0,Los Angeles Dodgers,9,6,September 9 2014,3
Miami Marlins,0,Milwaukee Brewers,9,6,September 9 2014,3
Tampa Bay Rays,0,New York Yankees,7,4,September 9 2014,3
Colorado Rockies,1,New York Mets,2,0,September 9 2014,2
Pittsburgh Pirates,1,Philadelphia Phillies,7,3,September 9 2014,4
Houston Astros,0,Seattle Mariners,3,2,September 9 2014,1
Arizona D'Backs,1,San Francisco Giants,6,1,September 9 2014,5
LA Angels of Anaheim,0,Texas Rangers,12,9,September 9 2014,3
Chicago Cubs,1,Toronto Blue Jays,11,2,September 9 2014,9
Atlanta Braves,1,Washington Nationals,10,4,September 9 2014,6
Baltimore Orioles,0,Boston Red Sox,16,10,September 10 2014,6
Oakland Athletics,1,Chicago White Sox,3,1,September 10 2014,2
St. Louis Cardinals,1,Cincinnati Reds,6,2,September 10 2014,4
Kansas City Royals,0,Detroit Tigers,3,3,September 10 2014,0
San Diego Padres,1,Los Angeles Dodgers,4,0,September 10 2014,4
Miami Marlins,1,Milwaukee Brewers,5,1,September 10 2014,4
Tampa Bay Rays,1,New York Yankees,13,5,September 10 2014,8
Colorado Rockies,1,New York Mets,2,0,September 10 2014,2
Pittsburgh Pirates,0,Philadelphia Phillies,9,6,September 10 2014,3
Houston Astros,0,Seattle Mariners,7,5,September 10 2014,2
Arizona D'Backs,1,San Francisco Giants,5,0,September 10 2014,5
LA Angels of Anaheim,0,Texas Rangers,9,8,September 10 2014,1
Chicago Cubs,1,Toronto Blue Jays,12,1,September 10 2014,11
Atlanta Braves,0,Washington Nationals,8,6,September 10 2014,2
Oakland Athletics,1,Chicago White Sox,1,0,September 11 2014,1
St. Louis Cardinals,1,Cincinnati Reds,1,0,September 11 2014,1
Minnesota Twins,1,Cleveland Indians,10,2,September 11 2014,8
Minnesota Twins,1,Cleveland Indians,2,0,September 11 2014,2
Boston Red Sox,0,Kansas City Royals,9,6,September 11 2014,3
Miami Marlins,1,Milwaukee Brewers,6,2,September 11 2014,4
Tampa Bay Rays,1,New York Yankees,9,4,September 11 2014,5
Washington Nationals,0,New York Mets,8,6,September 11 2014,2
Pittsburgh Pirates,0,Philadelphia Phillies,5,4,September 11 2014,1
Arizona D'Backs,1,San Francisco Giants,8,2,September 11 2014,6
LA Angels of Anaheim,0,Texas Rangers,10,7,September 11 2014,3
Houston Astros,1,LA Angels of Anaheim,14,3,September 12 2014,11
San Diego Padres,0,Arizona D'Backs,11,6,September 12 2014,5
New York Yankees,1,Baltimore Orioles,3,1,September 12 2014,2
New York Yankees,1,Baltimore Orioles,5,0,September 12 2014,5
Cleveland Indians,1,Detroit Tigers,9,2,September 12 2014,7
Boston Red Sox,0,Kansas City Royals,6,4,September 12 2014,2
Cincinnati Reds,1,Milwaukee Brewers,5,2,September 12 2014,3
Washington Nationals,1,New York Mets,7,3,September 12 2014,4
Miami Marlins,1,Philadelphia Phillies,4,1,September 12 2014,3
Chicago Cubs,1,Pittsburgh Pirates,10,3,September 12 2014,7
Oakland Athletics,1,Seattle Mariners,6,2,September 12 2014,4
Los Angeles Dodgers,1,San Francisco Giants,9,0,September 12 2014,9
Colorado Rockies,1,St. Louis Cardinals,6,1,September 12 2014,5
Atlanta Braves,1,Texas Rangers,3,1,September 12 2014,2
Tampa Bay Rays,0,Toronto Blue Jays,1,1,September 12 2014,0
Houston Astros,1,LA Angels of Anaheim,7,2,September 13 2014,5
San Diego Padres,1,Arizona D'Backs,14,4,September 13 2014,10
New York Yankees,0,Baltimore Orioles,5,3,September 13 2014,2
Minnesota Twins,1,Chicago White Sox,6,1,September 13 2014,5
Minnesota Twins,1,Chicago White Sox,13,6,September 13 2014,7
Cleveland Indians,1,Detroit Tigers,9,4,September 13 2014,5
Boston Red Sox,1,Kansas City Royals,8,1,September 13 2014,7
Cincinnati Reds,0,Milwaukee Brewers,6,5,September 13 2014,1
Washington Nationals,0,New York Mets,13,10,September 13 2014,3
Miami Marlins,1,Philadelphia Phillies,3,1,September 13 2014,2
Chicago Cubs,0,Pittsburgh Pirates,10,6,September 13 2014,4
Oakland Athletics,0,Seattle Mariners,5,3,September 13 2014,2
Los Angeles Dodgers,0,San Francisco Giants,17,17,September 13 2014,0
Colorado Rockies,1,St. Louis Cardinals,9,4,September 13 2014,5
Atlanta Braves,1,Texas Rangers,5,2,September 13 2014,3
Tampa Bay Rays,1,Toronto Blue Jays,9,3,September 13 2014,6
Houston Astros,0,LA Angels of Anaheim,7,6,September 14 2014,1
San Diego Padres,1,Arizona D'Backs,14,6,September 14 2014,8
New York Yankees,1,Baltimore Orioles,5,2,September 14 2014,3
Minnesota Twins,0,Chicago White Sox,10,6,September 14 2014,4
Cleveland Indians,1,Detroit Tigers,10,4,September 14 2014,6
Boston Red Sox,0,Kansas City Royals,12,8,September 14 2014,4
Cincinnati Reds,1,Milwaukee Brewers,11,2,September 14 2014,9
Washington Nationals,0,New York Mets,3,3,September 14 2014,0
Miami Marlins,0,Philadelphia Phillies,9,5,September 14 2014,4
Chicago Cubs,1,Pittsburgh Pirates,10,3,September 14 2014,7
Oakland Athletics,0,Seattle Mariners,4,4,September 14 2014,0
Los Angeles Dodgers,0,San Francisco Giants,6,4,September 14 2014,2
Colorado Rockies,1,St. Louis Cardinals,5,1,September 14 2014,4
Atlanta Braves,1,Texas Rangers,13,3,September 14 2014,10
Tampa Bay Rays,0,Toronto Blue Jays,11,6,September 14 2014,5
Seattle Mariners,1,LA Angels of Anaheim,9,1,September 15 2014,8
San Francisco Giants,1,Arizona D'Backs,8,2,September 15 2014,6
Washington Nationals,0,Atlanta Braves,6,4,September 15 2014,2
Toronto Blue Jays,1,Baltimore Orioles,7,2,September 15 2014,5
Cincinnati Reds,1,Chicago Cubs,1,0,September 15 2014,1
Los Angeles Dodgers,0,Colorado Rockies,14,11,September 15 2014,3
Cleveland Indians,1,Houston Astros,4,1,September 15 2014,3
Chicago White Sox,1,Kansas City Royals,7,3,September 15 2014,4
Detroit Tigers,0,Minnesota Twins,14,8,September 15 2014,6
Miami Marlins,0,New York Mets,11,6,September 15 2014,5
Philadelphia Phillies,1,San Diego Padres,1,0,September 15 2014,1
New York Yankees,1,Tampa Bay Rays,1,0,September 15 2014,1
Seattle Mariners,0,LA Angels of Anaheim,15,13,September 16 2014,2
San Francisco Giants,0,Arizona D'Backs,3,2,September 16 2014,1
Washington Nationals,0,Atlanta Braves,3,3,September 16 2014,0
Toronto Blue Jays,1,Baltimore Orioles,10,2,September 16 2014,8
Cincinnati Reds,1,Chicago Cubs,7,0,September 16 2014,7
Los Angeles Dodgers,1,Colorado Rockies,14,4,September 16 2014,10
Cleveland Indians,0,Houston Astros,6,4,September 16 2014,2
Chicago White Sox,0,Kansas City Royals,12,7,September 16 2014,5
Detroit Tigers,1,Minnesota Twins,7,3,September 16 2014,4
Miami Marlins,1,New York Mets,10,1,September 16 2014,9
Texas Rangers,0,Oakland Athletics,9,6,September 16 2014,3
Boston Red Sox,1,Pittsburgh Pirates,4,0,September 16 2014,4
Philadelphia Phillies,1,San Diego Padres,9,4,September 16 2014,5
Milwaukee Brewers,0,St. Louis Cardinals,5,3,September 16 2014,2
New York Yankees,1,Tampa Bay Rays,7,1,September 16 2014,6
Seattle Mariners,1,LA Angels of Anaheim,5,0,September 17 2014,5
San Francisco Giants,0,Arizona D'Backs,6,4,September 17 2014,2
Washington Nationals,1,Atlanta Braves,4,1,September 17 2014,3
Toronto Blue Jays,1,Baltimore Orioles,7,1,September 17 2014,6
Cincinnati Reds,1,Chicago Cubs,4,1,September 17 2014,3
Los Angeles Dodgers,1,Colorado Rockies,18,2,September 17 2014,16
Cleveland Indians,0,Houston Astros,2,2,September 17 2014,0
Chicago White Sox,1,Kansas City Royals,8,2,September 17 2014,6
Detroit Tigers,1,Minnesota Twins,12,4,September 17 2014,8
Miami Marlins,0,New York Mets,7,4,September 17 2014,3
Texas Rangers,0,Oakland Athletics,7,6,September 17 2014,1
Boston Red Sox,1,Pittsburgh Pirates,10,1,September 17 2014,9
Philadelphia Phillies,0,San Diego Padres,7,5,September 17 2014,2
Milwaukee Brewers,1,St. Louis Cardinals,2,0,September 17 2014,2
New York Yankees,0,Tampa Bay Rays,5,3,September 17 2014,2
Seattle Mariners,0,LA Angels of Anaheim,4,3,September 18 2014,1
Los Angeles Dodgers,0,Chicago Cubs,12,8,September 18 2014,4
Arizona D'Backs,1,Colorado Rockies,13,6,September 18 2014,7
Cleveland Indians,0,Houston Astros,3,2,September 18 2014,1
Washington Nationals,0,Miami Marlins,8,6,September 18 2014,2
Toronto Blue Jays,1,New York Yankees,5,2,September 18 2014,3
Texas Rangers,0,Oakland Athletics,9,7,September 18 2014,2
Boston Red Sox,1,Pittsburgh Pirates,5,2,September 18 2014,3
Philadelphia Phillies,1,San Diego Padres,10,3,September 18 2014,7
Milwaukee Brewers,1,St. Louis Cardinals,5,2,September 18 2014,3
Texas Rangers,0,LA Angels of Anaheim,15,12,September 19 2014,3
New York Mets,0,Atlanta Braves,5,5,September 19 2014,0
Boston Red Sox,0,Baltimore Orioles,8,5,September 19 2014,3
Los Angeles Dodgers,0,Chicago Cubs,19,14,September 19 2014,5
Arizona D'Backs,1,Colorado Rockies,18,3,September 19 2014,15
Seattle Mariners,0,Houston Astros,15,10,September 19 2014,5
Detroit Tigers,0,Kansas City Royals,11,10,September 19 2014,1
Washington Nationals,0,Miami Marlins,5,3,September 19 2014,2
Cleveland Indians,1,Minnesota Twins,9,4,September 19 2014,5
Toronto Blue Jays,1,New York Yankees,8,3,September 19 2014,5
Philadelphia Phillies,1,Oakland Athletics,4,1,September 19 2014,3
Milwaukee Brewers,1,Pittsburgh Pirates,6,2,September 19 2014,4
San Francisco Giants,1,San Diego Padres,5,0,September 19 2014,5
Cincinnati Reds,1,St. Louis Cardinals,3,1,September 19 2014,2
Chicago White Sox,0,Tampa Bay Rays,7,4,September 19 2014,3
Texas Rangers,1,LA Angels of Anaheim,13,5,September 20 2014,8
New York Mets,0,Atlanta Braves,6,4,September 20 2014,2
Boston Red Sox,1,Baltimore Orioles,9,2,September 20 2014,7
Los Angeles Dodgers,1,Chicago Cubs,15,7,September 20 2014,8
Arizona D'Backs,1,Colorado Rockies,6,1,September 20 2014,5
Seattle Mariners,1,Houston Astros,11,1,September 20 2014,10
Detroit Tigers,0,Kansas City Royals,5,3,September 20 2014,2
Washington Nationals,0,Miami Marlins,5,3,September 20 2014,2
Cleveland Indians,0,Minnesota Twins,10,7,September 20 2014,3
Toronto Blue Jays,0,New York Yankees,9,6,September 20 2014,3
Philadelphia Phillies,0,Oakland Athletics,3,3,September 20 2014,0
Milwaukee Brewers,0,Pittsburgh Pirates,1,1,September 20 2014,0
San Francisco Giants,1,San Diego Padres,5,2,September 20 2014,3
Cincinnati Reds,1,St. Louis Cardinals,12,4,September 20 2014,8
Chicago White Sox,1,Tampa Bay Rays,4,1,September 20 2014,3
Texas Rangers,0,LA Angels of Anaheim,3,2,September 21 2014,1
New York Mets,0,Atlanta Braves,12,10,September 21 2014,2
Boston Red Sox,0,Baltimore Orioles,5,3,September 21 2014,2
Los Angeles Dodgers,0,Chicago Cubs,13,8,September 21 2014,5
Arizona D'Backs,1,Colorado Rockies,11,3,September 21 2014,8
Seattle Mariners,1,Houston Astros,11,3,September 21 2014,8
Detroit Tigers,1,Kansas City Royals,7,2,September 21 2014,5
Washington Nationals,0,Miami Marlins,3,2,September 21 2014,1
Cleveland Indians,0,Minnesota Twins,9,7,September 21 2014,2
Toronto Blue Jays,1,New York Yankees,7,2,September 21 2014,5
Philadelphia Phillies,1,Oakland Athletics,14,6,September 21 2014,8
Milwaukee Brewers,1,Pittsburgh Pirates,1,0,September 21 2014,1
San Francisco Giants,1,San Diego Padres,10,2,September 21 2014,8
Cincinnati Reds,0,St. Louis Cardinals,9,7,September 21 2014,2
Chicago White Sox,0,Tampa Bay Rays,15,10,September 21 2014,5
Pittsburgh Pirates,0,Atlanta Braves,1,1,September 22 2014,0
St. Louis Cardinals,0,Chicago Cubs,8,8,September 22 2014,0
Kansas City Royals,0,Cleveland Indians,2,2,September 22 2014,0
Chicago White Sox,0,Detroit Tigers,2,2,September 22 2014,0
San Francisco Giants,0,Los Angeles Dodgers,7,5,September 22 2014,2
Arizona D'Backs,0,Minnesota Twins,8,6,September 22 2014,2
Baltimore Orioles,1,New York Yankees,5,0,September 22 2014,5
LA Angels of Anaheim,1,Oakland Athletics,12,4,September 22 2014,8
Colorado Rockies,1,San Diego Padres,1,0,September 22 2014,1
Houston Astros,1,Texas Rangers,7,3,September 22 2014,4
Seattle Mariners,1,Toronto Blue Jays,18,4,September 22 2014,14
Pittsburgh Pirates,0,Atlanta Braves,5,3,September 23 2014,2
Tampa Bay Rays,0,Boston Red Sox,8,6,September 23 2014,2
St. Louis Cardinals,1,Chicago Cubs,7,3,September 23 2014,4
Milwaukee Brewers,1,Cincinnati Reds,4,1,September 23 2014,3
Kansas City Royals,0,Cleveland Indians,8,7,September 23 2014,1
Chicago White Sox,1,Detroit Tigers,7,3,September 23 2014,4
San Francisco Giants,1,Los Angeles Dodgers,6,2,September 23 2014,4
Philadelphia Phillies,1,Miami Marlins,2,0,September 23 2014,2
Arizona D'Backs,1,Minnesota Twins,9,3,September 23 2014,6
Baltimore Orioles,0,New York Yankees,9,5,September 23 2014,4
LA Angels of Anaheim,0,Oakland Athletics,2,2,September 23 2014,0
Colorado Rockies,0,San Diego Padres,5,3,September 23 2014,2
Houston Astros,1,Texas Rangers,3,1,September 23 2014,2
Seattle Mariners,1,Toronto Blue Jays,12,2,September 23 2014,10
New York Mets,1,Washington Nationals,6,2,September 23 2014,4
Pittsburgh Pirates,1,Atlanta Braves,8,2,September 24 2014,6
Tampa Bay Rays,1,Boston Red Sox,14,3,September 24 2014,11
St. Louis Cardinals,1,Chicago Cubs,4,1,September 24 2014,3
Milwaukee Brewers,0,Cincinnati Reds,5,5,September 24 2014,0
Kansas City Royals,1,Cleveland Indians,10,4,September 24 2014,6
Chicago White Sox,1,Detroit Tigers,7,1,September 24 2014,6
San Francisco Giants,1,Los Angeles Dodgers,10,1,September 24 2014,9
Philadelphia Phillies,0,Miami Marlins,3,2,September 24 2014,1
Arizona D'Backs,1,Minnesota Twins,3,1,September 24 2014,2
Baltimore Orioles,0,New York Yankees,14,9,September 24 2014,5
LA Angels of Anaheim,0,Oakland Athletics,9,5,September 24 2014,4
Colorado Rockies,1,San Diego Padres,7,3,September 24 2014,4
Houston Astros,1,Texas Rangers,6,1,September 24 2014,5
Seattle Mariners,1,Toronto Blue Jays,1,0,September 24 2014,1
Pittsburgh Pirates,0,Atlanta Braves,11,10,September 25 2014,1
Tampa Bay Rays,1,Boston Red Sox,12,1,September 25 2014,11
Kansas City Royals,0,Chicago White Sox,9,6,September 25 2014,3
Milwaukee Brewers,1,Cincinnati Reds,8,3,September 25 2014,5
Minnesota Twins,1,Detroit Tigers,6,2,September 25 2014,4
Philadelphia Phillies,1,Miami Marlins,10,4,September 25 2014,6
Baltimore Orioles,1,New York Yankees,11,5,September 25 2014,6
San Diego Padres,1,San Francisco Giants,17,8,September 25 2014,9
Oakland Athletics,1,Texas Rangers,3,1,September 25 2014,2
Seattle Mariners,0,Toronto Blue Jays,12,7,September 25 2014,5
New York Mets,0,Washington Nationals,11,7,September 25 2014,4
New York Mets,1,Washington Nationals,3,0,September 25 2014,3
St. Louis Cardinals,0,Arizona D'Backs,13,7,September 26 2014,6
New York Yankees,0,Boston Red Sox,5,3,September 26 2014,2
Kansas City Royals,0,Chicago White Sox,4,3,September 26 2014,1
Pittsburgh Pirates,0,Cincinnati Reds,4,3,September 26 2014,1
Tampa Bay Rays,1,Cleveland Indians,1,0,September 26 2014,1
Minnesota Twins,0,Detroit Tigers,15,11,September 26 2014,4
Colorado Rockies,1,Los Angeles Dodgers,11,4,September 26 2014,7
Chicago Cubs,0,Milwaukee Brewers,10,6,September 26 2014,4
Houston Astros,0,New York Mets,4,3,September 26 2014,1
Atlanta Braves,1,Philadelphia Phillies,9,4,September 26 2014,5
LA Angels of Anaheim,1,Seattle Mariners,7,3,September 26 2014,4
San Diego Padres,0,San Francisco Giants,5,4,September 26 2014,1
Oakland Athletics,0,Texas Rangers,8,6,September 26 2014,2
Baltimore Orioles,1,Toronto Blue Jays,6,2,September 26 2014,4
Miami Marlins,1,Washington Nationals,4,0,September 26 2014,4
Miami Marlins,0,Washington Nationals,22,15,September 26 2014,7
St. Louis Cardinals,1,Arizona D'Backs,7,2,September 27 2014,5
New York Yankees,1,Boston Red Sox,14,4,September 27 2014,10
Kansas City Royals,1,Chicago White Sox,9,4,September 27 2014,5
Pittsburgh Pirates,1,Cincinnati Reds,16,6,September 27 2014,10
Tampa Bay Rays,0,Cleveland Indians,2,2,September 27 2014,0
Minnesota Twins,0,Detroit Tigers,15,12,September 27 2014,3
Colorado Rockies,1,Los Angeles Dodgers,11,5,September 27 2014,6
Chicago Cubs,1,Milwaukee Brewers,3,1,September 27 2014,2
Houston Astros,1,New York Mets,3,1,September 27 2014,2
Atlanta Braves,0,Philadelphia Phillies,6,4,September 27 2014,2
LA Angels of Anaheim,1,Seattle Mariners,3,1,September 27 2014,2
San Diego Padres,1,San Francisco Giants,4,1,September 27 2014,3
Oakland Athletics,1,Texas Rangers,9,4,September 27 2014,5
Baltimore Orioles,1,Toronto Blue Jays,6,2,September 27 2014,4
Miami Marlins,1,Washington Nationals,6,1,September 27 2014,5
St. Louis Cardinals,0,Arizona D'Backs,1,1,September 28 2014,0
New York Yankees,0,Boston Red Sox,14,9,September 28 2014,5
Kansas City Royals,0,Chicago White Sox,10,6,September 28 2014,4
Pittsburgh Pirates,1,Cincinnati Reds,5,1,September 28 2014,4
Tampa Bay Rays,1,Cleveland Indians,9,2,September 28 2014,7
Minnesota Twins,1,Detroit Tigers,3,0,September 28 2014,3
Colorado Rockies,1,Los Angeles Dodgers,15,5,September 28 2014,10
Chicago Cubs,0,Milwaukee Brewers,7,5,September 28 2014,2
Houston Astros,1,New York Mets,11,3,September 28 2014,8
Atlanta Braves,0,Philadelphia Phillies,3,2,September 28 2014,1
LA Angels of Anaheim,1,Seattle Mariners,5,1,September 28 2014,4
San Diego Padres,1,San Francisco Giants,12,3,September 28 2014,9
Oakland Athletics,0,Texas Rangers,4,4,September 28 2014,0
Baltimore Orioles,0,Toronto Blue Jays,1,1,September 28 2014,0
Miami Marlins,1,Washington Nationals,1,0,September 28 2014,1
Oakland Athletics,1,Kansas City Royals,17,8,September 30 2014,9
San Francisco Giants,0,Pittsburgh Pirates,8,8,October 1 2014,0
Kansas City Royals,0,LA Angels of Anaheim,5,3,October 2 2014,2
Detroit Tigers,1,Baltimore Orioles,15,3,October 2 2014,12
Kansas City Royals,0,LA Angels of Anaheim,5,4,October 3 2014,1
Detroit Tigers,1,Baltimore Orioles,13,6,October 3 2014,7
St. Louis Cardinals,0,Los Angeles Dodgers,19,10,October 3 2014,9
San Francisco Giants,0,Washington Nationals,5,3,October 3 2014,2
St. Louis Cardinals,1,Los Angeles Dodgers,5,2,October 4 2014,3
San Francisco Giants,0,Washington Nationals,3,2,October 4 2014,1
Baltimore Orioles,0,Detroit Tigers,3,2,October 5 2014,1
LA Angels of Anaheim,1,Kansas City Royals,11,3,October 5 2014,8
Washington Nationals,0,San Francisco Giants,5,4,October 6 2014,1
Los Angeles Dodgers,1,St. Louis Cardinals,4,1,October 6 2014,3
Washington Nationals,1,San Francisco Giants,5,2,October 7 2014,3
Los Angeles Dodgers,1,St. Louis Cardinals,5,2,October 7 2014,3
Kansas City Royals,0,Baltimore Orioles,14,8,October 10 2014,6
Kansas City Royals,0,Baltimore Orioles,10,6,October 11 2014,4
San Francisco Giants,0,St. Louis Cardinals,3,3,October 11 2014,0
San Francisco Giants,1,St. Louis Cardinals,9,4,October 12 2014,5
Baltimore Orioles,1,Kansas City Royals,3,1,October 14 2014,2
St. Louis Cardinals,1,San Francisco Giants,9,4,October 14 2014,5
Baltimore Orioles,1,Kansas City Royals,3,1,October 15 2014,2
St. Louis Cardinals,1,San Francisco Giants,10,4,October 15 2014,6
St. Louis Cardinals,1,San Francisco Giants,9,3,October 16 2014,6
San Francisco Giants,0,Kansas City Royals,8,7,October 21 2014,1
San Francisco Giants,1,Kansas City Royals,9,2,October 22 2014,7
Kansas City Royals,0,San Francisco Giants,5,3,October 24 2014,2
Kansas City Royals,1,San Francisco Giants,15,4,October 25 2014,11
Kansas City Royals,1,San Francisco Giants,5,0,October 26 2014,5
San Francisco Giants,1,Kansas City Royals,10,0,October 28 2014,10
San Francisco Giants,0,Kansas City Royals,5,3,October 29 2014,2
St. Louis Cardinals,0,Chicago Cubs,3,3,April 5 2015,0
San Francisco Giants,0,Arizona D'Backs,9,5,April 6 2015,4
Pittsburgh Pirates,1,Cincinnati Reds,7,2,April 6 2015,5
Minnesota Twins,1,Detroit Tigers,4,0,April 6 2015,4
Cleveland Indians,1,Houston Astros,2,0,April 6 2015,2
Chicago White Sox,1,Kansas City Royals,11,1,April 6 2015,10
San Diego Padres,1,Los Angeles Dodgers,9,3,April 6 2015,6
Atlanta Braves,0,Miami Marlins,3,2,April 6 2015,1
Colorado Rockies,0,Milwaukee Brewers,10,10,April 6 2015,0
Toronto Blue Jays,0,New York Yankees,7,6,April 6 2015,1
Texas Rangers,1,Oakland Athletics,8,0,April 6 2015,8
Boston Red Sox,0,Philadelphia Phillies,8,8,April 6 2015,0
LA Angels of Anaheim,1,Seattle Mariners,5,1,April 6 2015,4
Baltimore Orioles,0,Tampa Bay Rays,8,6,April 6 2015,2
New York Mets,0,Washington Nationals,4,3,April 6 2015,1
San Francisco Giants,1,Arizona D'Backs,13,6,April 7 2015,7
San Diego Padres,0,Los Angeles Dodgers,10,7,April 7 2015,3
Atlanta Braves,0,Miami Marlins,14,12,April 7 2015,2
Colorado Rockies,0,Milwaukee Brewers,7,5,April 7 2015,2
Texas Rangers,0,Oakland Athletics,4,3,April 7 2015,1
LA Angels of Anaheim,0,Seattle Mariners,2,2,April 7 2015,0
Baltimore Orioles,0,Tampa Bay Rays,11,6,April 7 2015,5
San Francisco Giants,0,Arizona D'Backs,7,5,April 8 2015,2
St. Louis Cardinals,1,Chicago Cubs,2,0,April 8 2015,2
Pittsburgh Pirates,1,Cincinnati Reds,9,4,April 8 2015,5
Minnesota Twins,1,Detroit Tigers,11,0,April 8 2015,11
Cleveland Indians,0,Houston Astros,2,2,April 8 2015,0
Chicago White Sox,1,Kansas City Royals,12,5,April 8 2015,7
San Diego Padres,1,Los Angeles Dodgers,11,4,April 8 2015,7
Atlanta Braves,0,Miami Marlins,2,2,April 8 2015,0
Colorado Rockies,0,Milwaukee Brewers,9,5,April 8 2015,4
Toronto Blue Jays,1,New York Yankees,7,3,April 8 2015,4
Texas Rangers,1,Oakland Athletics,10,0,April 8 2015,10
Boston Red Sox,1,Philadelphia Phillies,6,2,April 8 2015,4
LA Angels of Anaheim,0,Seattle Mariners,8,5,April 8 2015,3
Baltimore Orioles,1,Tampa Bay Rays,2,0,April 8 2015,2
New York Mets,1,Washington Nationals,3,1,April 8 2015,2
Pittsburgh Pirates,1,Cincinnati Reds,5,2,April 9 2015,3
Minnesota Twins,1,Detroit Tigers,8,1,April 9 2015,7
Cleveland Indians,0,Houston Astros,6,5,April 9 2015,1
Chicago White Sox,1,Kansas City Royals,5,1,April 9 2015,4
Toronto Blue Jays,0,New York Yankees,9,6,April 9 2015,3
Texas Rangers,0,Oakland Athletics,11,10,April 9 2015,1
Boston Red Sox,0,Philadelphia Phillies,8,6,April 9 2015,2
San Francisco Giants,0,San Diego Padres,1,1,April 9 2015,0
New York Mets,0,Washington Nationals,9,6,April 9 2015,3
Kansas City Royals,0,LA Angels of Anaheim,6,4,April 10 2015,2
Los Angeles Dodgers,1,Arizona D'Backs,7,3,April 10 2015,4
New York Mets,1,Atlanta Braves,8,3,April 10 2015,5
Toronto Blue Jays,0,Baltimore Orioles,17,12,April 10 2015,5
Minnesota Twins,0,Chicago White Sox,6,6,April 10 2015,0
St. Louis Cardinals,1,Cincinnati Reds,9,4,April 10 2015,5
Detroit Tigers,0,Cleveland Indians,12,8,April 10 2015,4
Chicago Cubs,1,Colorado Rockies,6,1,April 10 2015,5
Tampa Bay Rays,1,Miami Marlins,19,9,April 10 2015,10
Pittsburgh Pirates,0,Milwaukee Brewers,8,6,April 10 2015,2
Boston Red Sox,0,New York Yankees,11,6,April 10 2015,5
Seattle Mariners,1,Oakland Athletics,12,0,April 10 2015,12
Washington Nationals,1,Philadelphia Phillies,5,1,April 10 2015,4
San Francisco Giants,1,San Diego Padres,1,0,April 10 2015,1
Houston Astros,0,Texas Rangers,6,5,April 10 2015,1
Kansas City Royals,0,LA Angels of Anaheim,10,6,April 11 2015,4
Los Angeles Dodgers,1,Arizona D'Backs,6,0,April 11 2015,6
New York Mets,1,Atlanta Braves,8,3,April 11 2015,5
Toronto Blue Jays,1,Baltimore Orioles,8,1,April 11 2015,7
Minnesota Twins,1,Chicago White Sox,9,4,April 11 2015,5
St. Louis Cardinals,0,Cincinnati Reds,5,4,April 11 2015,1
Detroit Tigers,0,Cleveland Indians,15,9,April 11 2015,6